simulações,a,b,c,f,g,h
1000,518,501,485,259,486,745
1000,441,506,512,199,530,729
1000,499,498,490,256,489,745
1000,473,507,497,237,490,727
1000,505,458,532,220,555,775
1000,505,494,512,245,510,755
1000,509,528,475,275,463,738
1000,508,487,519,243,498,741
1000,503,518,488,268,487,755
1000,517,510,503,253,487,740
1000,507,490,467,242,485,727
1000,497,513,511,254,498,752
1000,498,467,524,227,533,760
1000,518,510,513,259,517,776
1000,483,512,491,247,481,728
1000,492,518,527,256,482,738
1000,506,508,466,261,459,720
1000,495,491,521,244,519,763
1000,515,515,483,268,482,750
1000,487,500,508,227,520,747
1000,485,499,486,249,485,734
1000,501,490,488,237,514,751
1000,502,499,494,257,502,759
1000,526,509,512,272,499,771
1000,483,496,514,232,534,766
1000,482,499,507,237,510,747
1000,511,496,504,233,543,776
1000,533,510,488,272,486,758
1000,491,517,498,256,488,744
1000,512,501,484,257,491,748
1000,490,506,516,247,503,750
1000,486,486,508,245,501,746
1000,476,491,487,231,514,745
1000,516,520,518,253,506,759
1000,530,485,470,254,494,748
1000,503,506,516,256,485,741
1000,486,504,510,259,497,756
1000,489,481,522,237,516,753
1000,522,512,536,281,485,766
1000,506,497,500,246,517,763
1000,517,504,488,263,492,755
1000,489,508,502,251,514,765
1000,497,486,520,238,506,744
1000,488,530,472,255,481,736
1000,500,506,521,253,518,771
1000,501,483,479,232,509,741
1000,494,494,499,227,518,745
1000,513,503,477,259,479,738
1000,513,484,496,253,494,747
1000,518,523,493,269,471,740
1000,481,488,499,240,506,746
1000,520,509,499,267,498,765
1000,519,485,484,252,504,756
1000,514,514,505,262,497,759
1000,494,507,490,238,511,749
1000,495,484,510,249,505,754
1000,507,475,507,244,507,751
1000,477,452,490,215,523,738
1000,496,491,513,234,532,766
1000,503,510,504,248,507,755
1000,516,484,514,254,515,769
1000,483,503,478,231,500,731
1000,481,511,518,251,491,742
1000,465,503,485,227,494,721
1000,494,521,479,255,472,727
1000,535,508,499,264,519,783
1000,488,504,508,245,494,739
1000,489,516,506,261,477,738
1000,517,485,484,267,461,728
1000,521,479,500,247,523,770
1000,491,514,523,247,501,748
1000,481,488,482,238,490,728
1000,484,477,497,230,505,735
1000,497,503,504,253,497,750
1000,495,491,490,246,494,740
1000,507,500,511,270,490,760
1000,507,479,501,246,517,763
1000,498,486,508,238,514,752
1000,507,525,520,260,507,767
1000,512,479,494,248,498,746
1000,506,501,499,248,499,747
1000,490,515,469,245,491,736
1000,532,521,481,270,479,749
1000,503,500,508,262,488,750
1000,494,508,508,253,500,753
1000,489,486,476,227,515,742
1000,476,487,506,225,499,724
1000,512,489,495,253,501,754
1000,508,506,527,253,509,762
1000,472,501,490,239,499,738
1000,516,483,492,249,503,752
1000,494,491,494,249,503,752
1000,505,511,519,251,519,770
1000,492,520,500,252,487,739
1000,511,516,482,251,506,757
1000,529,492,509,272,498,770
1000,507,501,497,254,515,769
1000,511,480,489,244,503,747
1000,472,524,475,247,476,723
1000,472,512,492,235,493,728
1000,511,488,519,245,527,772
1000,489,476,479,220,515,735
1000,491,490,464,238,480,718
1000,514,511,484,246,516,762
1000,485,495,522,226,523,749
1000,476,487,510,238,508,746
1000,499,490,489,246,506,752
1000,511,488,509,247,535,782
1000,504,486,464,244,497,741
1000,519,497,511,254,501,755
1000,471,497,513,237,490,727
1000,512,490,526,253,518,771
1000,506,490,519,259,506,765
1000,495,524,487,255,488,743
1000,496,496,492,245,493,738
1000,499,492,472,243,494,737
1000,528,498,487,260,495,755
1000,477,503,506,240,502,742
1000,500,550,494,269,482,751
1000,502,525,482,278,460,738
1000,489,503,530,247,515,762
1000,499,491,505,248,514,762
1000,481,502,469,231,494,725
1000,504,510,487,244,492,736
1000,470,496,480,226,486,712
1000,495,492,506,247,504,751
1000,502,492,508,258,497,755
1000,485,510,491,253,483,736
1000,492,502,518,262,478,740
1000,486,507,492,250,507,757
1000,476,526,512,252,491,743
1000,540,523,484,281,473,754
1000,491,521,473,257,480,737
1000,497,509,518,250,522,772
1000,496,519,488,249,500,749
1000,481,495,499,254,485,739
1000,486,496,490,241,507,748
1000,505,501,500,236,512,748
1000,501,537,519,265,497,762
1000,492,517,524,250,496,746
1000,499,485,501,237,505,742
1000,520,486,473,263,497,760
1000,499,525,486,250,485,735
1000,508,471,495,225,530,755
1000,487,486,498,238,506,744
1000,492,498,508,239,517,756
1000,502,509,490,268,491,759
1000,503,478,477,245,491,736
1000,451,523,477,228,478,706
1000,487,521,492,257,480,737
1000,519,503,492,267,483,750
1000,507,473,491,248,500,748
1000,503,467,501,232,529,761
1000,510,498,513,247,510,757
1000,493,523,493,268,468,736
1000,483,484,485,235,484,719
1000,490,510,509,237,515,752
1000,519,520,512,266,507,773
1000,517,491,500,249,524,773
1000,523,505,500,265,491,756
1000,491,472,451,245,473,718
1000,488,495,497,247,491,738
1000,492,501,503,249,497,746
1000,522,492,504,274,488,762
1000,505,513,499,248,505,753
1000,530,522,499,270,495,765
1000,497,467,491,233,505,738
1000,495,489,507,232,512,744
1000,483,500,499,229,508,737
1000,492,473,507,240,497,737
1000,484,509,530,254,500,754
1000,509,499,522,251,528,779
1000,507,467,492,244,497,741
1000,520,508,487,255,494,749
1000,501,477,494,253,488,741
1000,515,481,510,239,516,755
1000,513,507,505,267,488,755
1000,489,498,511,243,503,746
1000,499,493,488,249,502,751
1000,485,497,503,247,492,739
1000,532,520,502,285,484,769
1000,505,523,518,269,493,762
1000,495,500,491,258,480,738
1000,500,511,521,256,505,761
1000,511,498,512,250,519,769
1000,506,491,503,249,496,745
1000,520,514,489,280,472,752
1000,476,490,497,221,521,742
1000,491,516,492,260,483,743
1000,519,505,484,255,486,741
1000,466,493,513,234,509,743
1000,511,507,489,271,487,758
1000,502,526,493,261,484,745
1000,519,516,530,263,519,782
1000,495,510,498,241,507,748
1000,506,458,499,226,533,759
1000,492,480,479,239,496,735
1000,515,500,511,263,498,761
1000,511,505,492,253,494,747
1000,536,515,500,270,503,773
1000,484,492,512,230,521,751
1000,467,503,488,236,509,745
1000,500,520,521,270,501,771
1000,475,495,534,229,530,759
1000,496,536,493,264,477,741
1000,520,500,525,255,507,762
1000,518,487,491,265,490,755
1000,494,521,509,244,516,760
1000,515,511,499,266,504,770
1000,522,498,507,248,517,765
1000,507,512,481,257,477,734
1000,496,488,485,230,527,757
1000,500,504,495,255,503,758
1000,500,495,531,266,486,752
1000,511,489,520,242,520,762
1000,493,483,505,244,501,745
1000,502,530,486,275,456,731
1000,499,526,531,257,510,767
1000,500,484,495,235,516,751
1000,506,500,482,250,492,742
1000,480,504,543,246,519,765
1000,489,506,505,246,503,749
1000,492,482,494,230,513,743
1000,484,525,479,249,478,727
1000,500,486,529,228,541,769
1000,514,476,507,241,516,757
1000,508,516,482,272,479,751
1000,484,507,525,252,499,751
1000,482,503,480,242,482,724
1000,506,512,521,255,520,775
1000,511,497,493,260,491,751
1000,511,485,485,257,486,743
1000,493,508,501,257,495,752
1000,474,508,490,242,506,748
1000,511,480,526,238,537,775
1000,475,505,518,247,505,752
1000,465,498,514,229,509,738
1000,502,484,546,242,513,755
1000,508,471,511,237,529,766
1000,507,496,472,258,477,735
1000,508,471,507,247,523,770
1000,507,466,518,235,524,759
1000,525,491,491,269,505,774
1000,504,517,513,269,480,749
1000,483,499,506,246,494,740
1000,496,513,497,239,514,753
1000,489,499,496,238,494,732
1000,476,516,498,231,512,743
1000,479,513,518,238,504,742
1000,512,500,530,267,505,772
1000,501,534,476,272,472,744
1000,496,507,489,257,473,730
1000,518,499,480,264,479,743
1000,495,496,504,253,507,760
1000,491,520,499,253,488,741
1000,488,503,482,248,492,740
1000,497,498,527,252,513,765
1000,503,491,505,254,506,760
1000,489,493,510,243,503,746
1000,513,521,506,260,507,767
1000,524,513,514,269,484,753
1000,521,502,475,251,499,750
1000,529,507,498,271,500,771
1000,517,499,518,247,533,780
1000,480,502,511,241,498,739
1000,519,519,497,262,502,764
1000,493,500,469,235,479,714
1000,476,534,517,267,483,750
1000,508,484,529,243,527,770
1000,491,501,502,232,523,755
1000,473,474,512,229,504,733
1000,493,486,528,249,508,757
1000,467,525,498,249,488,737
1000,515,521,502,270,489,759
1000,492,520,505,244,511,755
1000,513,500,484,269,467,736
1000,501,513,470,249,487,736
1000,507,512,470,258,489,747
1000,502,498,494,253,499,752
1000,484,503,484,245,493,738
1000,504,527,482,268,485,753
1000,506,512,488,268,498,766
1000,497,519,472,268,463,731
1000,480,508,476,254,462,716
1000,514,490,485,249,496,745
1000,524,505,495,264,505,769
1000,487,504,510,234,513,747
1000,491,508,506,257,496,753
1000,496,498,499,244,491,735
1000,495,494,519,252,502,754
1000,507,490,495,250,508,758
1000,465,501,494,239,494,733
1000,484,481,486,237,500,737
1000,512,504,484,266,474,740
1000,482,466,512,224,527,751
1000,480,504,469,242,486,728
1000,511,511,499,275,478,753
1000,516,503,495,252,505,757
1000,499,505,492,258,474,732
1000,519,500,494,271,489,760
1000,481,463,530,218,541,759
1000,482,476,513,226,532,758
1000,485,503,507,235,508,743
1000,526,508,497,268,500,768
1000,500,481,487,232,516,748
1000,496,514,490,259,485,744
1000,487,525,521,252,498,750
1000,520,532,501,279,481,760
1000,510,500,494,258,468,726
1000,515,501,515,266,500,766
1000,490,481,494,245,495,740
1000,502,501,506,254,494,748
1000,490,506,507,238,530,768
1000,496,477,468,236,492,728
1000,503,524,511,264,501,765
1000,481,538,490,256,488,744
1000,515,499,511,267,501,768
1000,519,479,490,250,508,758
1000,517,503,506,264,497,761
1000,516,505,467,258,483,741
1000,504,519,487,271,473,744
1000,504,495,530,263,502,765
1000,499,490,506,245,501,746
1000,505,520,539,255,517,772
1000,494,506,503,238,515,753
1000,515,520,507,256,490,746
1000,505,501,479,255,498,753
1000,510,497,491,255,493,748
1000,500,511,494,265,474,739
1000,495,469,509,229,528,757
1000,518,502,473,259,489,748
1000,509,501,534,260,521,781
1000,506,508,518,247,508,755
1000,492,499,478,242,490,732
1000,492,495,504,245,516,761
1000,502,495,506,242,510,752
1000,491,476,503,241,490,731
1000,494,470,515,219,531,750
1000,476,485,495,236,497,733
1000,512,495,483,259,469,728
1000,494,505,494,249,496,745
1000,476,498,500,239,508,747
1000,484,473,534,223,537,760
1000,504,508,505,252,507,759
1000,528,506,499,282,489,771
1000,510,503,510,256,506,762
1000,476,494,530,231,532,763
1000,477,487,495,234,506,740
1000,507,482,486,234,514,748
1000,507,482,487,248,494,742
1000,509,479,514,250,510,760
1000,513,504,483,256,492,748
1000,507,544,485,271,475,746
1000,482,519,469,245,483,728
1000,527,507,481,272,485,757
1000,501,467,542,230,538,768
1000,534,505,511,255,516,771
1000,516,497,489,261,502,763
1000,515,519,481,267,472,739
1000,519,490,506,262,498,760
1000,527,506,493,266,504,770
1000,510,494,508,256,498,754
1000,492,478,501,238,517,755
1000,488,488,489,235,510,745
1000,502,492,501,246,513,759
1000,494,486,501,233,511,744
1000,483,491,474,232,505,737
1000,501,492,493,246,509,755
1000,497,501,494,247,486,733
1000,488,515,485,262,475,737
1000,459,499,507,235,503,738
1000,482,509,525,233,524,757
1000,525,485,495,248,520,768
1000,498,474,524,236,535,771
1000,500,478,495,238,517,755
1000,504,470,500,246,504,750
1000,486,507,504,228,508,736
1000,494,501,474,259,472,731
1000,502,501,477,251,486,737
1000,484,514,517,251,507,758
1000,512,497,504,262,493,755
1000,504,504,470,255,487,742
1000,493,502,497,230,503,733
1000,501,509,504,262,489,751
1000,474,491,509,240,513,753
1000,492,506,489,252,492,744
1000,456,509,518,236,497,733
1000,508,518,499,263,484,747
1000,506,495,504,260,501,761
1000,497,470,478,230,503,733
1000,490,510,492,251,490,741
1000,538,498,506,264,509,773
1000,518,504,504,262,492,754
1000,506,495,519,246,512,758
1000,509,490,494,251,484,735
1000,507,490,499,250,490,740
1000,497,465,521,237,536,773
1000,491,491,507,232,507,739
1000,510,489,480,251,494,745
1000,486,488,499,257,494,751
1000,492,510,523,263,499,762
1000,517,499,512,265,508,773
1000,485,526,538,256,508,764
1000,489,495,489,252,486,738
1000,500,496,503,233,531,764
1000,521,491,503,239,531,770
1000,483,512,515,244,507,751
1000,478,493,523,243,494,737
1000,503,491,505,246,501,747
1000,481,522,472,252,463,715
1000,489,507,516,243,499,742
1000,498,478,491,239,510,749
1000,485,485,496,229,530,759
1000,484,482,474,225,505,730
1000,515,503,480,257,491,748
1000,502,488,510,259,489,748
1000,497,488,521,244,517,761
1000,521,513,520,261,497,758
1000,502,477,501,231,504,735
1000,497,493,509,260,492,752
1000,498,495,502,249,502,751
1000,501,489,507,244,515,759
1000,520,490,481,250,483,733
1000,498,532,500,265,489,754
1000,497,498,486,255,499,754
1000,453,477,494,221,498,719
1000,486,523,483,240,491,731
1000,498,498,488,266,479,745
1000,506,532,501,272,484,756
1000,481,483,488,226,510,736
1000,488,490,485,244,492,736
1000,469,501,530,242,513,755
1000,507,489,505,231,515,746
1000,516,509,491,265,489,754
1000,485,535,529,265,495,760
1000,519,479,507,255,511,766
1000,496,517,493,247,507,754
1000,513,485,480,251,493,744
1000,484,474,501,218,530,748
1000,485,495,493,239,509,748
1000,520,520,496,266,481,747
1000,513,505,497,265,491,756
1000,498,496,506,247,497,744
1000,503,523,492,271,472,743
1000,487,528,506,256,485,741
1000,507,514,513,261,516,777
1000,503,491,530,247,523,770
1000,478,515,470,235,504,739
1000,508,494,517,239,523,762
1000,494,500,485,258,484,742
1000,510,481,499,246,511,757
1000,472,489,487,225,508,733
1000,444,499,507,211,506,717
1000,499,492,510,236,529,765
1000,508,489,484,250,497,747
1000,523,526,500,256,513,769
1000,522,495,509,264,509,773
1000,508,502,463,264,475,739
1000,499,500,482,237,499,736
1000,476,508,507,248,491,739
1000,506,495,524,249,512,761
1000,504,498,504,261,488,749
1000,498,511,501,243,501,744
1000,478,498,520,232,514,746
1000,542,489,484,253,492,745
1000,485,515,478,254,492,746
1000,493,494,494,243,496,739
1000,502,484,503,237,514,751
1000,458,480,474,216,495,711
1000,513,514,530,262,503,765
1000,508,524,499,270,489,759
1000,515,504,472,277,463,740
1000,505,493,500,254,487,741
1000,515,506,488,267,492,759
1000,490,511,492,250,488,738
1000,492,494,499,241,503,744
1000,464,505,514,240,502,742
1000,495,494,495,247,498,745
1000,498,512,482,243,491,734
1000,520,497,482,258,505,763
1000,495,486,506,241,512,753
1000,488,511,485,251,483,734
1000,513,509,501,256,497,753
1000,502,533,494,261,482,743
1000,445,508,502,226,507,733
1000,507,519,508,259,509,768
1000,478,513,458,253,452,705
1000,461,513,506,233,496,729
1000,497,489,502,243,517,760
1000,508,515,511,258,495,753
1000,505,488,506,250,504,754
1000,515,495,501,250,519,769
1000,518,497,488,261,492,753
1000,492,501,512,249,507,756
1000,496,527,518,258,498,756
1000,499,474,518,226,533,759
1000,509,503,513,258,495,753
1000,510,498,511,253,503,756
1000,495,496,513,239,502,741
1000,532,494,483,241,523,764
1000,507,490,491,250,497,747
1000,487,488,489,221,510,731
1000,512,513,516,264,495,759
1000,505,503,497,260,488,748
1000,481,513,491,250,491,741
1000,506,481,493,234,518,752
1000,478,491,502,228,516,744
1000,516,525,490,255,495,750
1000,513,520,498,249,495,744
1000,522,500,494,265,493,758
1000,478,513,495,259,480,739
1000,481,497,502,237,513,750
1000,492,482,513,223,525,748
1000,523,509,508,254,529,783
1000,507,490,492,244,510,754
1000,482,490,497,213,526,739
1000,480,526,493,251,484,735
1000,492,497,515,259,485,744
1000,496,512,505,246,520,766
1000,521,468,505,237,529,766
1000,517,511,502,247,511,758
1000,493,505,525,248,525,773
1000,488,514,506,236,517,753
1000,504,484,504,240,521,761
1000,499,495,500,246,517,763
1000,513,486,499,256,516,772
1000,480,481,491,227,510,737
1000,485,501,510,243,516,759
1000,505,491,504,259,493,752
1000,504,513,498,267,500,767
1000,521,510,496,258,508,766
1000,495,495,497,264,479,743
1000,496,503,491,263,482,745
1000,517,531,508,272,491,763
1000,492,489,502,235,504,739
1000,516,493,487,257,488,745
1000,493,504,499,251,501,752
1000,520,520,501,275,472,747
1000,498,515,528,270,486,756
1000,496,481,497,234,515,749
1000,500,492,515,252,499,751
1000,515,508,499,249,509,758
1000,487,501,483,257,480,737
1000,495,519,535,256,519,775
1000,522,521,489,287,464,751
1000,502,511,511,266,507,773
1000,522,497,502,256,500,756
1000,484,521,512,239,494,733
1000,480,490,496,238,490,728
1000,485,501,495,239,508,747
1000,491,498,515,250,505,755
1000,482,496,512,243,511,754
1000,506,498,517,251,508,759
1000,491,521,514,256,498,754
1000,516,501,494,256,503,759
1000,494,492,517,260,491,751
1000,496,478,504,235,500,735
1000,497,506,496,259,498,757
1000,518,500,516,257,507,764
1000,522,493,490,271,482,753
1000,491,492,459,249,470,719
1000,491,503,521,244,513,757
1000,504,507,501,262,481,743
1000,493,493,510,237,507,744
1000,508,511,489,255,481,736
1000,496,512,500,256,511,767
1000,508,493,496,236,511,747
1000,498,486,495,247,499,746
1000,513,527,494,274,476,750
1000,510,522,497,266,496,762
1000,523,504,471,264,490,754
1000,494,500,504,249,490,739
1000,509,500,494,253,492,745
1000,503,516,484,260,491,751
1000,497,482,506,230,513,743
1000,495,492,492,249,492,741
1000,505,487,479,245,501,746
1000,513,494,496,253,511,764
1000,500,482,496,236,498,734
1000,483,466,475,219,501,720
1000,517,469,523,238,532,770
1000,506,513,510,246,504,750
1000,469,501,482,248,471,719
1000,502,483,496,251,510,761
1000,505,496,500,245,515,760
1000,482,509,527,250,493,743
1000,499,491,517,250,502,752
1000,514,517,500,258,494,752
1000,491,530,518,267,479,746
1000,478,472,513,234,506,740
1000,485,472,524,230,526,756
1000,468,509,492,237,493,730
1000,500,498,487,229,498,727
1000,505,505,491,257,494,751
1000,503,506,492,243,503,746
1000,449,500,487,236,501,737
1000,489,489,495,243,503,746
1000,505,495,497,250,497,747
1000,505,499,492,249,501,750
1000,471,484,502,225,516,741
1000,508,506,474,266,486,752
1000,501,496,495,243,506,749
1000,489,487,516,244,519,763
1000,496,497,499,247,504,751
1000,498,493,503,242,509,751
1000,482,491,509,236,501,737
1000,490,507,503,260,496,756
1000,486,507,508,245,506,751
1000,487,482,477,233,510,743
1000,527,513,455,276,463,739
1000,493,509,499,260,486,746
1000,501,512,524,259,503,762
1000,467,475,511,228,498,726
1000,506,492,507,241,510,751
1000,494,511,517,253,488,741
1000,504,506,479,253,498,751
1000,495,528,515,248,501,749
1000,496,495,493,241,487,728
1000,492,490,488,237,508,745
1000,515,501,504,263,489,752
1000,514,519,499,274,486,760
1000,513,497,477,248,490,738
1000,480,518,485,239,483,722
1000,499,512,485,255,483,738
1000,531,515,518,275,485,760
1000,515,535,508,274,485,759
1000,514,498,512,247,519,766
1000,490,499,483,244,502,746
1000,510,525,496,261,501,762
1000,493,513,520,253,512,765
1000,514,497,533,247,538,785
1000,486,472,510,227,545,772
1000,466,497,519,220,539,759
1000,504,495,488,235,509,744
1000,527,479,497,263,493,756
1000,519,500,498,253,502,755
1000,510,495,501,243,519,762
1000,521,483,491,246,511,757
1000,510,493,484,259,494,753
1000,495,512,511,269,482,751
1000,485,478,492,236,495,731
1000,498,496,514,251,503,754
1000,497,486,503,242,511,753
1000,492,526,456,255,470,725
1000,511,509,484,267,476,743
1000,491,483,482,238,503,741
1000,522,499,478,260,491,751
1000,510,493,508,249,509,758
1000,468,511,511,229,520,749
1000,506,485,506,255,493,748
1000,500,486,506,242,519,761
1000,498,509,483,256,484,740
1000,490,484,500,232,499,731
1000,484,514,495,243,490,733
1000,511,479,505,267,483,750
1000,534,523,519,272,505,777
1000,513,490,499,246,497,743
1000,499,474,498,237,519,756
1000,513,537,478,284,460,744
1000,473,508,491,236,499,735
1000,500,496,522,245,513,758
1000,506,532,491,288,472,760
1000,494,527,512,266,479,745
1000,535,473,513,257,522,779
1000,502,528,491,268,482,750
1000,489,482,499,227,517,744
1000,496,485,527,236,533,769
1000,488,475,479,228,514,742
1000,493,522,530,272,500,772
1000,512,477,478,243,494,737
1000,477,490,504,221,521,742
1000,484,513,501,254,495,749
1000,504,495,506,248,510,758
1000,484,493,488,243,498,741
1000,517,469,534,242,538,780
1000,511,499,481,264,482,746
1000,510,488,498,248,514,762
1000,511,504,487,250,506,756
1000,485,498,499,231,528,759
1000,484,513,509,253,503,756
1000,501,515,526,262,495,757
1000,488,498,480,244,488,732
1000,502,462,525,240,533,773
1000,491,494,514,236,516,752
1000,497,497,507,254,507,761
1000,487,504,492,244,503,747
1000,507,517,462,258,470,728
1000,527,497,498,270,491,761
1000,475,503,525,239,528,767
1000,495,483,498,249,505,754
1000,477,543,515,268,492,760
1000,491,475,493,218,537,755
1000,517,512,477,272,474,746
1000,482,512,533,252,506,758
1000,487,509,470,232,501,733
1000,507,512,512,244,516,760
1000,526,490,522,256,522,778
1000,537,513,486,274,480,754
1000,514,527,477,267,476,743
1000,501,517,512,254,505,759
1000,503,485,503,242,511,753
1000,510,492,522,248,516,764
1000,488,470,489,242,491,733
1000,494,482,505,230,524,754
1000,497,483,512,232,512,744
1000,510,521,499,271,498,769
1000,467,494,510,243,494,737
1000,491,529,508,249,503,752
1000,481,514,514,246,506,752
1000,504,475,510,241,521,762
1000,509,507,501,265,493,758
1000,479,510,484,225,498,723
1000,525,474,531,254,528,782
1000,511,529,518,260,504,764
1000,503,500,495,251,492,743
1000,479,504,482,245,477,722
1000,494,509,491,236,514,750
1000,508,506,518,252,504,756
1000,515,500,487,256,502,758
1000,516,499,481,253,490,743
1000,512,509,516,252,499,751
1000,520,519,512,278,474,752
1000,472,459,524,212,546,758
1000,496,491,476,241,491,732
1000,501,517,496,274,457,731
1000,506,497,505,236,530,766
1000,490,504,502,245,501,746
1000,466,502,503,241,492,733
1000,500,488,495,239,515,754
1000,482,527,475,255,486,741
1000,467,481,499,224,511,735
1000,504,469,532,221,549,770
1000,503,487,493,257,490,747
1000,510,532,508,261,504,765
1000,471,471,508,205,536,741
1000,493,492,499,233,520,753
1000,511,476,495,253,495,748
1000,499,483,482,243,494,737
1000,482,468,485,218,520,738
1000,500,498,492,245,492,737
1000,470,499,481,238,492,730
1000,514,509,532,274,510,784
1000,539,497,504,268,494,762
1000,467,496,509,227,520,747
1000,505,519,478,272,481,753
1000,496,485,503,238,525,763
1000,531,496,485,261,508,769
1000,501,507,510,254,493,747
1000,530,487,466,263,490,753
1000,524,489,523,251,514,765
1000,505,476,500,247,510,757
1000,470,482,466,222,487,709
1000,507,489,499,241,524,765
1000,505,496,500,254,500,754
1000,468,497,513,220,521,741
1000,493,532,491,261,473,734
1000,523,486,514,251,504,755
1000,520,471,488,226,528,754
1000,547,504,502,273,504,777
1000,488,500,485,243,486,729
1000,487,500,510,237,516,753
1000,497,500,517,237,519,756
1000,506,491,502,238,522,760
1000,507,515,491,257,494,751
1000,489,526,509,249,482,731
1000,497,501,514,246,499,745
1000,506,506,505,241,505,746
1000,464,490,493,237,496,733
1000,507,496,519,265,501,766
1000,490,498,522,244,512,756
1000,521,500,500,276,482,758
1000,480,478,500,221,519,740
1000,507,499,506,253,496,749
1000,488,478,523,232,528,760
1000,470,501,463,240,470,710
1000,510,505,483,267,483,750
1000,485,497,506,243,488,731
1000,517,507,502,276,477,753
1000,503,496,488,243,510,753
1000,512,521,498,275,472,747
1000,515,493,522,256,505,761
1000,510,510,502,258,504,762
1000,525,463,514,241,531,772
1000,496,501,498,249,495,744
1000,469,489,532,222,526,748
1000,509,492,464,255,490,745
1000,501,468,507,229,510,739
1000,491,517,524,246,505,751
1000,458,535,487,248,471,719
1000,502,504,508,250,516,766
1000,479,531,482,253,470,723
1000,483,491,503,234,513,747
1000,493,496,487,237,500,737
1000,506,506,505,255,480,735
1000,497,483,491,240,507,747
1000,497,516,480,241,494,735
1000,504,491,508,249,508,757
1000,488,484,512,232,518,750
1000,490,478,490,234,509,743
1000,484,521,490,243,504,747
1000,503,493,490,249,500,749
1000,519,482,509,245,529,774
1000,498,515,492,258,497,755
1000,498,501,492,251,493,744
1000,487,494,508,244,510,754
1000,496,504,508,272,460,732
1000,493,524,482,260,481,741
1000,502,480,504,244,504,748
1000,466,479,511,215,529,744
1000,531,533,502,264,501,765
1000,485,506,489,238,504,742
1000,487,519,498,267,475,742
1000,486,511,489,256,480,736
1000,520,496,492,267,492,759
1000,493,477,504,236,507,743
1000,496,466,508,226,535,761
1000,513,505,478,245,507,752
1000,486,483,504,233,492,725
1000,471,507,512,237,505,742
1000,531,500,511,269,499,768
1000,493,512,490,250,487,737
1000,493,478,495,225,522,747
1000,508,464,461,243,491,734
1000,535,502,509,273,511,784
1000,490,527,495,253,494,747
1000,481,510,492,247,491,738
1000,480,501,487,244,487,731
1000,495,499,483,245,485,730
1000,518,514,485,263,491,754
1000,509,497,503,260,499,759
1000,483,510,489,254,495,749
1000,517,539,478,262,484,746
1000,516,505,493,254,497,751
1000,516,499,493,256,484,740
1000,501,513,487,264,479,743
1000,472,500,486,236,504,740
1000,518,502,528,260,523,783
1000,519,491,479,247,502,749
1000,493,479,511,231,535,766
1000,526,471,504,240,538,778
1000,526,488,526,246,534,780
1000,473,513,499,238,511,749
1000,514,508,508,266,494,760
1000,529,511,514,259,504,763
1000,512,493,503,257,515,772
1000,529,509,469,258,500,758
1000,513,510,495,268,487,755
1000,490,504,502,244,487,731
1000,507,500,505,249,509,758
1000,546,478,505,253,524,777
1000,506,501,502,250,509,759
1000,509,489,506,247,503,750
1000,509,536,488,257,492,749
1000,507,508,492,246,501,747
1000,527,495,489,265,488,753
1000,489,505,492,253,491,744
1000,498,490,514,234,538,772
1000,530,499,482,271,490,761
1000,486,490,500,227,499,726
1000,516,493,527,255,498,753
1000,499,499,498,244,520,764
1000,484,492,491,232,500,732
1000,505,504,509,252,507,759
1000,487,508,503,258,484,742
1000,502,505,521,251,523,774
1000,477,496,495,241,487,728
1000,506,491,474,251,485,736
1000,468,494,515,226,508,734
1000,502,493,497,235,515,750
1000,478,479,512,219,520,739
1000,499,493,484,243,499,742
1000,482,471,492,224,508,732
1000,522,504,516,274,493,767
1000,499,487,475,231,517,748
1000,496,476,497,212,517,729
1000,496,524,478,268,487,755
1000,518,492,507,266,498,764
1000,489,484,511,227,528,755
1000,490,523,485,244,493,737
1000,471,513,523,252,501,753
1000,524,505,510,275,496,771
1000,475,483,468,221,504,725
1000,506,478,515,248,507,755
1000,501,475,501,233,507,740
1000,490,503,497,247,503,750
1000,500,508,499,245,503,748
1000,487,529,481,263,455,718
1000,487,503,477,252,475,727
1000,457,525,481,235,469,704
1000,492,506,514,256,495,751
1000,520,490,488,253,501,754
1000,490,524,487,244,486,730
1000,486,484,497,240,503,743
1000,487,453,513,226,514,740
1000,504,505,504,258,491,749
1000,510,472,536,230,541,771
1000,494,519,483,264,475,739
1000,478,518,487,252,478,730
1000,519,493,473,263,475,738
1000,497,516,486,269,461,730
1000,495,499,496,249,506,755
1000,509,475,484,246,499,745
1000,508,488,497,249,495,744
1000,516,500,481,272,474,746
1000,499,508,487,238,502,740
1000,513,490,497,259,477,736
1000,496,480,513,246,506,752
1000,518,481,493,244,516,760
1000,503,533,500,261,498,759
1000,474,501,511,230,520,750
1000,488,545,531,256,506,762
1000,481,485,510,228,511,739
1000,508,484,504,248,505,753
1000,494,515,498,253,488,741
1000,499,529,524,266,496,762
1000,484,491,504,242,521,763
1000,504,481,508,242,517,759
1000,501,487,513,255,504,759
1000,500,477,501,243,510,753
1000,510,491,494,249,504,753
1000,497,471,499,233,523,756
1000,492,486,471,249,487,736
1000,498,496,482,237,502,739
1000,498,505,513,249,505,754
1000,449,519,488,232,487,719
1000,488,498,505,224,529,753
1000,446,495,499,228,491,719
1000,486,490,489,243,495,738
1000,488,495,516,238,517,755
1000,486,505,498,233,510,743
1000,503,489,492,273,470,743
1000,494,507,520,248,510,758
1000,512,508,499,259,492,751
1000,515,488,505,260,517,777
1000,492,478,515,258,505,763
1000,514,515,501,267,491,758
1000,487,505,534,250,508,758
1000,501,503,450,249,477,726
1000,480,483,463,231,495,726
1000,513,486,502,254,507,761
1000,528,495,509,254,519,773
1000,510,493,502,242,509,751
1000,509,487,496,251,493,744
1000,539,493,480,269,500,769
1000,475,518,514,230,509,739
1000,498,497,545,245,522,767
1000,536,497,489,252,512,764
1000,507,516,492,256,483,739
1000,498,499,527,250,509,759
1000,516,495,496,252,504,756
1000,508,489,488,247,507,754
1000,517,486,480,253,497,750
1000,486,511,479,252,470,722
1000,501,512,508,259,495,754
1000,478,492,482,239,495,734
1000,474,512,501,230,503,733
1000,491,498,493,240,502,742
1000,483,485,498,237,496,733
1000,469,456,503,211,531,742
1000,484,526,545,247,521,768
1000,489,516,506,269,472,741
1000,529,491,501,263,503,766
1000,511,521,508,265,492,757
1000,518,497,505,242,515,757
1000,473,524,498,255,478,733
1000,529,501,514,279,503,782
1000,528,491,496,260,504,764
1000,509,484,519,246,507,753
1000,496,484,492,240,517,757
1000,499,490,506,244,501,745
1000,494,517,517,277,483,760
1000,481,479,511,232,528,760
1000,503,508,504,267,471,738
1000,499,511,495,240,492,732
1000,489,501,492,240,503,743
1000,510,504,511,244,510,754
1000,493,525,473,252,478,730
1000,525,477,486,246,515,761
1000,487,506,510,252,500,752
1000,484,522,496,255,491,746
1000,484,484,526,244,527,771
1000,488,508,547,257,499,756
1000,487,505,509,248,511,759
1000,520,484,513,254,516,770
1000,502,500,462,256,482,738
1000,494,495,468,239,488,727
1000,501,496,534,251,512,763
1000,518,489,500,240,517,757
1000,500,530,545,275,500,775
1000,500,511,465,247,492,739
1000,477,489,509,226,504,730
1000,467,479,504,231,504,735
1000,494,497,492,244,496,740
1000,505,488,527,247,512,759
1000,495,494,498,242,500,742
1000,518,508,490,255,509,764
1000,493,489,490,235,517,752
1000,503,500,513,252,507,759
1000,518,501,516,254,513,767
1000,483,516,471,256,471,727
1000,496,502,499,243,503,746
1000,509,516,499,262,494,756
1000,535,484,516,271,499,770
1000,485,505,494,254,487,741
1000,503,502,488,252,493,745
1000,502,526,518,256,503,759
1000,528,478,507,262,510,772
1000,530,498,492,266,498,764
1000,499,498,496,262,490,752
1000,503,487,498,248,505,753
1000,530,492,497,262,493,755
1000,498,479,523,244,523,767
1000,526,513,498,273,474,747
1000,516,507,503,264,488,752
1000,498,529,495,266,486,752
1000,518,496,510,263,496,759
1000,487,487,501,234,518,752
1000,500,517,498,258,489,747
1000,509,458,509,243,512,755
1000,483,492,498,231,515,746
1000,488,504,505,243,494,737
1000,501,496,514,241,540,781
1000,510,499,501,241,508,749
1000,495,493,508,242,505,747
1000,482,504,512,243,494,737
1000,515,496,481,251,501,752
1000,532,511,500,269,484,753
1000,513,513,496,272,476,748
1000,474,505,498,230,526,756
1000,494,506,526,222,539,761
1000,525,483,487,261,498,759
1000,501,496,512,244,514,758
1000,474,527,511,243,493,736
1000,485,495,479,245,483,728
1000,545,498,506,266,529,795
1000,497,493,485,234,514,748
1000,503,495,489,244,489,733
1000,500,487,500,241,518,759
1000,473,503,498,229,501,730
1000,511,528,496,265,489,754
1000,490,516,496,253,486,739
1000,490,521,500,257,484,741
1000,486,466,528,220,537,757
1000,503,495,510,243,502,745
1000,519,473,467,258,486,744
1000,491,520,499,253,493,746
1000,493,471,494,223,528,751
1000,487,481,499,227,523,750
1000,486,486,486,246,488,734
1000,507,496,502,253,492,745
1000,511,508,507,258,510,768
1000,500,521,494,271,484,755
1000,494,497,500,246,491,737
1000,495,492,489,243,498,741
1000,491,478,509,247,495,742
1000,521,510,479,267,477,744
1000,515,518,477,270,481,751
1000,495,502,530,244,519,763
1000,495,501,479,249,498,747
1000,511,506,506,267,482,749
1000,523,508,490,261,486,747
1000,520,491,503,245,512,757
1000,471,529,502,250,482,732
1000,505,491,477,256,478,734
1000,505,496,499,248,504,752
1000,464,481,481,238,491,729
1000,464,496,509,229,503,732
1000,490,502,541,246,529,775
1000,511,491,509,245,519,764
1000,503,477,504,245,515,760
1000,518,507,466,239,511,750
1000,515,503,497,257,513,770
1000,521,518,497,265,503,768
1000,521,500,510,257,497,754
1000,487,510,512,253,496,749
1000,480,487,470,243,478,721
1000,495,506,475,253,483,736
1000,509,546,517,278,486,764
1000,492,467,513,242,520,762
1000,508,498,505,248,508,756
1000,494,493,517,235,530,765
1000,479,471,506,218,541,759
1000,547,507,481,299,453,752
1000,503,506,489,263,483,746
1000,492,494,502,243,510,753
1000,496,539,501,246,492,738
1000,494,488,489,236,493,729
1000,497,502,461,245,472,717
1000,521,492,530,245,534,779
1000,488,513,497,258,476,734
1000,520,508,510,265,510,775
1000,495,530,524,269,505,774
1000,525,507,501,252,518,770
1000,486,452,498,215,520,735
1000,499,483,501,243,510,753
1000,545,514,499,273,497,770
1000,507,466,527,234,531,765
1000,495,476,505,234,522,756
1000,480,518,487,235,488,723
1000,493,525,496,257,476,733
1000,502,510,467,255,487,742
1000,504,491,507,250,511,761
1000,511,476,473,260,493,753
1000,502,517,521,251,516,767
1000,507,502,494,267,483,750
1000,504,495,514,244,515,759
1000,498,528,520,269,483,752
1000,549,538,496,303,471,774
1000,484,499,485,231,510,741
1000,510,504,519,253,521,774
1000,506,495,511,281,478,759
1000,486,487,490,235,523,758
1000,517,483,506,240,519,759
1000,521,512,486,269,487,756
1000,492,500,517,243,522,765
1000,495,494,505,241,506,747
1000,503,497,485,269,475,744
1000,503,503,484,255,481,736
1000,505,495,502,253,502,755
1000,501,484,497,246,497,743
1000,502,494,529,242,532,774
1000,498,503,504,254,493,747
1000,513,508,495,256,498,754
1000,548,497,490,267,499,766
1000,466,508,518,237,510,747
1000,488,472,492,227,507,734
1000,478,511,501,239,505,744
1000,500,493,522,232,520,752
1000,490,510,465,248,480,728
1000,509,482,489,254,507,761
1000,522,518,519,276,500,776
1000,493,528,490,248,496,744
1000,496,502,491,264,479,743
1000,487,467,491,236,510,746
1000,497,456,483,224,517,741
1000,498,502,500,261,476,737
1000,514,505,477,252,488,740
1000,506,506,485,260,486,746
1000,524,512,522,273,496,769
1000,506,512,511,261,504,765
1000,498,511,510,269,476,745
1000,502,503,505,253,502,755
1000,502,512,492,248,502,750
1000,501,519,528,252,509,761
1000,497,501,493,234,515,749
1000,527,503,518,272,495,767
1000,490,502,507,253,493,746
1000,514,475,516,233,546,779
1000,521,509,490,258,505,763
1000,478,486,518,226,530,756
1000,504,504,521,251,511,762
1000,503,502,513,247,507,754
1000,492,489,487,238,495,733
1000,491,499,496,248,491,739
1000,517,490,518,251,518,769
1000,482,478,495,235,517,752
1000,511,511,502,265,500,765
1000,482,529,520,265,487,752
1000,522,510,496,267,505,772
1000,490,496,479,257,473,730
1000,495,535,501,269,487,756
1000,500,491,491,237,507,744
1000,481,517,505,255,497,752
1000,483,497,472,252,478,730
1000,525,481,489,257,501,758
1000,508,527,512,257,509,766
1000,491,477,472,237,507,744
1000,512,469,493,238,502,740
1000,514,494,489,250,498,748
1000,496,502,493,253,496,749
1000,504,525,502,258,511,769
1000,520,495,507,256,519,775
1000,504,496,488,250,487,737
1000,501,486,518,244,508,752
1000,520,500,516,263,510,773
1000,486,486,501,226,521,747
1000,497,510,513,245,507,752
1000,514,510,513,265,503,768
1000,503,518,507,259,493,752
1000,512,484,499,255,490,745
1000,495,485,503,237,518,755
1000,512,478,499,257,499,756
1000,506,520,491,263,478,741
1000,504,519,477,253,482,735
1000,516,496,495,246,503,749
1000,491,464,476,239,492,731
1000,500,489,497,246,509,755
1000,515,470,500,242,524,766
1000,498,497,493,246,499,745
1000,499,509,483,254,497,751
1000,482,510,460,254,465,719
1000,489,503,468,258,481,739
1000,497,493,488,264,481,745
1000,497,476,516,244,512,756
1000,482,499,524,256,495,751
1000,494,508,522,248,512,760
1000,504,503,516,254,512,766
1000,485,506,499,248,499,747
1000,504,527,484,258,488,746
1000,526,477,506,240,528,768
1000,467,514,490,231,501,732
1000,529,503,503,266,496,762
1000,500,494,510,244,504,748
1000,496,484,515,253,511,764
1000,505,526,475,254,471,725
1000,526,493,497,260,494,754
1000,491,501,499,256,489,745
1000,524,514,510,279,493,772
1000,508,512,499,259,507,766
1000,513,506,525,248,548,796
1000,511,487,498,248,500,748
1000,494,472,472,232,517,749
1000,494,519,480,252,500,752
1000,517,473,509,234,514,748
1000,482,511,512,257,487,744
1000,491,528,501,254,485,739
1000,502,499,517,249,508,757
1000,489,476,479,226,519,745
1000,499,510,490,256,480,736
1000,493,500,518,261,499,760
1000,505,521,495,252,496,748
1000,492,500,517,253,498,751
1000,526,473,473,253,498,751
1000,508,475,511,240,505,745
1000,514,480,499,246,500,746
1000,492,512,464,248,476,724
1000,535,523,483,273,468,741
1000,507,499,510,250,518,768
1000,492,506,499,248,495,743
1000,492,523,524,254,506,760
1000,525,495,480,275,482,757
1000,483,487,478,241,486,727
1000,512,505,511,264,503,767
1000,487,497,467,248,492,740
1000,502,525,492,265,477,742
1000,517,474,506,230,532,762
1000,505,530,512,268,492,760
1000,515,482,505,245,515,760
1000,497,481,479,238,499,737
1000,527,503,519,274,505,779
1000,501,511,476,247,487,734
1000,515,507,536,255,512,767
1000,497,510,494,259,482,741
1000,494,524,488,259,478,737
1000,487,499,494,250,494,744
1000,485,486,515,235,505,740
1000,518,481,484,243,512,755
1000,512,497,527,260,506,766
1000,491,503,498,245,490,735
1000,505,491,484,243,491,734
1000,497,505,497,253,503,756
1000,512,518,501,274,493,767
1000,502,490,506,251,502,753
1000,509,520,483,252,490,742
1000,523,482,523,257,503,760
1000,521,481,478,265,484,749
1000,512,481,500,242,516,758
1000,520,537,541,278,488,766
1000,522,500,519,259,520,779
1000,481,535,493,255,480,735
1000,488,530,517,260,497,757
1000,493,517,489,258,496,754
1000,500,489,519,243,505,748
1000,505,485,512,247,501,748
1000,506,520,505,275,484,759
1000,514,483,493,239,521,760
1000,512,489,524,251,518,769
1000,495,521,502,263,479,742
1000,518,497,483,239,517,756
1000,525,485,499,262,499,761
1000,516,499,484,251,491,742
1000,541,460,518,259,534,793
1000,483,521,483,252,475,727
1000,514,502,495,252,509,761
1000,516,496,499,249,512,761
1000,531,466,517,248,513,761
1000,491,509,509,245,524,769
1000,522,494,463,258,490,748
1000,525,504,501,268,492,760
1000,498,504,504,241,510,751
1000,530,492,537,269,526,795
1000,484,491,522,244,503,747
1000,500,486,505,247,491,738
1000,508,517,498,275,483,758
1000,504,478,485,244,499,743
1000,505,506,496,237,512,749
1000,518,445,489,235,518,753
1000,524,467,525,252,516,768
1000,517,514,508,271,484,755
1000,516,519,519,268,490,758
1000,518,518,483,270,487,757
1000,489,490,511,241,506,747
1000,485,498,504,235,503,738
1000,511,484,481,255,484,739
1000,528,519,498,269,477,746
1000,493,481,494,233,507,740
1000,511,491,477,258,486,744
1000,496,493,488,245,487,732
1000,507,485,511,255,501,756
1000,483,507,484,250,489,739
1000,505,508,478,255,492,747
1000,514,507,519,261,507,768
1000,508,518,496,257,473,730
1000,489,516,485,247,484,731
1000,516,520,506,269,498,767
1000,489,486,488,238,509,747
1000,492,497,497,232,504,736
1000,495,499,478,252,498,750
1000,516,476,514,252,500,752
1000,489,501,504,222,535,757
1000,486,501,511,246,493,739
1000,508,490,485,254,495,749
1000,514,533,491,275,493,768
1000,497,512,517,272,483,755
1000,502,501,508,261,504,765
1000,495,531,491,261,483,744
1000,509,489,465,249,480,729
1000,501,508,504,257,489,746
1000,457,495,502,233,493,726
1000,516,514,514,280,481,761
1000,498,495,485,236,513,749
1000,490,514,513,253,502,755
1000,499,494,494,235,510,745
1000,530,520,509,279,486,765
1000,494,494,487,237,506,743
1000,498,498,505,255,504,759
1000,521,508,522,283,476,759
1000,508,479,491,242,512,754
1000,485,505,492,242,484,726
1000,507,487,504,247,524,771
1000,524,482,519,252,528,780
1000,492,525,487,248,491,739
1000,490,516,497,260,490,750
1000,513,486,512,242,513,755
1000,508,497,480,249,497,746
1000,523,511,507,267,483,750
1000,481,511,513,248,499,747
1000,494,468,499,212,524,736
1000,498,499,529,253,514,767
1000,519,500,495,262,497,759
1000,500,506,493,250,498,748
1000,513,521,513,269,498,767
1000,488,498,497,243,493,736
1000,490,509,500,238,506,744
1000,495,503,494,250,496,746
1000,496,513,530,244,521,765
1000,448,534,511,229,493,722
1000,507,506,517,261,501,762
1000,492,495,496,238,497,735
1000,506,505,486,265,491,756
1000,507,500,495,249,499,748
1000,508,514,511,270,482,752
1000,529,486,514,258,496,754
1000,492,523,524,257,510,767
1000,516,494,478,258,487,745
1000,494,488,506,230,523,753
1000,512,490,474,250,481,731
1000,526,477,524,255,529,784
1000,475,530,501,254,488,742
1000,493,522,499,266,474,740
1000,499,481,492,224,526,750
1000,486,526,482,258,462,720
1000,488,512,491,235,507,742
1000,519,506,493,264,494,758
1000,486,517,495,253,482,735
1000,532,476,525,260,520,780
1000,509,527,497,263,488,751
1000,487,496,492,243,500,743
1000,463,492,498,223,505,728
1000,503,504,502,256,499,755
1000,502,473,489,221,518,739
1000,478,516,495,249,496,745
1000,511,512,508,256,503,759
1000,495,514,500,252,493,745
1000,483,504,483,252,487,739
1000,492,484,487,218,537,755
1000,496,505,521,245,517,762
1000,508,480,516,245,508,753
1000,512,480,485,239,515,754
1000,513,499,517,240,520,760
1000,481,513,504,249,501,750
1000,501,543,495,268,478,746
1000,480,506,482,250,478,728
1000,514,490,516,247,508,755
1000,510,509,501,265,489,754
1000,500,505,472,256,482,738
1000,494,494,527,249,504,753
1000,499,509,501,247,498,745
1000,499,491,519,256,503,759
1000,504,507,476,263,472,735
1000,490,516,493,253,493,746
1000,503,492,509,246,509,755
1000,470,507,489,253,482,735
1000,493,498,490,257,479,736
1000,486,466,495,222,535,757
1000,497,524,493,260,481,741
1000,491,498,512,258,485,743
1000,523,474,521,240,534,774
1000,488,520,504,250,515,765
1000,502,481,523,247,514,761
1000,511,487,477,251,498,749
1000,500,485,522,244,528,772
1000,496,479,509,228,538,766
1000,524,498,487,272,469,741
1000,497,495,491,254,492,746
1000,536,529,521,285,504,789
1000,526,488,508,264,509,773
1000,516,452,500,231,523,754
1000,498,499,511,242,506,748
1000,491,491,492,238,507,745
1000,529,523,518,266,505,771
1000,494,487,529,247,521,768
1000,489,502,515,249,494,743
1000,488,508,500,234,505,739
1000,489,502,499,235,514,749
1000,503,490,519,257,511,768
1000,499,500,511,243,526,769
1000,498,485,486,241,499,740
1000,482,492,506,232,504,736
1000,493,538,508,257,478,735
1000,523,486,487,268,500,768
1000,538,529,462,287,447,734
1000,512,544,536,292,482,774
1000,491,491,499,235,495,730
1000,490,511,499,255,477,732
1000,488,480,525,234,537,771
1000,517,489,510,264,497,761
1000,510,515,499,265,476,741
1000,519,499,472,252,491,743
1000,505,491,486,246,506,752
1000,516,471,517,248,520,768
1000,486,512,518,248,496,744
1000,480,509,514,244,502,746
1000,507,474,493,247,514,761
1000,508,486,506,241,500,741
1000,471,514,515,245,491,736
1000,507,514,506,267,490,757
1000,521,484,503,266,488,754
1000,478,463,495,230,498,728
1000,493,513,501,246,505,751
1000,509,472,485,234,509,743
1000,510,504,491,261,466,727
1000,507,469,472,236,511,747
1000,509,486,465,246,483,729
1000,462,514,515,246,494,740
1000,506,486,486,254,492,746
1000,507,500,515,260,488,748
1000,516,489,487,246,508,754
1000,515,507,494,271,480,751
1000,499,527,504,267,484,751
1000,479,493,496,242,491,733
1000,478,525,535,254,494,748
1000,493,517,526,254,513,767
1000,519,473,503,240,510,750
1000,455,464,499,199,535,734
1000,473,533,504,264,468,732
1000,516,515,474,264,475,739
1000,523,483,511,245,514,759
1000,508,518,490,268,476,744
1000,518,518,481,286,466,752
1000,535,509,485,255,514,769
1000,497,515,491,262,493,755
1000,528,472,506,252,502,754
1000,531,510,487,276,481,757
1000,498,501,495,249,497,746
1000,500,511,495,253,503,756
1000,464,512,474,246,473,719
1000,475,520,506,248,480,728
1000,522,507,509,258,510,768
1000,471,513,534,238,512,750
1000,483,495,483,233,493,726
1000,504,524,503,274,479,753
1000,494,507,483,237,501,738
1000,507,500,486,255,489,744
1000,506,494,501,251,517,768
1000,473,513,510,239,504,743
1000,503,498,510,254,509,763
1000,496,518,477,248,502,750
1000,486,480,506,250,494,744
1000,498,510,515,244,520,764
1000,494,510,478,262,465,727
1000,507,487,514,232,530,762
1000,502,520,510,253,507,760
1000,496,477,480,237,498,735
1000,509,513,493,256,501,757
1000,487,504,511,244,511,755
1000,531,494,516,270,503,773
1000,461,478,475,219,506,725
1000,498,485,514,239,516,755
1000,507,464,496,227,533,760
1000,479,507,492,248,489,737
1000,518,489,479,254,508,762
1000,491,495,489,228,514,742
1000,526,486,494,251,524,775
1000,505,481,495,226,531,757
1000,503,494,484,248,489,737
1000,484,504,499,230,512,742
1000,509,520,518,265,496,761
1000,492,526,511,262,495,757
1000,471,497,518,222,524,746
1000,507,510,524,251,518,769
1000,506,468,516,237,523,760
1000,500,502,516,237,509,746
1000,510,511,495,252,475,727
1000,479,528,509,251,495,746
1000,504,498,511,255,500,755
1000,512,481,494,235,523,758
1000,488,476,511,222,529,751
1000,523,506,491,265,484,749
1000,475,521,491,240,492,732
1000,486,499,517,252,509,761
1000,473,510,491,241,487,728
1000,502,517,509,270,487,757
1000,506,472,495,229,512,741
1000,481,470,511,227,517,744
1000,509,518,505,272,492,764
1000,514,507,505,263,504,767
1000,518,512,507,268,503,771
1000,532,515,504,278,489,767
1000,493,504,494,253,479,732
1000,483,518,513,251,486,737
1000,512,501,486,258,493,751
1000,500,490,494,259,487,746
1000,510,502,500,251,512,763
1000,485,516,467,240,478,718
1000,531,507,483,259,484,743
1000,501,488,491,252,488,740
1000,499,512,501,248,500,748
1000,492,505,489,261,484,745
1000,485,496,517,246,502,748
1000,520,498,509,257,498,755
1000,496,514,493,258,489,747
1000,499,500,525,254,514,768
1000,500,508,481,244,500,744
1000,500,525,477,251,483,734
1000,505,472,505,247,509,756
1000,508,495,488,251,504,755
1000,511,504,475,251,493,744
1000,479,503,497,248,482,730
1000,478,531,522,257,489,746
1000,501,509,523,260,506,766
1000,491,496,493,253,489,742
1000,500,478,500,246,505,751
1000,474,513,493,253,489,742
1000,498,500,510,256,514,770
1000,522,490,493,265,481,746
1000,504,514,482,247,489,736
1000,519,515,506,252,514,766
1000,487,490,486,245,505,750
1000,505,479,498,233,519,752
1000,486,502,515,254,491,745
1000,532,485,483,248,516,764
1000,502,503,503,253,500,753
1000,513,493,519,252,510,762
1000,499,491,513,242,510,752
1000,511,501,482,252,497,749
1000,479,503,501,246,495,741
1000,490,497,519,232,524,756
1000,500,500,490,245,490,735
1000,482,491,481,235,515,750
1000,499,510,492,252,496,748
1000,508,494,505,260,497,757
1000,499,473,510,234,515,749
1000,521,484,490,252,503,755
1000,511,492,517,262,512,774
1000,508,523,485,277,468,745
1000,505,506,492,244,507,751
1000,508,506,512,256,503,759
1000,490,501,523,254,510,764
1000,515,504,492,260,497,757
1000,484,516,505,245,511,756
1000,522,517,499,274,497,771
1000,452,517,480,230,474,704
1000,539,487,520,258,520,778
1000,507,505,498,249,514,763
1000,508,519,517,281,479,760
1000,491,503,486,255,484,739
1000,501,496,505,244,496,740
1000,507,473,488,239,510,749
1000,479,507,510,248,501,749
1000,499,476,478,228,517,745
1000,513,499,515,252,521,773
1000,505,503,524,266,491,757
1000,475,490,490,231,500,731
1000,502,500,501,238,525,763
1000,526,531,483,281,477,758
1000,476,501,512,240,495,735
1000,495,538,489,261,496,757
1000,500,495,492,244,499,743
1000,454,509,497,236,489,725
1000,500,517,491,264,499,763
1000,511,535,475,271,472,743
1000,485,478,493,235,500,735
1000,504,494,492,251,505,756
1000,492,513,491,247,482,729
1000,502,491,520,258,504,762
1000,498,477,497,235,520,755
1000,492,500,469,246,472,718
1000,513,507,495,253,501,754
1000,486,493,494,235,509,744
1000,497,490,514,248,504,752
1000,492,486,507,240,530,770
1000,544,519,516,285,492,777
1000,498,505,500,259,488,747
1000,514,484,484,241,515,756
1000,495,494,492,254,478,732
1000,497,478,487,240,504,744
1000,498,506,521,246,509,755
1000,469,493,488,239,487,726
1000,509,487,498,251,502,753
1000,503,512,492,248,504,752
1000,488,525,470,274,458,732
1000,535,523,483,285,468,753
1000,518,501,548,252,529,781
1000,496,513,488,242,509,751
1000,513,517,519,265,499,764
1000,530,491,502,258,503,761
1000,490,513,478,258,464,722
1000,504,522,493,276,476,752
1000,506,491,534,253,521,774
1000,485,528,499,255,488,743
1000,500,495,495,251,496,747
1000,498,487,492,245,507,752
1000,463,501,543,231,521,752
1000,492,520,500,236,518,754
1000,522,487,522,247,530,777
1000,488,474,504,229,527,756
1000,503,490,501,245,489,734
1000,533,509,504,279,478,757
1000,504,514,480,256,495,751
1000,507,495,481,252,494,746
1000,492,495,477,241,495,736
1000,518,503,483,270,485,755
1000,540,499,485,266,490,756
1000,489,520,474,251,487,738
1000,484,493,503,241,502,743
1000,475,495,487,236,500,736
1000,481,509,499,228,511,739
1000,486,477,511,238,517,755
1000,482,507,498,249,487,736
1000,498,473,514,222,528,750
1000,502,528,501,266,490,756
1000,494,475,499,228,524,752
1000,507,517,506,261,499,760
1000,504,507,507,247,513,760
1000,516,496,505,249,508,757
1000,501,513,506,251,499,750
1000,533,507,493,261,492,753
1000,483,496,495,235,507,742
1000,519,484,541,249,529,778
1000,507,509,517,267,502,769
1000,484,482,501,246,494,740
1000,518,497,529,272,496,768
1000,517,475,502,260,498,758
1000,513,510,506,260,508,768
1000,528,519,494,266,485,751
1000,476,483,516,229,515,744
1000,494,485,493,231,516,747
1000,504,497,484,236,507,743
1000,501,489,481,246,505,751
1000,517,504,523,262,504,766
1000,497,498,528,250,515,765
1000,517,507,488,272,471,743
1000,483,497,474,229,516,745
1000,486,505,482,245,507,752
1000,471,503,481,234,487,721
1000,463,489,529,235,505,740
1000,476,505,497,234,505,739
1000,496,514,524,258,509,767
1000,495,486,502,254,492,746
1000,508,550,495,281,477,758
1000,500,507,496,262,494,756
1000,504,502,487,247,507,754
1000,508,516,493,267,481,748
1000,507,530,511,278,476,754
1000,518,522,478,270,478,748
1000,484,487,491,238,498,736
1000,503,476,499,238,505,743
1000,494,495,501,225,523,748
1000,518,537,499,289,469,758
1000,497,507,506,250,507,757
1000,503,524,506,278,482,760
1000,515,511,475,266,482,748
1000,526,503,524,271,511,782
1000,497,479,484,239,506,745
1000,518,513,501,254,504,758
1000,526,504,534,281,502,783
1000,489,481,504,240,519,759
1000,494,508,467,225,501,726
1000,498,510,497,251,496,747
1000,501,479,497,238,521,759
1000,488,496,480,230,492,722
1000,509,492,499,253,513,766
1000,494,489,503,235,524,759
1000,495,509,500,257,492,749
1000,486,503,518,240,505,745
1000,483,525,499,252,498,750
1000,489,517,487,247,492,739
1000,507,490,519,245,518,763
1000,507,492,536,256,518,774
1000,538,498,488,267,495,762
1000,494,489,506,252,492,744
1000,507,516,509,254,489,743
1000,489,515,497,253,479,732
1000,521,507,517,250,524,774
1000,485,493,489,234,522,756
1000,474,516,503,263,470,733
1000,500,496,493,255,500,755
1000,486,485,483,241,482,723
1000,493,479,501,232,504,736
1000,500,517,502,252,508,760
1000,508,515,483,265,467,732
1000,486,507,524,254,504,758
1000,526,498,456,259,472,731
1000,500,490,532,253,513,766
1000,490,512,511,250,499,749
1000,494,505,513,246,504,750
1000,515,525,490,257,498,755
1000,509,493,536,225,552,777
1000,500,503,481,246,487,733
1000,495,481,503,247,494,741
1000,497,500,488,245,503,748
1000,502,530,521,264,493,757
1000,472,480,529,216,533,749
1000,481,502,511,236,510,746
1000,502,504,488,245,502,747
1000,524,484,502,269,486,755
1000,518,516,520,265,502,767
1000,490,501,500,251,491,742
1000,513,527,513,264,503,767
1000,521,524,471,280,474,754
1000,495,500,493,233,515,748
1000,507,486,509,236,532,768
1000,472,502,470,232,489,721
1000,521,507,517,261,516,777
1000,534,508,494,276,495,771
1000,505,513,495,255,492,747
1000,489,480,504,226,520,746
1000,502,492,511,245,511,756
1000,498,505,504,257,499,756
1000,510,515,487,260,486,746
1000,506,494,509,250,494,744
1000,502,502,491,247,505,752
1000,496,488,491,257,496,753
1000,497,485,494,239,506,745
1000,515,528,463,268,469,737
1000,527,517,522,265,511,776
1000,519,521,527,284,481,765
1000,505,476,479,237,504,741
1000,509,488,488,241,490,731
1000,524,502,523,259,525,784
1000,493,499,515,255,496,751
1000,486,504,478,239,507,746
1000,486,501,513,240,506,746
1000,484,500,493,227,502,729
1000,507,506,489,255,499,754
1000,495,475,503,247,496,743
1000,501,503,513,262,487,749
1000,477,499,502,224,516,740
1000,506,479,493,255,494,749
1000,486,492,498,239,518,757
1000,522,519,486,257,504,761
1000,514,515,519,276,502,778
1000,513,526,506,263,503,766
1000,450,495,490,215,503,718
1000,473,528,499,242,498,740
1000,512,479,493,238,511,749
1000,487,493,487,255,474,729
1000,494,500,474,225,495,720
1000,497,493,507,233,515,748
1000,487,477,503,248,495,743
1000,502,506,506,258,481,739
1000,485,500,492,245,491,736
1000,495,497,507,245,512,757
1000,520,489,489,245,516,761
1000,470,510,504,249,502,751
1000,502,492,497,246,504,750
1000,496,470,502,242,498,740
1000,504,497,493,249,505,754
1000,522,498,494,255,501,756
1000,518,476,507,254,493,747
1000,510,498,470,245,490,735
1000,502,489,525,246,502,748
1000,492,514,506,251,497,748
1000,528,499,498,248,509,757
1000,500,505,510,247,493,740
1000,491,490,494,243,504,747
1000,494,525,504,254,492,746
1000,480,489,504,217,531,748
1000,538,514,479,269,482,751
1000,507,492,480,255,486,741
1000,508,473,506,237,514,751
1000,493,484,451,240,487,727
1000,496,475,505,240,513,753
1000,493,488,507,245,506,751
1000,502,499,495,260,481,741
1000,510,522,499,271,489,760
1000,488,473,507,234,522,756
1000,495,497,503,234,514,748
1000,469,495,475,244,476,720
1000,508,498,479,254,494,748
1000,500,475,463,240,504,744
1000,491,504,505,259,496,755
1000,485,502,497,248,491,739
1000,484,501,517,250,485,735
1000,484,513,471,242,491,733
1000,510,495,481,254,482,736
1000,502,488,488,239,499,738
1000,466,498,519,228,501,729
1000,519,500,508,263,518,781
1000,517,503,519,258,517,775
1000,505,492,510,236,511,747
1000,479,499,522,243,508,751
1000,514,513,489,261,490,751
1000,507,493,481,250,487,737
1000,482,490,495,231,504,735
1000,531,516,511,272,496,768
1000,492,508,460,250,469,719
1000,502,506,480,241,509,750
1000,490,525,490,277,451,728
1000,487,458,525,219,547,766
1000,467,492,517,227,529,756
1000,476,487,476,234,497,731
1000,489,480,467,240,478,718
1000,531,506,521,262,504,766
1000,532,515,503,265,494,759
1000,504,531,524,273,489,762
1000,532,514,511,269,495,764
1000,474,486,489,223,513,736
1000,519,454,486,250,498,748
1000,531,527,531,273,496,769
1000,498,491,492,251,500,751
1000,519,496,490,253,494,747
1000,524,506,509,257,510,767
1000,496,495,488,251,505,756
1000,499,513,515,260,501,761
1000,507,492,488,243,504,747
1000,500,504,501,263,483,746
1000,479,499,500,252,492,744
1000,486,498,486,233,502,735
1000,513,537,484,271,475,746
1000,489,498,511,248,495,743
1000,485,513,492,260,473,733
1000,504,490,507,242,523,765
1000,487,481,506,226,517,743
1000,498,498,488,256,486,742
1000,501,511,508,256,510,766
1000,499,496,533,234,513,747
1000,522,482,488,253,519,772
1000,480,520,502,255,482,737
1000,499,530,499,266,493,759
1000,490,523,510,263,494,757
1000,479,518,500,250,491,741
1000,478,520,487,234,496,730
1000,523,494,491,258,515,773
1000,504,493,496,242,515,757
1000,516,477,516,243,512,755
1000,490,494,504,233,523,756
1000,495,527,496,255,494,749
1000,493,488,466,242,473,715
1000,516,501,537,274,501,775
1000,491,529,497,253,479,732
1000,487,497,494,250,481,731
1000,512,499,518,253,525,778
1000,499,508,503,262,494,756
1000,503,469,491,235,512,747
1000,512,525,531,274,496,770
1000,496,480,480,229,494,723
1000,499,528,524,269,488,757
1000,517,529,474,270,473,743
1000,541,518,520,279,506,785
1000,522,512,500,261,497,758
1000,485,526,508,264,488,752
1000,503,496,482,255,474,729
1000,512,514,523,249,518,767
1000,525,453,498,228,523,751
1000,502,475,496,249,511,760
1000,491,517,519,249,496,745
1000,497,501,477,252,487,739
1000,495,494,490,247,494,741
1000,508,493,483,251,498,749
1000,493,495,508,236,511,747
1000,490,522,519,260,490,750
1000,535,522,527,272,517,789
1000,508,514,503,256,491,747
1000,468,487,522,224,515,739
1000,475,521,522,242,506,748
1000,522,494,522,268,512,780
1000,499,499,502,250,502,752
1000,511,499,522,252,512,764
1000,507,495,513,251,498,749
1000,500,513,487,256,488,744
1000,525,492,483,257,498,755
1000,491,484,524,229,528,757
1000,473,493,516,229,516,745
1000,494,508,517,256,508,764
1000,504,487,502,230,520,750
1000,491,510,496,266,469,735
1000,490,512,523,253,491,744
1000,499,506,524,257,504,761
1000,523,504,521,252,511,763
1000,495,495,511,246,512,758
1000,507,494,528,255,511,766
1000,523,482,512,249,511,760
1000,511,510,518,270,505,775
1000,483,530,529,265,509,774
1000,485,501,492,234,499,733
1000,490,507,490,246,498,744
1000,468,490,491,229,498,727
1000,492,498,534,237,527,764
1000,506,534,487,269,476,745
1000,504,500,510,246,503,749
1000,520,509,502,278,489,767
1000,509,517,504,260,501,761
1000,513,501,509,256,506,762
1000,509,501,498,251,493,744
1000,521,520,491,274,472,746
1000,509,506,495,249,509,758
1000,483,533,495,256,493,749
1000,479,508,528,236,534,770
1000,485,533,512,244,506,750
1000,483,481,483,234,505,739
1000,478,524,500,259,489,748
1000,536,502,501,266,497,763
1000,502,497,482,247,494,741
1000,512,527,456,265,471,736
1000,490,508,505,238,515,753
1000,518,506,482,265,490,755
1000,481,499,476,234,503,737
1000,510,540,505,268,483,751
1000,508,530,459,272,452,724
1000,455,486,459,217,497,714
1000,500,486,493,248,506,754
1000,525,499,521,247,526,773
1000,493,500,459,254,475,729
1000,502,487,492,257,500,757
1000,469,482,491,230,496,726
1000,500,518,481,273,475,748
1000,477,517,521,247,498,745
1000,500,506,452,244,478,722
1000,489,531,505,262,484,746
1000,483,513,505,249,508,757
1000,538,480,516,247,527,774
1000,510,473,468,238,501,739
1000,518,518,499,272,484,756
1000,498,499,527,254,500,754
1000,505,491,499,239,502,741
1000,505,533,481,269,457,726
1000,461,496,511,227,519,746
1000,510,525,518,279,486,765
1000,504,507,470,264,482,746
1000,465,518,508,228,501,729
1000,505,521,502,263,493,756
1000,513,501,478,256,501,757
1000,508,493,512,240,510,750
1000,534,508,505,269,501,770
1000,500,484,461,240,482,722
1000,519,524,501,261,501,762
1000,518,494,528,266,507,773
1000,510,475,502,249,514,763
1000,506,503,471,253,475,728
1000,504,503,508,254,506,760
1000,474,474,506,229,516,745
1000,485,490,501,234,520,754
1000,507,496,503,260,486,746
1000,507,493,516,251,500,751
1000,496,513,491,242,503,745
1000,487,492,534,227,537,764
1000,483,501,511,244,519,763
1000,496,513,489,280,455,735
1000,466,500,504,223,512,735
1000,517,524,494,270,493,763
1000,504,522,505,266,495,761
1000,481,473,495,220,513,733
1000,513,485,491,243,517,760
1000,506,490,487,242,500,742
1000,506,526,491,240,520,760
1000,499,493,505,251,485,736
1000,516,468,485,244,492,736
1000,510,494,512,247,518,765
1000,512,492,501,256,504,760
1000,515,504,494,267,490,757
1000,492,489,471,235,492,727
1000,488,501,534,240,509,749
1000,474,505,464,230,485,715
1000,488,497,483,240,502,742
1000,496,500,498,251,485,736
1000,506,494,474,241,507,748
1000,533,481,511,259,507,766
1000,481,497,486,230,499,729
1000,497,508,486,243,486,729
1000,494,517,508,264,486,750
1000,493,505,530,236,524,760
1000,509,501,504,251,499,750
1000,515,503,505,260,496,756
1000,515,535,515,275,487,762
1000,524,526,461,274,473,747
1000,494,509,499,254,483,737
1000,493,484,510,239,510,749
1000,503,511,497,256,500,756
1000,471,513,524,238,515,753
1000,508,503,492,257,502,759
1000,508,483,492,244,520,764
1000,487,511,510,249,500,749
1000,491,509,505,246,496,742
1000,485,519,480,243,484,727
1000,499,495,484,234,507,741
1000,483,509,486,243,479,722
1000,503,520,524,256,517,773
1000,504,514,488,262,480,742
1000,454,518,508,238,495,733
1000,518,494,503,242,524,766
1000,480,493,491,233,512,745
1000,494,504,524,258,507,765
1000,501,485,478,257,473,730
1000,507,498,496,255,486,741
1000,494,519,493,247,507,754
1000,515,482,510,250,523,773
1000,503,491,479,246,485,731
1000,489,475,503,241,495,736
1000,484,491,514,220,537,757
1000,512,516,493,268,482,750
1000,509,489,512,236,532,768
1000,497,511,506,235,516,751
1000,495,498,493,235,490,725
1000,507,487,503,244,527,771
1000,516,499,488,269,485,754
1000,492,509,494,247,503,750
1000,502,515,488,256,476,732
1000,503,482,482,252,481,733
1000,506,506,492,257,500,757
1000,522,503,504,265,496,761
1000,505,512,502,265,484,749
1000,492,499,502,253,513,766
1000,503,504,499,251,492,743
1000,478,457,524,205,550,755
1000,513,504,512,259,499,758
1000,501,505,510,252,512,764
1000,493,505,508,250,499,749
1000,519,499,525,261,501,762
1000,520,489,514,235,524,759
1000,496,510,515,247,507,754
1000,503,514,498,271,492,763
1000,498,495,527,254,517,771
1000,495,496,497,265,476,741
1000,520,493,519,254,530,784
1000,509,479,490,246,499,745
1000,507,509,483,257,478,735
1000,489,520,499,251,493,744
1000,487,500,473,250,481,731
1000,498,470,489,238,511,749
1000,493,498,476,253,488,741
1000,482,517,516,240,521,761
1000,508,466,502,230,521,751
1000,503,470,500,227,520,747
1000,482,495,494,244,495,739
1000,497,498,500,251,488,739
1000,501,503,514,255,493,748
1000,500,508,499,259,488,747
1000,506,493,513,234,527,761
1000,494,511,493,261,481,742
1000,503,515,527,262,503,765
1000,507,502,502,246,503,749
1000,507,489,509,258,512,770
1000,536,515,476,283,471,754
1000,469,506,497,238,483,721
1000,475,478,516,234,519,753
1000,516,515,509,277,487,764
1000,514,504,495,248,511,759
1000,492,509,491,230,520,750
1000,486,493,518,245,529,774
1000,531,487,539,251,533,784
1000,504,473,510,228,537,765
1000,496,512,497,255,493,748
1000,490,489,504,236,513,749
1000,524,502,475,247,500,747
1000,489,530,539,247,532,779
1000,518,529,509,272,479,751
1000,477,510,510,240,509,749
1000,503,516,505,268,482,750
1000,489,498,487,243,498,741
1000,508,510,494,271,482,753
1000,502,525,500,269,485,754
1000,500,500,508,246,513,759
1000,494,519,497,251,478,729
1000,499,508,522,248,514,762
1000,486,480,512,242,510,752
1000,494,498,509,238,511,749
1000,477,501,484,253,486,739
1000,503,492,527,246,516,762
1000,483,500,498,232,518,750
1000,503,498,522,237,526,763
1000,481,497,515,227,510,737
1000,556,480,508,262,508,770
1000,516,489,503,262,493,755
1000,510,507,521,258,499,757
1000,489,474,511,235,524,759
1000,507,501,485,251,492,743
1000,505,515,513,260,505,765
1000,508,509,501,246,519,765
1000,491,509,504,240,505,745
1000,505,505,508,255,493,748
1000,512,526,533,265,511,776
1000,503,499,493,266,481,747
1000,507,499,466,266,466,732
1000,477,482,511,229,528,757
1000,499,518,515,270,499,769
1000,494,502,492,265,481,746
1000,485,519,517,247,515,762
1000,498,483,491,237,517,754
1000,522,495,472,249,490,739
1000,476,480,503,211,527,738
1000,513,521,528,263,500,763
1000,522,501,488,255,490,745
1000,514,478,478,268,483,751
1000,493,513,491,253,503,756
1000,504,499,474,243,510,753
1000,506,512,512,256,500,756
1000,502,491,517,242,517,759
1000,492,498,527,245,509,754
1000,486,504,507,248,510,758
1000,496,477,500,242,508,750
1000,490,505,487,255,507,762
1000,524,488,493,268,496,764
1000,499,495,486,247,494,741
1000,473,504,500,233,503,736
1000,489,501,520,253,501,754
1000,496,488,468,244,492,736
1000,501,508,516,256,507,763
1000,498,500,502,259,494,753
1000,475,522,499,255,472,727
1000,522,489,504,255,513,768
1000,516,480,490,247,501,748
1000,511,496,496,250,505,755
1000,491,525,528,261,503,764
1000,493,519,485,256,505,761
1000,499,511,477,246,504,750
1000,540,490,493,252,511,763
1000,512,467,508,243,526,769
1000,534,493,491,263,501,764
1000,533,546,498,294,472,766
1000,502,505,497,248,511,759
1000,521,484,499,251,514,765
1000,509,495,497,274,488,762
1000,492,479,515,234,524,758
1000,498,496,512,244,523,767
1000,490,499,511,242,512,754
1000,504,506,514,254,516,770
1000,496,504,498,240,495,735
1000,485,519,493,248,494,742
1000,498,521,522,257,501,758
1000,481,498,502,242,498,740
1000,496,489,513,253,509,762
1000,495,512,490,267,466,733
1000,487,516,515,247,505,752
1000,513,484,495,248,513,761
1000,499,504,500,256,490,746
1000,514,501,492,253,499,752
1000,510,508,494,273,482,755
1000,501,481,485,242,510,752
1000,491,510,484,262,480,742
1000,514,490,495,229,521,750
1000,508,508,528,256,508,764
1000,523,502,509,271,499,770
1000,481,527,500,263,470,733
1000,518,495,513,259,504,763
1000,505,503,485,254,504,758
1000,489,521,517,247,516,763
1000,509,492,517,253,507,760
1000,495,494,486,239,505,744
1000,502,507,510,252,497,749
1000,477,490,532,248,515,763
1000,523,503,528,270,509,779
1000,508,485,499,244,510,754
1000,515,523,462,279,460,739
1000,486,526,504,252,493,745
1000,498,517,493,256,480,736
1000,487,490,484,248,492,740
1000,522,480,508,275,486,761
1000,486,519,504,241,513,754
1000,518,485,522,237,529,766
1000,487,496,498,248,483,731
1000,497,524,497,254,495,749
1000,515,515,492,276,474,750
1000,483,505,515,245,506,751
1000,497,460,498,236,515,751
1000,499,473,519,223,531,754
1000,486,522,483,250,508,758
1000,507,518,506,260,500,760
1000,507,481,496,234,510,744
1000,504,490,500,245,515,760
1000,496,490,511,239,511,750
1000,509,475,472,239,494,733
1000,462,476,519,217,536,753
1000,492,470,520,240,522,762
1000,486,492,489,239,499,738
1000,489,479,492,241,501,742
1000,501,489,490,242,506,748
1000,495,491,505,249,491,740
1000,483,486,520,247,513,760
1000,504,495,512,251,499,750
1000,475,494,517,240,501,741
1000,515,496,517,267,505,772
1000,539,495,498,247,521,768
1000,503,479,527,231,537,768
1000,496,535,522,258,504,762
1000,500,476,523,243,517,760
1000,475,508,513,250,496,746
1000,493,504,528,259,496,755
1000,480,467,488,216,521,737
1000,480,507,518,234,510,744
1000,497,524,464,260,485,745
1000,518,476,521,237,524,761
1000,524,488,501,255,507,762
1000,487,499,499,250,507,757
1000,522,485,504,240,517,757
1000,488,494,503,245,497,742
1000,493,488,485,261,491,752
1000,503,502,494,253,486,739
1000,513,491,492,247,502,749
1000,497,491,486,250,504,754
1000,480,499,514,249,500,749
1000,493,519,514,251,499,750
1000,514,496,481,262,481,743
1000,525,506,483,246,497,743
1000,509,492,526,247,529,776
1000,499,533,509,261,495,756
1000,489,510,520,255,505,760
1000,502,504,507,255,495,750
1000,506,523,497,264,477,741
1000,497,513,516,243,519,762
1000,482,512,511,246,511,757
1000,496,498,496,258,495,753
1000,493,523,535,265,492,757
1000,508,519,519,267,494,761
1000,491,514,502,261,484,745
1000,502,489,504,246,510,756
1000,492,481,534,239,527,766
1000,492,506,527,261,502,763
1000,498,485,510,242,512,754
1000,505,488,515,245,509,754
1000,491,503,522,258,494,752
1000,504,513,525,251,515,766
1000,457,530,501,251,475,726
1000,482,487,518,241,504,745
1000,489,501,509,254,487,741
1000,506,519,501,245,512,757
1000,493,486,483,233,518,751
1000,482,488,506,235,504,739
1000,511,524,477,270,473,743
1000,515,486,506,259,499,758
1000,488,514,496,262,481,743
1000,519,518,497,264,500,764
1000,520,499,514,253,505,758
1000,515,500,506,256,508,764
1000,508,519,493,259,475,734
1000,503,516,498,250,501,751
1000,529,481,506,245,522,767
1000,494,515,491,266,467,733
1000,499,511,477,250,493,743
1000,486,487,494,239,517,756
1000,504,492,498,250,502,752
1000,492,489,502,244,507,751
1000,498,494,524,254,511,765
1000,481,474,489,217,522,739
1000,488,475,498,240,509,749
1000,502,516,466,267,467,734
1000,491,474,499,218,528,746
1000,537,485,503,260,512,772
1000,491,520,520,245,510,755
1000,503,469,496,233,523,756
1000,480,500,496,253,489,742
1000,505,502,499,251,513,764
1000,491,481,541,241,538,779
1000,495,520,511,249,500,749
1000,508,500,522,266,501,767
1000,501,494,519,246,518,764
1000,476,499,511,229,516,745
1000,471,498,491,242,497,739
1000,513,511,501,256,505,761
1000,486,513,493,253,491,744
1000,511,510,482,265,484,749
1000,491,527,538,263,496,759
1000,482,474,486,219,529,748
1000,492,487,504,233,518,751
1000,497,491,508,240,507,747
1000,528,485,489,236,532,768
1000,522,513,486,276,477,753
1000,514,516,467,275,481,756
1000,503,514,496,250,519,769
1000,496,479,486,248,498,746
1000,510,511,492,260,518,778
1000,499,489,517,257,494,751
1000,505,498,480,252,492,744
1000,519,494,516,264,497,761
1000,505,497,510,243,519,762
1000,473,518,543,254,508,762
1000,511,496,500,250,522,772
1000,499,503,491,243,493,736
1000,491,504,499,242,496,738
1000,510,510,478,263,476,739
1000,498,493,496,241,501,742
1000,498,515,518,252,503,755
1000,523,525,496,256,489,745
1000,475,506,462,232,481,713
1000,532,503,482,265,503,768
1000,505,477,522,225,534,759
1000,505,503,530,242,523,765
1000,498,512,514,275,485,760
1000,485,484,493,247,494,741
1000,465,503,518,230,523,753
1000,531,483,474,260,511,771
1000,507,497,492,253,501,754
1000,518,496,493,260,493,753
1000,522,497,538,261,530,791
1000,501,499,511,262,490,752
1000,475,506,475,236,490,726
1000,498,489,512,245,506,751
1000,501,514,495,281,468,749
1000,486,471,484,235,509,744
1000,504,519,495,259,494,753
1000,505,491,484,243,504,747
1000,516,508,488,272,488,760
1000,506,528,474,267,472,739
1000,485,488,528,217,532,749
1000,478,491,470,226,489,715
1000,484,504,510,232,526,758
1000,498,511,501,259,497,756
1000,509,474,489,234,500,734
1000,513,507,512,265,501,766
1000,495,506,497,255,492,747
1000,507,496,515,254,512,766
1000,498,515,471,262,466,728
1000,486,510,497,254,498,752
1000,512,499,499,250,498,748
1000,521,490,529,251,534,785
1000,473,497,519,237,522,759
1000,507,487,498,259,502,761
1000,486,494,491,229,528,757
1000,499,508,482,266,488,754
1000,489,490,493,237,511,748
1000,513,484,506,253,506,759
1000,476,501,497,242,488,730
1000,497,533,499,260,493,753
1000,492,469,502,237,519,756
1000,542,498,495,269,496,765
1000,488,515,510,254,494,748
1000,489,485,512,238,514,752
1000,495,520,491,270,479,749
1000,485,463,510,215,529,744
1000,519,490,518,259,503,762
1000,487,510,507,248,499,747
1000,492,513,479,266,472,738
1000,527,480,499,239,529,768
1000,485,508,502,243,498,741
1000,494,481,473,234,500,734
1000,499,507,522,247,513,760
1000,469,492,496,227,516,743
1000,526,502,530,268,521,789
1000,498,489,491,236,506,742
1000,542,523,539,286,498,784
1000,511,485,516,249,505,754
1000,508,521,496,274,461,735
1000,530,489,515,250,516,766
1000,523,484,510,253,519,772
1000,507,487,502,242,511,753
1000,506,484,529,245,533,778
1000,495,488,477,239,494,733
1000,462,502,525,233,503,736
1000,510,502,491,255,486,741
1000,474,483,489,231,499,730
1000,499,507,497,254,496,750
1000,523,467,528,233,531,764
1000,514,534,494,263,484,747
1000,481,523,507,261,484,745
1000,501,519,534,268,501,769
1000,497,493,499,253,495,748
1000,505,503,495,253,497,750
1000,514,496,499,266,496,762
1000,489,465,487,227,512,739
1000,509,511,509,263,502,765
1000,493,498,502,239,513,752
1000,500,484,513,235,517,752
1000,511,501,494,250,512,762
1000,515,499,480,272,498,770
1000,493,493,514,247,507,754
1000,512,485,497,250,517,767
1000,506,508,506,252,495,747
1000,505,481,477,244,500,744
1000,540,477,463,271,481,752
1000,502,523,531,270,502,772
1000,507,506,488,254,486,740
1000,506,489,492,240,510,750
1000,524,529,504,271,502,773
1000,530,493,468,269,473,742
1000,504,497,499,249,507,756
1000,510,489,495,267,491,758
1000,490,504,530,250,507,757
1000,473,496,523,227,528,755
1000,503,499,515,243,511,754
1000,491,501,481,250,488,738
1000,505,507,484,250,507,757
1000,523,512,498,272,490,762
1000,517,498,470,256,485,741
1000,468,483,509,226,511,737
1000,504,484,512,232,535,767
1000,507,473,509,253,499,752
1000,500,475,466,237,493,730
1000,492,497,478,246,495,741
1000,492,512,499,250,503,753
1000,497,485,466,235,496,731
1000,514,522,496,249,498,747
1000,483,507,486,257,475,732
1000,505,511,487,246,505,751
1000,498,503,513,235,525,760
1000,502,505,510,262,482,744
1000,522,494,503,261,488,749
1000,508,487,503,245,508,753
1000,511,483,520,250,519,769
1000,506,495,511,250,521,771
1000,470,495,482,241,480,721
1000,519,477,492,267,484,751
1000,482,524,507,258,485,743
1000,486,500,503,256,494,750
1000,518,493,504,260,504,764
1000,519,487,465,253,487,740
1000,498,503,523,251,514,765
1000,494,513,505,253,503,756
1000,509,466,500,226,538,764
1000,488,510,498,262,489,751
1000,517,533,482,284,473,757
1000,496,516,509,253,495,748
1000,501,489,487,245,507,752
1000,515,513,511,261,499,760
1000,481,485,498,236,519,755
1000,485,506,489,239,499,738
1000,515,494,520,251,517,768
1000,487,488,502,231,512,743
1000,494,489,484,250,478,728
1000,499,483,500,236,525,761
1000,525,496,508,261,508,769
1000,515,500,482,263,473,736
1000,514,497,519,260,509,769
1000,506,487,467,251,477,728
1000,460,497,501,246,490,736
1000,480,511,508,249,491,740
1000,514,507,496,258,473,731
1000,481,486,520,235,520,755
1000,510,509,496,239,514,753
1000,494,510,506,243,508,751
1000,511,482,501,248,492,740
1000,492,496,496,241,510,751
1000,509,501,483,263,483,746
1000,483,516,520,245,511,756
1000,532,507,499,260,511,771
1000,484,520,484,243,479,722
1000,466,474,469,222,488,710
1000,507,492,507,250,506,756
1000,507,501,497,262,514,776
1000,489,469,513,233,530,763
1000,515,516,513,258,496,754
1000,505,513,475,275,466,741
1000,523,523,510,270,501,771
1000,491,508,497,259,478,737
1000,476,488,488,234,490,724
1000,495,484,502,239,501,740
1000,512,471,484,232,518,750
1000,513,483,474,260,470,730
1000,528,484,522,266,514,780
1000,493,492,496,234,504,738
1000,511,504,509,256,489,745
1000,477,495,498,256,479,735
1000,496,513,500,244,513,757
1000,499,487,493,237,510,747
1000,495,482,514,242,516,758
1000,493,473,491,232,510,742
1000,522,486,543,253,526,779
1000,479,499,490,249,479,728
1000,481,477,460,230,497,727
1000,509,498,518,257,509,766
1000,502,475,489,241,512,753
1000,508,506,481,262,478,740
1000,492,491,498,237,514,751
1000,474,494,479,229,507,736
1000,492,506,517,237,508,745
1000,496,521,494,254,481,735
1000,505,470,501,249,498,747
1000,490,515,473,227,494,721
1000,531,493,495,267,515,782
1000,519,485,505,259,501,760
1000,471,510,487,244,479,723
1000,510,509,495,252,508,760
1000,503,487,506,242,528,770
1000,470,523,519,253,504,757
1000,510,491,471,244,494,738
1000,499,500,471,244,505,749
1000,514,484,484,254,499,753
1000,486,500,506,241,501,742
1000,488,529,502,254,477,731
1000,499,542,513,262,493,755
1000,497,503,498,240,522,762
1000,516,489,512,245,518,763
1000,512,488,492,244,520,764
1000,506,486,511,245,515,760
1000,510,507,488,251,495,746
1000,487,490,489,235,495,730
1000,523,501,501,268,499,767
1000,480,512,485,232,502,734
1000,490,516,509,243,506,749
1000,453,508,510,236,483,719
1000,510,498,499,244,515,759
1000,498,510,517,253,499,752
1000,524,494,517,259,512,771
1000,506,478,497,237,518,755
1000,487,496,493,255,479,734
1000,504,477,493,249,508,757
1000,492,505,502,232,506,738
1000,512,482,505,240,523,763
1000,515,511,524,276,497,773
1000,468,487,529,241,492,733
1000,504,504,521,250,511,761
1000,503,487,479,260,482,742
1000,483,502,511,243,508,751
1000,502,481,525,241,519,760
1000,487,509,503,254,492,746
1000,504,462,482,237,514,751
1000,474,488,509,231,523,754
1000,540,521,491,285,474,759
1000,511,507,500,265,494,759
1000,505,473,488,235,511,746
1000,501,492,495,247,490,737
1000,497,498,517,258,496,754
1000,508,500,510,257,514,771
1000,507,482,491,246,500,746
1000,489,495,536,249,509,758
1000,496,510,489,262,486,748
1000,497,505,473,264,460,724
1000,511,487,478,250,490,740
1000,513,495,476,245,499,744
1000,517,504,524,249,535,784
1000,474,516,490,243,484,727
1000,499,527,498,261,483,744
1000,506,487,522,243,513,756
1000,511,498,491,268,489,757
1000,500,475,472,224,506,730
1000,504,496,528,240,527,767
1000,498,503,500,253,490,743
1000,511,524,509,271,484,755
1000,462,499,527,236,503,739
1000,479,497,507,249,481,730
1000,498,509,517,245,525,770
1000,505,521,522,263,500,763
1000,513,527,494,272,492,764
1000,500,521,501,253,514,767
1000,478,515,495,252,484,736
1000,496,471,462,232,490,722
1000,484,497,495,241,502,743
1000,498,507,484,251,490,741
1000,497,491,477,238,500,738
1000,511,504,522,247,527,774
1000,505,532,480,271,466,737
1000,479,500,491,249,492,741
1000,495,502,524,248,499,747
1000,538,506,484,269,503,772
1000,492,475,475,234,505,739
1000,485,481,512,233,513,746
1000,498,493,519,242,514,756
1000,500,512,511,252,499,751
1000,501,487,507,239,533,772
1000,513,503,512,276,490,766
1000,496,510,506,259,483,742
1000,486,504,486,247,495,742
1000,497,494,499,245,516,761
1000,494,510,509,253,494,747
1000,500,512,459,252,471,723
1000,521,517,515,278,496,774
1000,501,528,528,267,504,771
1000,503,484,495,258,490,748
1000,492,516,512,252,503,755
1000,500,523,489,249,490,739
1000,480,494,480,243,482,725
1000,496,515,525,250,512,762
1000,498,519,482,270,477,747
1000,516,490,486,251,500,751
1000,490,467,514,219,531,750
1000,450,519,525,235,502,737
1000,502,477,501,223,532,755
1000,531,518,521,268,505,773
1000,513,499,485,260,489,749
1000,491,494,524,249,510,759
1000,501,513,481,254,477,731
1000,542,502,526,270,506,776
1000,502,504,501,256,502,758
1000,496,484,511,235,511,746
1000,507,490,508,250,508,758
1000,487,502,491,231,513,744
1000,491,501,501,255,494,749
1000,512,461,504,242,529,771
1000,515,530,495,278,473,751
1000,515,515,486,270,482,752
1000,505,505,477,255,496,751
1000,519,478,527,261,513,774
1000,492,506,505,248,502,750
1000,489,465,494,236,504,740
1000,476,505,502,263,480,743
1000,497,513,474,270,459,729
1000,529,496,495,256,501,757
1000,476,468,513,225,509,734
1000,487,501,516,251,505,756
1000,463,533,529,247,498,745
1000,510,512,512,258,496,754
1000,499,507,522,245,529,774
1000,515,496,502,253,504,757
1000,487,502,514,233,520,753
1000,519,494,499,264,507,771
1000,517,482,513,248,523,771
1000,489,538,502,252,482,734
1000,507,502,489,241,490,731
1000,478,504,502,241,504,745
1000,504,494,514,253,504,757
1000,492,519,502,256,487,743
1000,487,495,506,235,512,747
1000,505,490,493,258,489,747
1000,506,516,496,278,472,750
1000,505,504,500,246,505,751
1000,477,499,512,235,505,740
1000,481,506,513,246,507,753
1000,480,500,521,247,494,741
1000,511,499,488,244,508,752
1000,518,474,502,238,513,751
1000,483,526,499,250,494,744
1000,507,510,505,259,491,750
1000,513,509,494,261,498,759
1000,495,491,514,250,501,751
1000,494,523,487,264,474,738
1000,500,475,496,241,511,752
1000,519,492,483,249,492,741
1000,513,473,489,241,511,752
1000,470,490,487,232,475,707
1000,511,465,508,236,516,752
1000,508,510,506,260,504,764
1000,520,486,464,252,495,747
1000,484,533,518,264,498,762
1000,503,524,504,269,488,757
1000,496,505,542,252,517,769
1000,496,470,491,233,501,734
1000,522,491,513,275,485,760
1000,526,492,498,278,477,755
1000,496,520,504,265,483,748
1000,504,490,485,245,503,748
1000,491,502,490,268,482,750
1000,481,479,511,234,507,741
1000,508,466,504,242,527,769
1000,524,481,501,254,499,753
1000,513,493,526,243,522,765
1000,481,507,506,238,506,744
1000,495,503,502,242,517,759
1000,474,504,525,245,500,745
1000,487,507,489,248,480,728
1000,505,522,495,265,490,755
1000,482,525,510,247,495,742
1000,492,489,494,227,515,742
1000,497,479,497,242,519,761
1000,535,506,507,270,490,760
1000,508,511,502,248,505,753
1000,499,487,485,242,509,751
1000,503,498,526,252,504,756
1000,498,489,490,251,508,759
1000,492,499,487,239,512,751
1000,514,512,487,255,494,749
1000,504,520,514,267,489,756
1000,466,503,504,227,504,731
1000,505,510,506,268,501,769
1000,522,481,514,259,514,773
1000,524,496,484,266,494,760
1000,470,520,479,251,479,730
1000,500,506,503,237,511,748
1000,487,488,514,229,508,737
1000,505,487,505,254,496,750
1000,515,490,477,256,493,749
1000,490,479,480,228,514,742
1000,509,491,507,244,526,770
1000,470,476,496,227,511,738
1000,493,494,512,259,501,760
1000,486,507,500,238,492,730
1000,510,501,524,259,505,764
1000,530,484,507,254,507,761
1000,508,471,511,242,504,746
1000,500,490,502,235,511,746
1000,498,526,501,262,492,754
1000,503,508,476,259,478,737
1000,523,488,518,247,526,773
1000,514,521,479,255,478,733
1000,467,477,476,214,505,719
1000,504,508,524,256,513,769
1000,483,508,535,238,515,753
1000,496,525,479,257,468,725
1000,507,477,489,242,507,749
1000,511,504,503,253,497,750
1000,500,475,518,245,511,756
1000,527,494,490,278,476,754
1000,504,494,526,242,524,766
1000,520,502,501,242,520,762
1000,500,496,497,250,511,761
1000,506,488,534,264,506,770
1000,481,501,487,239,481,720
1000,508,518,486,252,500,752
1000,511,512,492,246,514,760
1000,494,501,536,243,510,753
1000,496,504,493,245,508,753
1000,521,507,504,273,496,769
1000,515,470,496,253,517,770
1000,472,531,484,251,481,732
1000,504,526,520,254,511,765
1000,502,483,485,255,490,745
1000,495,494,507,245,496,741
1000,492,531,476,258,466,724
1000,522,511,474,265,491,756
1000,521,480,512,254,513,767
1000,480,484,498,240,501,741
1000,465,511,504,245,492,737
1000,494,523,482,259,472,731
1000,497,483,477,229,512,741
1000,507,518,493,272,472,744
1000,515,490,506,251,506,757
1000,493,504,484,251,492,743
1000,500,504,462,259,478,737
1000,484,509,507,245,494,739
1000,509,520,496,269,469,738
1000,497,506,506,261,480,741
1000,492,499,485,239,491,730
1000,499,476,486,241,486,727
1000,492,508,488,258,472,730
1000,500,494,491,238,507,745
1000,493,493,512,237,516,753
1000,506,504,500,263,482,745
1000,508,510,497,263,486,749
1000,500,490,502,241,516,757
1000,502,476,526,252,518,770
1000,529,487,491,255,502,757
1000,503,531,492,260,489,749
1000,492,518,471,276,448,724
1000,485,501,506,247,507,754
1000,521,486,514,249,517,766
1000,457,479,482,210,509,719
1000,499,510,512,258,503,761
1000,493,509,489,237,499,736
1000,522,496,501,254,510,764
1000,518,529,474,274,481,755
1000,490,514,495,256,480,736
1000,492,506,500,249,497,746
1000,509,512,477,247,503,750
1000,485,482,486,231,500,731
1000,509,505,507,267,486,753
1000,506,519,507,266,506,772
1000,521,484,514,243,533,776
1000,497,478,470,231,495,726
1000,491,477,482,235,502,737
1000,496,514,504,253,497,750
1000,485,509,493,237,501,738
1000,495,513,480,268,468,736
1000,480,491,499,246,480,726
1000,512,481,521,239,535,774
1000,515,491,485,247,513,760
1000,482,501,507,256,501,757
1000,470,509,502,242,499,741
1000,511,502,489,270,483,753
1000,487,488,505,239,510,749
1000,490,483,508,236,511,747
1000,493,515,480,261,486,747
1000,520,501,517,261,507,768
1000,471,490,523,239,509,748
1000,485,489,490,232,501,733
1000,504,492,482,239,508,747
1000,492,469,468,236,481,717
1000,476,510,510,246,514,760
1000,500,489,482,255,482,737
1000,480,473,518,221,522,743
1000,483,496,522,244,511,755
1000,515,505,517,264,497,761
1000,491,505,519,248,494,742
1000,476,505,466,243,482,725
1000,496,511,504,252,486,738
1000,504,482,513,245,504,749
1000,496,502,537,253,498,751
1000,514,487,517,268,496,764
1000,520,503,490,269,477,746
1000,509,487,498,252,489,741
1000,501,476,526,245,501,746
1000,494,487,484,250,492,742
1000,505,504,483,257,506,763
1000,473,506,476,244,480,724
1000,503,512,507,255,498,753
1000,493,496,484,248,478,726
1000,483,502,488,245,487,732
1000,461,507,500,230,507,737
1000,518,504,518,268,501,769
1000,502,481,478,242,504,746
1000,510,487,510,254,510,764
1000,528,521,488,291,479,770
1000,524,483,492,263,495,758
1000,500,496,495,250,484,734
1000,491,504,501,247,494,741
1000,496,516,520,253,512,765
1000,502,502,513,247,518,765
1000,524,470,504,258,489,747
1000,497,506,516,242,519,761
1000,488,512,501,250,482,732
1000,499,483,493,234,517,751
1000,480,489,476,232,494,726
1000,509,532,500,278,471,749
1000,465,481,506,216,521,737
1000,503,513,476,250,492,742
1000,523,495,487,255,491,746
1000,523,494,492,250,504,754
1000,501,495,507,266,487,753
1000,483,507,514,241,500,741
1000,497,494,498,251,507,758
1000,499,519,515,263,492,755
1000,517,525,503,274,493,767
1000,489,513,493,257,479,736
1000,500,495,493,255,495,750
1000,518,507,501,246,505,751
1000,498,491,516,240,493,733
1000,497,516,531,260,487,747
1000,501,496,491,263,486,749
1000,503,508,510,246,514,760
1000,487,490,503,228,524,752
1000,471,517,505,248,493,741
1000,485,490,507,239,508,747
1000,489,475,490,226,506,732
1000,483,481,482,231,504,735
1000,528,503,486,271,488,759
1000,510,496,486,240,518,758
1000,485,506,505,241,507,748
1000,482,505,503,246,506,752
1000,471,497,498,238,499,737
1000,510,501,503,258,500,758
1000,510,482,519,231,534,765
1000,488,512,510,258,476,734
1000,527,508,499,265,501,766
1000,497,482,527,241,518,759
1000,512,510,478,254,473,727
1000,481,489,486,233,505,738
1000,500,497,503,245,496,741
1000,491,498,477,236,509,745
1000,493,498,487,246,498,744
1000,510,483,449,236,508,744
1000,487,510,512,230,533,763
1000,482,511,496,240,506,746
1000,514,514,501,269,486,755
1000,508,520,485,264,481,745
1000,482,466,473,221,516,737
1000,491,493,536,264,484,748
1000,512,492,491,263,488,751
1000,468,498,473,233,484,717
1000,510,516,512,257,509,766
1000,471,475,501,243,504,747
1000,519,506,506,270,514,784
1000,513,504,489,248,510,758
1000,504,508,482,261,494,755
1000,520,510,502,274,487,761
1000,519,491,478,246,496,742
1000,485,477,497,222,516,738
1000,490,494,496,249,497,746
1000,502,505,492,260,486,746
1000,509,544,491,276,478,754
1000,520,479,481,253,498,751
1000,488,493,517,247,500,747
1000,519,485,484,242,510,752
1000,498,477,487,226,527,753
1000,497,521,494,260,488,748
1000,512,499,536,254,517,771
1000,491,494,500,235,523,758
1000,493,521,491,245,503,748
1000,516,491,500,255,509,764
1000,495,513,482,246,490,736
1000,518,508,510,256,510,766
1000,490,495,529,251,523,774
1000,524,481,496,252,517,769
1000,494,490,491,230,522,752
1000,486,514,499,249,490,739
1000,510,496,468,252,490,742
1000,511,512,483,275,471,746
1000,484,493,508,244,508,752
1000,497,520,458,254,477,731
1000,484,519,477,255,487,742
1000,506,495,506,245,505,750
1000,511,528,502,280,462,742
1000,518,502,536,273,504,777
1000,546,491,513,264,512,776
1000,499,484,503,244,509,753
1000,506,483,489,239,495,734
1000,514,513,509,247,524,771
1000,515,507,498,253,500,753
1000,518,511,502,261,508,769
1000,480,526,509,248,509,757
1000,488,481,513,225,522,747
1000,489,482,522,235,523,758
1000,493,495,508,243,502,745
1000,500,490,503,240,508,748
1000,500,492,513,247,502,749
1000,504,482,480,248,494,742
1000,506,492,491,247,498,745
1000,541,490,480,269,502,771
1000,489,513,503,253,499,752
1000,501,509,488,255,500,755
1000,517,492,507,252,510,762
1000,491,467,498,236,489,725
1000,496,478,529,230,539,769
1000,486,518,502,252,498,750
1000,512,478,503,249,507,756
1000,499,504,519,255,511,766
1000,495,511,507,245,493,738
1000,505,498,514,259,510,769
1000,508,494,501,253,506,759
1000,499,488,489,254,483,737
1000,490,497,508,233,517,750
1000,479,501,477,243,487,730
1000,507,491,479,258,500,758
1000,483,512,503,241,507,748
1000,489,515,502,250,503,753
1000,488,491,522,255,500,755
1000,485,512,497,264,475,739
1000,504,489,499,254,497,751
1000,493,459,500,236,517,753
1000,505,520,504,265,486,751
1000,504,511,511,271,490,761
1000,497,481,495,243,526,769
1000,499,501,506,255,496,751
1000,476,502,500,251,494,745
1000,511,499,517,263,501,764
1000,510,476,502,253,503,756
1000,503,494,491,246,505,751
1000,504,460,517,231,529,760
1000,501,483,503,240,516,756
1000,507,518,504,251,509,760
1000,518,492,505,257,502,759
1000,525,506,507,262,499,761
1000,492,499,504,228,518,746
1000,486,494,491,230,514,744
1000,497,547,481,263,482,745
1000,503,522,485,259,500,759
1000,523,522,470,271,477,748
1000,476,490,533,231,517,748
1000,505,493,497,259,482,741
1000,477,464,511,216,531,747
1000,485,496,522,228,533,761
1000,518,509,486,252,493,745
1000,517,476,484,240,512,752
1000,495,477,507,241,500,741
1000,491,498,496,242,494,736
1000,519,484,535,244,532,776
1000,488,493,496,238,498,736
1000,472,515,491,230,513,743
1000,540,504,495,278,497,775
1000,492,507,512,254,491,745
1000,506,502,507,253,501,754
1000,508,495,504,249,512,761
1000,508,478,507,232,528,760
1000,477,529,480,252,472,724
1000,513,478,537,247,535,782
1000,506,477,499,241,499,740
1000,502,515,500,243,500,743
1000,469,501,482,237,480,717
1000,510,517,511,257,501,758
1000,513,511,515,270,482,752
1000,458,522,507,232,511,743
1000,504,497,492,266,487,753
1000,470,516,495,253,493,746
1000,523,523,508,275,501,776
1000,518,475,476,240,505,745
1000,510,491,488,231,544,775
1000,493,515,506,246,511,757
1000,509,518,477,271,468,739
1000,521,533,469,283,463,746
1000,504,480,487,239,512,751
1000,494,516,497,257,485,742
1000,502,475,503,241,510,751
1000,488,497,471,245,485,730
1000,504,502,490,234,503,737
1000,521,498,517,258,512,770
1000,486,525,522,247,502,749
1000,488,517,522,244,506,750
1000,504,528,512,266,491,757
1000,494,503,499,252,491,743
1000,496,484,507,238,518,756
1000,484,478,505,238,502,740
1000,504,514,492,263,473,736
1000,485,515,544,245,524,769
1000,522,486,517,241,533,774
1000,506,500,488,239,506,745
1000,480,486,501,217,519,736
1000,489,509,505,245,505,750
1000,527,530,486,279,473,752
1000,499,491,495,229,512,741
1000,509,498,477,253,477,730
1000,486,497,517,252,498,750
1000,503,504,497,252,490,742
1000,506,500,508,250,505,755
1000,492,514,514,251,497,748
1000,491,522,497,250,488,738
1000,484,496,517,248,490,738
1000,480,509,482,245,492,737
1000,512,477,519,235,527,762
1000,517,471,495,249,506,755
1000,492,516,501,249,500,749
1000,525,487,491,256,509,765
1000,511,500,493,247,501,748
1000,513,504,524,255,518,773
1000,508,501,517,271,496,767
1000,459,474,514,211,532,743
1000,485,495,514,251,500,751
1000,471,491,518,240,501,741
1000,520,485,501,247,516,763
1000,501,496,474,251,485,736
1000,471,522,520,252,482,734
1000,496,506,494,266,483,749
1000,482,510,517,238,513,751
1000,485,524,480,260,475,735
1000,470,502,485,225,503,728
1000,495,509,508,252,501,753
1000,500,483,507,240,521,761
1000,482,494,509,229,510,739
1000,496,492,497,261,478,739
1000,510,471,497,235,524,759
1000,499,486,507,251,494,745
1000,494,517,493,268,484,752
1000,505,493,532,235,545,780
1000,479,504,495,246,493,739
1000,476,500,493,241,499,740
1000,492,480,495,235,516,751
1000,521,487,509,261,500,761
1000,497,501,499,229,512,741
1000,485,518,499,246,497,743
1000,525,496,509,258,502,760
1000,514,503,483,260,498,758
1000,491,477,489,234,498,732
1000,492,520,495,249,492,741
1000,513,497,496,246,503,749
1000,490,506,487,247,495,742
1000,487,498,517,249,500,749
1000,509,506,468,254,486,740
1000,531,482,508,254,522,776
1000,529,508,498,271,485,756
1000,504,508,502,267,487,754
1000,500,535,516,264,478,742
1000,531,511,550,269,518,787
1000,504,522,497,250,488,738
1000,517,493,483,270,468,738
1000,505,530,517,255,516,771
1000,495,508,515,249,511,760
1000,486,488,500,230,514,744
1000,501,473,484,227,520,747
1000,517,490,466,258,473,731
1000,524,506,485,270,483,753
1000,492,523,498,252,500,752
1000,509,499,475,252,486,738
1000,494,497,492,239,495,734
1000,526,496,496,252,501,753
1000,504,513,508,272,479,751
1000,503,521,501,256,495,751
1000,503,522,515,252,508,760
1000,506,493,495,252,503,755
1000,518,513,489,256,500,756
1000,500,499,513,267,493,760
1000,479,500,480,237,505,742
1000,497,485,521,237,514,751
1000,492,496,463,240,498,738
1000,498,499,497,246,506,752
1000,493,531,504,258,488,746
1000,539,502,481,256,509,765
1000,471,488,495,227,501,728
1000,495,510,497,264,500,764
1000,500,517,514,253,511,764
1000,525,537,517,275,490,765
1000,477,507,487,237,490,727
1000,491,519,512,252,500,752
1000,469,502,483,229,500,729
1000,500,529,498,268,489,757
1000,494,496,522,247,512,759
1000,472,494,471,240,483,723
1000,500,507,495,248,511,759
1000,527,493,489,258,500,758
1000,512,466,486,244,508,752
1000,510,513,511,259,506,765
1000,521,493,480,260,489,749
1000,472,515,516,260,469,729
1000,489,513,474,245,492,737
1000,531,484,502,252,516,768
1000,478,485,481,218,512,730
1000,487,519,474,249,474,723
1000,518,503,506,259,509,768
1000,515,528,486,268,464,732
1000,508,501,506,264,482,746
1000,500,470,503,234,521,755
1000,510,515,509,264,504,768
1000,492,508,487,239,506,745
1000,497,480,510,224,539,763
1000,518,497,513,264,493,757
1000,483,483,501,228,520,748
1000,503,514,502,245,524,769
1000,481,483,498,241,490,731
1000,492,514,476,261,477,738
1000,507,499,489,253,500,753
1000,515,497,519,255,523,778
1000,494,485,504,241,493,734
1000,497,505,493,239,514,753
1000,480,506,498,264,472,736
1000,473,489,517,230,513,743
1000,517,521,496,281,459,740
1000,474,492,512,243,503,746
1000,513,479,516,253,505,758
1000,505,505,507,269,486,755
1000,484,501,505,231,505,736
1000,492,515,485,261,475,736
1000,491,491,501,226,527,753
1000,483,504,512,237,509,746
1000,484,478,489,237,498,735
1000,490,488,511,247,503,750
1000,486,510,496,245,495,740
1000,512,481,500,239,528,767
1000,465,500,505,233,510,743
1000,501,536,484,265,471,736
1000,521,514,502,267,492,759
1000,504,522,492,273,472,745
1000,493,509,508,254,498,752
1000,497,507,497,256,504,760
1000,511,499,488,262,483,745
1000,507,484,484,245,492,737
1000,481,517,478,255,476,731
1000,477,515,489,248,496,744
1000,499,518,506,244,508,752
1000,516,477,499,246,520,766
1000,492,517,511,258,481,739
1000,526,526,478,263,488,751
1000,479,518,486,234,510,744
1000,503,489,508,240,521,761
1000,500,497,509,254,505,759
1000,500,504,498,240,498,738
1000,492,477,527,239,522,761
1000,508,499,509,265,479,744
1000,503,514,503,258,487,745
1000,516,499,473,259,480,739
1000,469,505,479,241,483,724
1000,508,496,532,258,504,762
1000,520,470,519,231,532,763
1000,508,496,486,254,503,757
1000,511,517,501,258,511,769
1000,513,510,496,259,502,761
1000,498,481,515,229,510,739
1000,501,498,488,245,502,747
1000,495,499,466,246,470,716
1000,495,502,500,260,489,749
1000,497,510,472,261,476,737
1000,482,494,515,233,517,750
1000,479,479,489,230,508,738
1000,494,499,497,247,505,752
1000,505,521,487,262,484,746
1000,506,513,472,265,474,739
1000,484,482,474,232,507,739
1000,496,492,513,242,507,749
1000,485,491,479,238,491,729
1000,536,498,515,263,516,779
1000,475,498,504,235,493,728
1000,504,524,487,275,476,751
1000,524,502,482,251,506,757
1000,501,501,492,248,496,744
1000,513,489,490,263,485,748
1000,529,534,527,287,480,767
1000,500,506,486,252,485,737
1000,506,508,502,241,515,756
1000,508,514,518,256,517,773
1000,507,493,479,248,506,754
1000,497,501,525,261,496,757
1000,488,500,486,246,487,733
1000,470,465,497,225,516,741
1000,524,518,501,275,480,755
1000,505,497,488,253,491,744
1000,485,493,508,226,526,752
1000,499,511,492,237,507,744
1000,513,506,493,253,505,758
1000,509,481,486,247,499,746
1000,473,531,484,241,481,722
1000,478,487,492,222,525,747
1000,514,516,496,262,487,749
1000,492,501,506,250,501,751
1000,504,482,502,237,514,751
1000,485,466,500,218,533,751
1000,508,483,513,244,522,766
1000,480,468,493,223,505,728
1000,513,511,515,277,480,757
1000,497,508,494,250,495,745
1000,503,520,499,255,489,744
1000,488,485,485,243,497,740
1000,491,483,487,245,496,741
1000,490,482,472,242,482,724
1000,496,512,492,257,482,739
1000,506,516,486,260,479,739
1000,500,487,487,249,494,743
1000,503,520,520,276,486,762
1000,500,509,520,257,502,759
1000,501,522,506,277,466,743
1000,513,494,512,250,520,770
1000,531,537,506,286,494,780
1000,513,501,465,266,486,752
1000,506,493,500,254,497,751
1000,488,495,527,247,511,758
1000,529,501,489,262,498,760
1000,523,516,500,280,482,762
1000,504,505,526,248,521,769
1000,509,514,500,253,513,766
1000,499,494,520,249,497,746
1000,499,509,510,245,505,750
1000,509,522,494,253,501,754
1000,502,529,521,260,485,745
1000,516,528,548,278,503,781
1000,512,519,500,272,486,758
1000,514,494,492,245,504,749
1000,505,504,506,263,471,734
1000,508,517,475,248,504,752
1000,515,500,521,267,492,759
1000,487,477,540,240,523,763
1000,470,533,476,259,461,720
1000,502,513,496,251,499,750
1000,508,488,489,262,499,761
1000,507,500,502,266,493,759
1000,472,514,515,229,517,746
1000,487,508,530,250,512,762
1000,496,530,496,258,488,746
1000,471,464,506,212,527,739
1000,469,488,455,230,481,711
1000,514,529,476,271,474,745
1000,479,498,490,240,498,738
1000,494,520,483,267,472,739
1000,477,489,467,242,481,723
1000,489,500,515,239,517,756
1000,501,489,504,249,507,756
1000,499,496,497,249,499,748
1000,531,466,517,247,533,780
1000,531,498,489,265,516,781
1000,519,515,485,264,474,738
1000,516,498,523,278,501,779
1000,481,503,476,239,490,729
1000,496,494,509,255,488,743
1000,506,481,498,247,502,749
1000,549,523,509,287,482,769
1000,513,508,518,258,512,770
1000,501,493,512,233,530,763
1000,486,492,506,237,498,735
1000,519,490,500,268,500,768
1000,477,504,522,263,477,740
1000,527,513,523,271,498,769
1000,537,490,484,264,511,775
1000,500,499,503,256,502,758
1000,469,512,503,237,498,735
1000,516,506,499,262,492,754
1000,496,514,492,254,480,734
1000,490,495,497,237,495,732
1000,507,485,503,236,504,740
1000,512,500,485,250,509,759
1000,473,482,503,227,518,745
1000,493,468,495,229,537,766
1000,524,510,495,267,491,758
1000,487,508,512,241,498,739
1000,484,473,489,263,462,725
1000,500,500,526,247,523,770
1000,484,500,480,240,487,727
1000,508,506,491,257,496,753
1000,492,508,509,254,490,744
1000,489,480,502,233,518,751
1000,513,504,513,247,511,758
1000,473,515,508,246,492,738
1000,498,500,514,250,494,744
1000,499,504,481,235,515,750
1000,490,492,503,240,520,760
1000,470,499,507,228,506,734
1000,482,482,511,226,511,737
1000,515,504,482,265,488,753
1000,512,508,526,259,519,778
1000,501,498,508,260,506,766
1000,521,480,489,259,497,756
1000,520,510,533,265,514,779
1000,525,494,494,255,512,767
1000,480,520,502,259,481,740
1000,519,514,490,272,482,754
1000,497,503,496,243,515,758
1000,493,501,530,254,487,741
1000,506,485,486,249,502,751
1000,492,508,510,260,506,766
1000,503,504,499,252,480,732
1000,516,489,515,244,533,777
1000,498,503,501,263,500,763
1000,490,508,526,256,507,763
1000,499,475,516,241,525,766
1000,473,477,531,232,523,755
1000,519,508,501,261,509,770
1000,492,481,510,237,507,744
1000,488,488,515,237,514,751
1000,489,500,515,235,520,755
1000,505,510,519,262,514,776
1000,475,515,507,239,506,745
1000,516,519,507,274,484,758
1000,479,468,494,228,523,751
1000,488,489,548,240,528,768
1000,523,532,483,284,466,750
1000,476,490,538,233,537,770
1000,491,520,498,266,481,747
1000,486,494,481,231,505,736
1000,507,501,495,266,483,749
1000,508,507,481,271,475,746
1000,495,466,492,223,518,741
1000,503,473,493,232,523,755
1000,522,492,540,265,511,776
1000,517,531,500,286,469,755
1000,527,493,516,249,528,777
1000,512,504,502,271,487,758
1000,520,522,518,271,508,779
1000,493,463,501,239,495,734
1000,503,507,494,243,506,749
1000,497,491,502,249,494,743
1000,496,500,501,240,519,759
1000,478,501,491,237,509,746
1000,480,448,491,206,549,755
1000,520,498,487,263,505,768
1000,489,498,506,252,502,754
1000,499,487,512,246,503,749
1000,525,512,477,264,501,765
1000,511,499,503,256,504,760
1000,476,541,510,244,508,752
1000,491,515,522,250,490,740
1000,516,484,506,245,509,754
1000,512,508,492,269,473,742
1000,503,503,471,253,478,731
1000,484,496,503,233,518,751
1000,494,499,505,250,510,760
1000,513,499,476,266,477,743
1000,516,514,501,277,482,759
1000,486,523,492,245,493,738
1000,525,500,502,270,502,772
1000,519,503,492,280,486,766
1000,487,499,509,254,490,744
1000,451,496,523,219,526,745
1000,505,463,524,220,524,744
1000,470,507,497,237,486,723
1000,487,509,504,252,494,746
1000,484,497,520,232,525,757
1000,478,533,516,266,479,745
1000,507,502,493,276,470,746
1000,503,506,510,255,500,755
1000,509,490,472,244,486,730
1000,479,495,503,228,502,730
1000,488,518,519,254,487,741
1000,508,487,523,251,513,764
1000,516,518,497,256,506,762
1000,479,502,560,226,550,776
1000,508,522,480,262,474,736
1000,479,510,486,221,504,725
1000,490,495,480,245,480,725
1000,508,504,497,256,495,751
1000,504,474,518,243,516,759
1000,497,496,470,259,474,733
1000,521,497,486,261,512,773
1000,490,491,498,232,520,752
1000,502,508,505,255,503,758
1000,527,490,531,267,522,789
1000,488,506,509,265,480,745
1000,491,502,508,248,501,749
1000,524,500,524,255,523,778
1000,503,494,511,253,518,771
1000,494,493,501,236,497,733
1000,498,516,495,262,493,755
1000,508,494,485,258,487,745
1000,500,530,487,275,468,743
1000,482,499,498,246,493,739
1000,476,483,520,227,527,754
1000,515,507,513,260,499,759
1000,510,494,486,254,493,747
1000,507,517,529,265,491,756
1000,498,475,515,229,532,761
1000,474,488,495,228,507,735
1000,534,495,521,260,504,764
1000,499,507,494,265,478,743
1000,486,519,486,264,469,733
1000,535,494,499,263,498,761
1000,492,508,479,253,486,739
1000,488,500,489,241,492,733
1000,508,477,509,242,508,750
1000,471,491,488,236,500,736
1000,512,498,514,252,508,760
1000,540,473,507,262,514,776
1000,483,508,486,256,468,724
1000,488,497,481,251,466,717
1000,519,489,480,258,488,746
1000,502,476,497,241,510,751
1000,507,486,491,227,526,753
1000,501,495,508,242,501,743
1000,502,484,484,231,518,749
1000,472,500,486,237,496,733
1000,514,517,482,266,484,750
1000,514,497,495,257,498,755
1000,516,504,505,269,481,750
1000,505,515,512,260,498,758
1000,519,519,514,265,503,768
1000,463,526,488,236,478,714
1000,524,483,499,261,495,756
1000,482,480,489,239,494,733
1000,516,485,472,249,494,743
1000,506,511,509,250,504,754
1000,496,536,507,257,513,770
1000,513,509,519,262,505,767
1000,535,502,501,257,504,761
1000,502,496,485,244,503,747
1000,511,509,500,264,503,767
1000,504,515,491,256,496,752
1000,513,509,500,256,504,760
1000,490,519,505,255,507,762
1000,475,507,487,237,487,724
1000,506,491,478,250,491,741
1000,528,528,514,275,490,765
1000,524,484,495,261,488,749
1000,507,478,502,250,511,761
1000,511,494,502,251,512,763
1000,489,495,506,240,515,755
1000,489,510,484,258,479,737
1000,495,518,490,267,484,751
1000,505,486,496,260,496,756
1000,475,474,493,218,521,739
1000,504,523,490,260,475,735
1000,512,483,476,250,496,746
1000,496,498,505,254,495,749
1000,503,517,496,266,487,753
1000,491,503,501,253,493,746
1000,473,509,479,240,489,729
1000,530,480,488,251,506,757
1000,511,470,496,242,496,738
1000,502,489,490,242,518,760
1000,503,492,481,237,510,747
1000,509,496,503,247,504,751
1000,461,504,516,232,514,746
1000,501,473,483,232,519,751
1000,494,496,502,253,498,751
1000,521,496,507,265,513,778
1000,529,508,528,261,532,793
1000,491,507,479,257,480,737
1000,502,525,509,266,488,754
1000,505,528,490,267,496,763
1000,507,509,491,259,484,743
1000,517,513,487,260,487,747
1000,511,513,492,260,506,766
1000,495,492,504,240,515,755
1000,498,486,510,249,491,740
1000,522,487,513,249,524,773
1000,496,480,500,247,495,742
1000,506,521,497,261,474,735
1000,484,463,489,223,513,736
1000,491,503,491,254,498,752
1000,507,485,464,246,476,722
1000,520,495,518,257,516,773
1000,513,492,493,249,498,747
1000,489,499,513,252,488,740
1000,497,495,505,247,507,754
1000,509,504,504,263,480,743
1000,481,514,511,233,515,748
1000,499,484,487,254,501,755
1000,504,522,520,253,514,767
1000,522,518,495,273,486,759
1000,506,473,507,251,506,757
1000,496,489,503,234,511,745
1000,498,482,485,244,486,730
1000,517,521,492,259,500,759
1000,535,497,524,273,506,779
1000,478,484,524,227,518,745
1000,494,496,516,242,527,769
1000,525,483,497,251,500,751
1000,504,478,505,246,515,761
1000,524,485,482,239,514,753
1000,486,503,513,250,492,742
1000,475,521,505,249,490,739
1000,503,499,518,252,506,758
1000,489,510,486,255,486,741
1000,484,510,533,250,514,764
1000,508,496,469,244,482,726
1000,481,496,531,244,512,756
1000,504,486,508,234,513,747
1000,485,518,491,247,496,743
1000,507,499,488,259,482,741
1000,506,488,497,243,509,752
1000,495,520,503,266,478,744
1000,524,504,508,255,511,766
1000,500,492,483,242,491,733
1000,505,512,503,263,492,755
1000,480,511,498,247,485,732
1000,499,515,515,257,493,750
1000,512,516,523,266,505,771
1000,522,488,507,251,505,756
1000,530,483,508,247,518,765
1000,513,493,489,256,492,748
1000,506,500,516,254,522,776
1000,481,494,510,237,512,749
1000,475,478,521,225,531,756
1000,490,513,498,238,516,754
1000,509,498,495,253,501,754
1000,476,494,522,237,518,755
1000,498,532,491,259,479,738
1000,508,540,497,257,500,757
1000,447,509,497,222,480,702
1000,484,498,518,244,502,746
1000,489,492,475,248,482,730
1000,470,525,507,242,486,728
1000,508,520,509,277,489,766
1000,481,515,520,248,518,766
1000,470,486,492,223,509,732
1000,520,498,513,248,535,783
1000,517,512,497,265,492,757
1000,496,492,514,226,534,760
1000,472,486,506,225,516,741
1000,502,520,483,272,471,743
1000,479,469,516,223,533,756
1000,495,486,493,236,502,738
1000,521,503,498,258,484,742
1000,505,496,498,260,486,746
1000,536,541,493,304,464,768
1000,504,476,514,231,541,772
1000,523,495,504,271,494,765
1000,488,497,495,246,504,750
1000,495,483,497,237,512,749
1000,504,498,502,258,486,744
1000,487,483,522,240,511,751
1000,515,481,530,234,529,763
1000,497,514,490,255,485,740
1000,494,498,521,244,503,747
1000,496,492,512,248,495,743
1000,480,495,525,240,517,757
1000,445,508,509,212,517,729
1000,488,516,505,244,504,748
1000,498,487,486,244,505,749
1000,488,493,499,242,501,743
1000,473,493,478,244,477,721
1000,553,504,487,291,490,781
1000,496,494,510,252,508,760
1000,502,517,498,266,481,747
1000,481,500,497,236,505,741
1000,508,520,496,267,479,746
1000,526,546,493,299,456,755
1000,523,491,521,260,521,781
1000,510,497,477,256,487,743
1000,496,506,527,261,497,758
1000,481,505,525,239,500,739
1000,507,509,493,254,491,745
1000,526,489,481,261,492,753
1000,495,466,500,219,526,745
1000,530,503,493,256,512,768
1000,504,521,494,256,490,746
1000,477,472,496,224,524,748
1000,506,519,518,244,515,759
1000,505,462,501,236,508,744
1000,514,510,538,275,498,773
1000,491,490,498,243,508,751
1000,488,507,525,239,522,761
1000,502,471,464,222,523,745
1000,492,504,522,247,507,754
1000,506,489,483,247,481,728
1000,498,509,491,244,499,743
1000,501,479,507,240,509,749
1000,511,527,497,264,489,753
1000,500,523,500,263,477,740
1000,500,500,478,248,500,748
1000,490,508,478,263,477,740
1000,498,515,505,248,497,745
1000,517,508,501,254,501,755
1000,483,519,485,259,462,721
1000,477,496,485,242,500,742
1000,503,516,502,259,491,750
1000,503,500,492,252,483,735
1000,464,496,514,229,513,742
1000,481,490,500,247,484,731
1000,477,524,480,247,477,724
1000,499,476,508,234,507,741
1000,479,464,483,216,504,720
1000,468,517,485,242,469,711
1000,529,507,481,266,502,768
1000,501,494,507,249,501,750
1000,506,529,505,265,487,752
1000,496,482,499,247,504,751
1000,496,498,521,257,496,753
1000,491,489,479,237,501,738
1000,485,513,525,254,494,748
1000,500,508,496,258,501,759
1000,475,508,539,236,514,750
1000,480,461,493,221,504,725
1000,541,501,519,278,510,788
1000,482,505,491,244,489,733
1000,510,481,522,244,519,763
1000,507,497,483,251,481,732
1000,513,496,489,273,479,752
1000,496,495,521,247,519,766
1000,513,496,528,249,527,776
1000,491,507,507,250,513,763
1000,495,501,490,242,490,732
1000,517,483,512,262,500,762
1000,505,512,504,260,487,747
1000,545,508,465,277,471,748
1000,503,497,501,251,508,759
1000,522,505,503,261,494,755
1000,498,481,518,239,517,756
1000,475,497,518,231,507,738
1000,475,517,525,232,523,755
1000,507,480,491,245,508,753
1000,492,491,487,234,503,737
1000,492,502,496,264,490,754
1000,511,456,527,225,526,751
1000,500,540,491,283,459,742
1000,510,508,493,264,476,740
1000,515,523,494,245,484,729
1000,471,504,471,248,477,725
1000,461,513,484,242,473,715
1000,499,510,518,265,491,756
1000,482,510,505,249,493,742
1000,494,502,498,239,506,745
1000,510,509,504,256,481,737
1000,476,511,497,250,499,749
1000,500,496,515,246,513,759
1000,498,514,514,251,497,748
1000,507,503,504,266,499,765
1000,516,514,470,258,487,745
1000,488,475,511,234,510,744
1000,474,512,511,231,523,754
1000,517,514,506,260,496,756
1000,506,478,514,255,524,779
1000,467,489,484,219,515,734
1000,533,515,482,266,491,757
1000,507,496,476,257,496,753
1000,475,499,480,248,476,724
1000,489,505,491,243,497,740
1000,514,518,487,267,490,757
1000,507,492,536,247,525,772
1000,536,502,478,283,470,753
1000,476,493,493,229,503,732
1000,515,485,494,250,510,760
1000,503,492,486,252,480,732
1000,512,480,536,245,526,771
1000,488,519,500,239,496,735
1000,515,501,535,243,539,782
1000,496,482,469,229,497,726
1000,488,507,479,234,498,732
1000,504,490,504,250,495,745
1000,498,509,499,245,505,750
1000,517,498,509,261,498,759
1000,484,484,508,230,532,762
1000,488,494,491,238,503,741
1000,480,495,481,244,481,725
1000,508,512,506,264,498,762
1000,521,492,502,262,500,762
1000,531,477,500,262,496,758
1000,505,510,495,251,499,750
1000,505,512,493,254,496,750
1000,499,506,508,254,500,754
1000,522,487,506,256,506,762
1000,478,474,514,226,514,740
1000,510,528,524,265,507,772
1000,489,499,492,247,494,741
1000,492,493,486,253,478,731
1000,533,478,493,268,490,758
1000,479,499,496,229,517,746
1000,482,535,495,250,489,739
1000,484,510,487,258,479,737
1000,495,500,479,264,463,727
1000,505,502,504,250,504,754
1000,503,526,469,264,478,742
1000,487,501,543,232,536,768
1000,503,509,498,270,488,758
1000,495,465,519,223,529,752
1000,510,529,500,271,486,757
1000,505,473,501,231,521,752
1000,507,504,492,249,503,752
1000,504,499,493,252,495,747
1000,519,500,520,252,513,765
1000,495,487,513,251,497,748
1000,494,518,515,240,512,752
1000,502,496,499,250,491,741
1000,507,498,528,254,506,760
1000,488,510,501,254,488,742
1000,500,491,504,258,491,749
1000,521,500,490,265,491,756
1000,507,518,499,267,482,749
1000,504,498,496,259,487,746
1000,508,498,490,264,483,747
1000,496,530,464,264,470,734
1000,482,511,513,255,490,745
1000,507,525,490,263,485,748
1000,522,489,473,249,498,747
1000,491,521,504,250,496,746
1000,499,480,519,250,496,746
1000,519,523,481,271,477,748
1000,510,505,482,270,477,747
1000,505,513,494,254,511,765
1000,482,509,506,243,504,747
1000,491,504,527,268,502,770
1000,508,504,491,247,520,767
1000,483,512,508,246,497,743
1000,510,482,523,233,529,762
1000,499,486,494,234,496,730
1000,502,510,509,261,503,764
1000,507,507,516,246,517,763
1000,498,492,501,246,511,757
1000,507,514,505,270,463,733
1000,511,518,477,257,481,738
1000,498,493,476,255,475,730
1000,512,482,517,245,502,747
1000,500,525,505,257,497,754
1000,502,484,498,241,511,752
1000,484,479,518,231,513,744
1000,473,515,492,239,507,746
1000,496,472,492,238,506,744
1000,519,486,489,259,485,744
1000,494,464,500,224,522,746
1000,513,482,475,231,514,745
1000,529,490,508,256,524,780
1000,474,495,482,240,477,717
1000,504,494,512,259,502,761
1000,517,509,487,265,488,753
1000,507,487,517,258,503,761
1000,497,499,502,248,505,753
1000,479,497,504,248,494,742
1000,514,508,492,271,494,765
1000,482,505,481,237,501,738
1000,508,493,527,258,525,783
1000,494,508,509,250,500,750
1000,463,495,498,228,496,724
1000,504,516,504,263,494,757
1000,509,508,480,240,500,740
1000,501,503,482,248,499,747
1000,500,499,487,253,494,747
1000,510,496,520,250,514,764
1000,496,485,480,233,507,740
1000,478,500,504,236,513,749
1000,492,516,493,252,480,732
1000,523,510,469,257,494,751
1000,508,501,505,262,507,769
1000,511,463,492,233,517,750
1000,495,507,497,248,501,749
1000,496,495,516,250,504,754
1000,508,499,487,269,489,758
1000,510,504,481,259,487,746
1000,521,515,518,258,518,776
1000,507,495,478,241,490,731
1000,504,501,472,248,499,747
1000,489,487,478,232,490,722
1000,492,521,498,273,473,746
1000,475,500,505,227,514,741
1000,471,499,489,220,515,735
1000,480,508,513,244,502,746
1000,483,532,519,261,483,744
1000,508,514,545,269,511,780
1000,485,501,498,236,492,728
1000,500,516,488,234,518,752
1000,489,497,520,240,513,753
1000,500,453,512,211,547,758
1000,492,488,505,228,525,753
1000,500,500,493,258,492,750
1000,486,500,468,246,479,725
1000,510,512,490,258,488,746
1000,478,500,496,230,500,730
1000,505,513,504,260,504,764
1000,521,483,499,252,517,769
1000,479,507,534,239,505,744
1000,510,485,504,241,511,752
1000,499,471,510,239,533,772
1000,515,499,497,268,495,763
1000,502,532,536,261,515,776
1000,489,514,509,258,493,751
1000,512,485,511,254,514,768
1000,489,475,491,229,503,732
1000,494,504,529,237,516,753
1000,537,480,520,263,495,758
1000,517,507,515,253,513,766
1000,501,517,497,258,491,749
1000,514,511,516,269,488,757
1000,488,512,499,250,490,740
1000,505,483,509,239,529,768
1000,498,510,485,255,490,745
1000,496,489,506,245,511,756
1000,516,485,507,255,496,751
1000,503,511,493,250,503,753
1000,495,497,526,244,521,765
1000,475,501,487,232,511,743
1000,501,530,498,275,474,749
1000,501,499,500,245,504,749
1000,483,485,528,215,554,769
1000,483,513,484,243,502,745
1000,476,512,479,232,481,713
1000,512,514,486,253,491,744
1000,500,501,483,249,503,752
1000,486,504,528,242,509,751
1000,495,502,485,252,484,736
1000,481,503,482,239,500,739
1000,481,534,497,254,474,728
1000,497,538,534,276,496,772
1000,518,490,511,249,527,776
1000,495,512,498,254,493,747
1000,510,485,494,235,516,751
1000,489,521,500,257,499,756
1000,480,494,510,241,502,743
1000,489,489,491,257,474,731
1000,473,522,502,244,494,738
1000,517,495,515,262,501,763
1000,499,511,531,259,500,759
1000,497,487,494,244,512,756
1000,478,520,481,251,473,724
1000,480,497,504,247,495,742
1000,507,515,511,258,496,754
1000,502,496,475,242,490,732
1000,468,501,512,228,507,735
1000,534,482,519,266,509,775
1000,490,488,537,232,515,747
1000,518,500,485,259,489,748
1000,504,498,512,247,502,749
1000,492,501,507,230,518,748
1000,492,495,537,252,521,773
1000,520,530,500,265,494,759
1000,484,492,488,250,474,724
1000,493,475,497,236,489,725
1000,511,489,514,254,509,763
1000,518,510,511,275,485,760
1000,479,546,507,252,484,736
1000,487,474,518,236,514,750
1000,508,530,478,262,486,748
1000,487,503,487,242,487,729
1000,491,511,506,261,486,747
1000,499,505,486,250,487,737
1000,476,510,469,242,497,739
1000,521,509,508,268,495,763
1000,513,484,506,249,500,749
1000,492,492,513,235,528,763
1000,498,500,491,242,500,742
1000,491,471,488,229,504,733
1000,508,524,519,257,507,764
1000,489,488,495,249,508,757
1000,480,458,525,207,531,738
1000,516,529,506,265,486,751
1000,487,500,479,241,468,709
1000,475,495,475,234,489,723
1000,502,508,520,255,509,764
1000,494,482,490,239,503,742
1000,519,482,519,262,511,773
1000,495,527,501,263,481,744
1000,499,526,507,258,485,743
1000,532,488,488,265,495,760
1000,513,493,497,255,507,762
1000,507,491,474,235,494,729
1000,508,489,487,252,508,760
1000,511,486,488,269,488,757
1000,503,481,507,244,502,746
1000,480,511,520,243,512,755
1000,535,518,493,274,482,756
1000,471,509,498,248,498,746
1000,502,492,488,251,500,751
1000,487,497,474,233,504,737
1000,494,490,498,232,516,748
1000,489,494,505,252,485,737
1000,528,509,505,263,498,761
1000,511,481,511,255,502,757
1000,517,474,520,246,521,767
1000,485,460,518,231,528,759
1000,499,484,502,245,514,759
1000,502,486,482,236,501,737
1000,524,509,522,272,489,761
1000,496,502,489,240,495,735
1000,499,488,474,225,501,726
1000,520,515,510,251,516,767
1000,510,500,473,236,494,730
1000,508,505,469,264,469,733
1000,494,493,501,228,511,739
1000,515,496,490,239,503,742
1000,469,515,511,232,508,740
1000,502,508,503,257,484,741
1000,499,501,472,246,496,742
1000,489,482,472,228,509,737
1000,502,478,475,260,489,749
1000,513,501,508,261,486,747
1000,489,498,525,247,507,754
1000,488,492,516,256,498,754
1000,503,489,479,262,473,735
1000,501,509,508,253,508,761
1000,498,478,511,243,517,760
1000,499,527,511,259,497,756
1000,485,481,506,233,511,744
1000,494,522,517,250,510,760
1000,529,480,507,254,513,767
1000,501,511,495,245,498,743
1000,499,486,475,239,507,746
1000,494,492,481,242,496,738
1000,473,473,460,218,496,714
1000,502,492,496,255,486,741
1000,463,461,520,217,522,739
1000,504,500,495,248,505,753
1000,486,497,521,236,506,742
1000,520,498,509,253,524,777
1000,517,497,500,253,508,761
1000,511,510,520,268,497,765
1000,530,504,507,268,499,767
1000,496,505,494,250,496,746
1000,520,498,506,253,515,768
1000,509,487,505,245,523,768
1000,512,498,477,255,483,738
1000,489,475,475,223,509,732
1000,505,513,524,260,501,761
1000,513,505,499,247,508,755
1000,519,517,503,270,486,756
1000,480,479,507,222,525,747
1000,519,497,490,270,469,739
1000,481,501,522,243,513,756
1000,510,503,499,264,484,748
1000,518,488,527,250,525,775
1000,497,498,493,241,512,753
1000,465,509,504,236,492,728
1000,478,487,491,234,511,745
1000,495,489,519,238,522,760
1000,500,479,503,238,515,753
1000,493,491,485,245,491,736
1000,504,486,495,257,488,745
1000,490,479,492,239,507,746
1000,478,515,501,234,491,725
1000,501,481,502,252,496,748
1000,502,508,495,244,512,756
1000,486,477,510,240,518,758
1000,493,499,501,250,511,761
1000,508,496,487,245,497,742
1000,501,511,506,260,485,745
1000,488,495,531,242,514,756
1000,497,511,501,240,508,748
1000,497,506,505,250,485,735
1000,518,500,484,239,514,753
1000,463,518,500,243,485,728
1000,515,498,507,254,514,768
1000,483,495,493,252,482,734
1000,508,495,496,252,503,755
1000,478,517,507,239,504,743
1000,514,496,534,275,483,758
1000,498,486,516,250,500,750
1000,489,508,473,232,501,733
1000,480,498,490,236,493,729
1000,499,482,487,237,517,754
1000,533,515,470,280,479,759
1000,528,496,501,254,511,765
1000,497,494,515,247,493,740
1000,524,505,494,270,483,753
1000,505,484,498,241,504,745
1000,519,507,491,266,499,765
1000,539,483,489,267,488,755
1000,498,500,482,252,488,740
1000,478,486,518,238,507,745
1000,505,472,496,245,504,749
1000,526,487,496,248,513,761
1000,507,537,489,271,472,743
1000,460,509,496,234,498,732
1000,493,485,490,239,488,727
1000,477,502,516,252,497,749
1000,539,484,512,262,511,773
1000,487,490,490,253,496,749
1000,500,510,504,246,506,752
1000,499,503,493,259,499,758
1000,508,493,512,234,521,755
1000,496,519,501,254,492,746
1000,485,490,499,244,496,740
1000,483,526,489,258,471,729
1000,500,478,488,238,504,742
1000,491,534,530,265,496,761
1000,492,480,493,235,497,732
1000,479,477,507,219,530,749
1000,486,485,509,226,501,727
1000,477,471,483,215,510,725
1000,465,499,508,243,498,741
1000,521,484,494,244,522,766
1000,514,500,522,269,488,757
1000,508,499,513,268,485,753
1000,480,493,494,241,504,745
1000,514,497,492,247,509,756
1000,481,506,502,240,492,732
1000,500,492,465,257,472,729
1000,520,485,511,243,518,761
1000,478,479,491,222,519,741
1000,495,502,503,249,491,740
1000,492,512,471,253,473,726
1000,517,488,519,231,528,759
1000,542,484,486,279,484,763
1000,526,462,516,237,533,770
1000,488,488,492,236,497,733
1000,496,497,504,254,487,741
1000,508,470,477,242,506,748
1000,489,496,504,238,525,763
1000,504,517,494,263,470,733
1000,508,505,519,253,513,766
1000,511,489,492,234,513,747
1000,525,477,473,260,475,735
1000,522,517,507,259,481,740
1000,479,476,495,220,524,744
1000,528,486,497,252,517,769
1000,494,511,487,261,471,732
1000,508,509,492,265,485,750
1000,535,500,495,269,485,754
1000,504,507,499,248,511,759
1000,530,492,509,261,510,771
1000,516,490,515,247,529,776
1000,513,465,514,230,535,765
1000,501,472,504,241,515,756
1000,529,499,490,272,484,756
1000,501,470,513,222,529,751
1000,504,518,503,244,508,752
1000,509,480,494,238,524,762
1000,512,510,514,264,506,770
1000,498,497,513,250,508,758
1000,494,486,516,235,523,758
1000,519,521,514,269,493,762
1000,500,506,492,259,481,740
1000,501,497,523,240,526,766
1000,539,524,512,271,513,784
1000,480,491,487,227,493,720
1000,491,504,493,243,509,752
1000,521,468,501,241,519,760
1000,473,497,523,239,503,742
1000,468,525,497,234,506,740
1000,501,492,510,235,515,750
1000,516,479,489,249,509,758
1000,504,506,487,252,494,746
1000,504,483,502,246,497,743
1000,521,501,489,263,485,748
1000,495,501,513,244,505,749
1000,503,477,500,245,507,752
1000,520,507,500,257,512,769
1000,493,478,518,236,513,749
1000,515,493,497,257,499,756
1000,500,508,513,261,478,739
1000,482,501,546,224,536,760
1000,535,491,486,253,498,751
1000,498,530,521,255,504,759
1000,519,474,525,257,519,776
1000,502,485,495,237,516,753
1000,471,488,494,218,512,730
1000,492,478,501,237,520,757
1000,482,503,521,249,515,764
1000,492,495,495,256,479,735
1000,497,489,508,235,524,759
1000,494,513,508,249,491,740
1000,513,494,528,244,533,777
1000,502,489,507,257,495,752
1000,484,501,493,254,480,734
1000,479,517,512,247,500,747
1000,506,509,490,247,499,746
1000,503,495,492,246,483,729
1000,492,491,486,255,485,740
1000,523,496,480,261,481,742
1000,501,492,503,260,494,754
1000,522,495,495,255,503,758
1000,515,511,536,270,505,775
1000,486,490,487,235,491,726
1000,490,510,512,248,507,755
1000,490,510,491,237,493,730
1000,507,501,504,257,496,753
1000,487,488,507,223,534,757
1000,498,504,507,246,501,747
1000,512,502,492,256,507,763
1000,505,493,497,244,510,754
1000,516,493,450,256,476,732
1000,526,487,493,243,526,769
1000,508,489,503,235,530,765
1000,497,510,473,265,478,743
1000,510,485,514,253,513,766
1000,500,486,501,229,517,746
1000,493,491,500,239,508,747
1000,504,516,501,261,493,754
1000,496,513,488,253,485,738
1000,475,517,472,249,470,719
1000,491,496,489,259,482,741
1000,506,499,478,266,475,741
1000,487,473,494,212,534,746
1000,485,492,506,243,498,741
1000,508,517,493,265,472,737
1000,471,496,512,253,486,739
1000,515,504,494,259,489,748
1000,501,507,476,256,486,742
1000,496,497,506,262,469,731
1000,502,494,490,256,479,735
1000,517,503,486,273,471,744
1000,485,493,495,239,504,743
1000,476,449,492,222,515,737
1000,508,514,504,260,509,769
1000,525,509,500,255,512,767
1000,505,536,467,273,455,728
1000,501,506,497,259,489,748
1000,538,509,526,275,502,777
1000,525,504,506,267,507,774
1000,522,511,476,260,503,763
1000,519,525,518,273,498,771
1000,510,507,499,262,492,754
1000,524,479,495,241,530,771
1000,495,490,499,256,504,760
1000,479,515,508,237,522,759
1000,522,509,502,258,515,773
1000,497,509,527,273,492,765
1000,482,503,472,232,503,735
1000,504,487,533,247,515,762
1000,517,495,484,254,497,751
1000,486,494,486,240,504,744
1000,493,525,517,273,487,760
1000,513,504,501,268,483,751
1000,509,526,500,257,502,759
1000,521,488,518,244,531,775
1000,499,517,506,263,484,747
1000,497,504,456,255,448,703
1000,504,512,483,253,495,748
1000,474,475,497,232,495,727
1000,480,468,485,244,495,739
1000,516,472,527,239,542,781
1000,498,509,489,255,482,737
1000,510,498,487,269,490,759
1000,495,506,488,251,503,754
1000,484,519,526,258,493,751
1000,512,494,504,263,492,755
1000,507,480,492,244,507,751
1000,503,507,517,262,495,757
1000,513,499,516,253,515,768
1000,498,490,492,249,482,731
1000,511,487,528,256,520,776
1000,455,488,492,224,484,708
1000,517,507,520,265,488,753
1000,507,484,490,241,504,745
1000,493,519,489,249,500,749
1000,514,522,493,265,483,748
1000,521,484,480,243,496,739
1000,498,486,502,242,500,742
1000,503,472,497,247,507,754
1000,496,484,500,237,517,754
1000,521,489,487,244,521,765
1000,476,499,491,228,496,724
1000,481,501,491,232,519,751
1000,520,508,481,253,503,756
1000,502,487,494,247,500,747
1000,535,500,481,254,505,759
1000,485,496,486,228,505,733
1000,511,508,520,267,509,776
1000,503,521,507,260,489,749
1000,505,505,542,248,516,764
1000,477,478,483,237,499,736
1000,490,492,495,233,516,749
1000,540,475,490,256,504,760
1000,476,503,505,235,516,751
1000,478,503,498,233,499,732
1000,523,467,512,253,513,766
1000,488,518,473,263,475,738
1000,499,513,486,276,463,739
1000,512,481,527,235,537,772
1000,505,511,495,269,481,750
1000,496,522,519,252,497,749
1000,499,485,470,248,486,734
1000,510,505,493,255,486,741
1000,501,488,459,242,495,737
1000,523,521,513,266,498,764
1000,493,514,501,272,476,748
1000,496,490,495,236,507,743
1000,487,513,518,255,491,746
1000,513,473,498,244,523,767
1000,509,494,512,261,499,760
1000,492,495,493,236,502,738
1000,481,528,473,253,475,728
1000,484,525,512,260,493,753
1000,488,499,491,250,495,745
1000,485,492,508,251,498,749
1000,494,514,515,255,489,744
1000,501,485,496,250,490,740
1000,500,503,481,257,483,740
1000,485,511,506,246,496,742
1000,502,481,505,249,499,748
1000,498,498,531,258,503,761
1000,480,528,496,258,471,729
1000,481,497,516,241,513,754
1000,523,498,495,265,509,774
1000,497,496,482,235,506,741
1000,500,518,489,261,478,739
1000,488,499,485,236,495,731
1000,448,471,516,205,531,736
1000,516,491,532,274,494,768
1000,488,465,532,230,534,764
1000,513,505,527,262,508,770
1000,515,501,510,264,493,757
1000,510,498,473,246,502,748
1000,489,484,514,230,523,753
1000,500,495,486,250,486,736
1000,501,499,488,243,499,742
1000,484,490,483,235,510,745
1000,518,491,461,256,481,737
1000,498,495,536,256,510,766
1000,536,494,504,259,517,776
1000,492,478,475,232,488,720
1000,491,496,528,248,504,752
1000,478,495,511,244,484,728
1000,521,471,486,230,523,753
1000,498,541,539,257,507,764
1000,513,491,512,259,502,761
1000,513,496,517,238,527,765
1000,484,508,493,250,492,742
1000,503,483,505,252,500,752
1000,525,489,503,262,506,768
1000,478,493,481,238,492,730
1000,510,534,522,269,485,754
1000,497,502,499,255,494,749
1000,484,494,528,250,504,754
1000,526,497,486,247,506,753
1000,506,491,481,259,480,739
1000,499,517,489,254,494,748
1000,475,503,495,234,490,724
1000,502,536,537,264,511,775
1000,494,500,506,252,511,763
1000,486,476,526,231,514,745
1000,512,506,494,263,501,764
1000,499,511,481,257,485,742
1000,500,506,509,249,521,770
1000,489,516,491,253,501,754
1000,483,505,486,242,494,736
1000,518,495,499,258,490,748
1000,509,471,509,233,520,753
1000,496,494,482,248,494,742
1000,488,522,498,246,505,751
1000,514,520,525,277,495,772
1000,490,500,507,255,503,758
1000,505,491,506,247,515,762
1000,492,496,525,251,518,769
1000,486,502,476,242,489,731
1000,519,495,475,271,481,752
1000,517,514,510,263,505,768
1000,509,485,517,246,528,774
1000,504,512,500,266,484,750
1000,505,494,512,250,499,749
1000,501,478,502,234,520,754
1000,509,498,508,261,494,755
1000,489,493,489,246,494,740
1000,491,483,486,230,499,729
1000,514,494,501,262,494,756
1000,516,467,506,237,518,755
1000,513,489,488,269,493,762
1000,527,460,477,246,484,730
1000,530,505,477,267,473,740
1000,476,484,521,252,504,756
1000,499,492,491,245,506,751
1000,489,488,467,255,464,719
1000,487,511,500,243,477,720
1000,485,522,496,246,499,745
1000,496,510,562,258,530,788
1000,492,509,512,247,510,757
1000,496,515,526,243,521,764
1000,473,510,485,254,476,730
1000,490,524,522,243,512,755
1000,502,517,484,251,485,736
1000,509,505,523,257,508,765
1000,511,465,518,232,528,760
1000,507,497,495,240,512,752
1000,526,497,487,251,499,750
1000,479,479,484,245,497,742
1000,480,488,503,236,499,735
1000,515,476,497,234,524,758
1000,488,511,474,247,485,732
1000,507,497,496,243,495,738
1000,509,497,489,256,479,735
1000,513,512,523,260,512,772
1000,512,519,491,269,487,756
1000,497,490,467,258,475,733
1000,498,515,509,257,506,763
1000,487,492,511,235,516,751
1000,522,513,498,262,499,761
1000,508,493,516,254,514,768
1000,484,485,492,224,515,739
1000,488,510,485,254,487,741
1000,496,489,483,244,485,729
1000,480,482,497,237,496,733
1000,514,500,516,276,487,763
1000,503,490,482,248,478,726
1000,507,480,490,240,497,737
1000,534,479,489,266,513,779
1000,486,520,503,254,488,742
1000,478,500,506,238,507,745
1000,533,477,509,266,512,778
1000,477,507,494,236,499,735
1000,503,526,502,261,485,746
1000,517,502,519,254,506,760
1000,491,517,465,251,464,715
1000,479,506,507,235,497,732
1000,499,491,468,249,485,734
1000,498,496,508,256,499,755
1000,496,505,492,249,499,748
1000,524,506,501,269,509,778
1000,516,515,555,269,501,770
1000,525,507,492,272,496,768
1000,509,514,488,248,499,747
1000,497,476,505,241,513,754
1000,521,491,517,257,514,771
1000,523,500,496,243,508,751
1000,528,498,486,259,503,762
1000,488,476,503,237,497,734
1000,507,505,483,251,493,744
1000,493,527,541,258,506,764
1000,511,514,486,264,480,744
1000,459,510,497,224,495,719
1000,488,497,522,244,503,747
1000,494,483,524,235,520,755
1000,457,516,481,239,484,723
1000,503,482,494,251,499,750
1000,498,513,515,254,500,754
1000,508,501,491,254,497,751
1000,534,513,509,285,485,770
1000,507,469,511,238,531,769
1000,519,487,500,257,494,751
1000,482,483,491,228,513,741
1000,482,469,504,218,515,733
1000,516,524,524,262,507,769
1000,491,497,494,253,475,728
1000,526,514,484,255,508,763
1000,499,505,489,260,500,760
1000,532,519,519,267,495,762
1000,506,489,520,255,505,760
1000,488,503,500,236,513,749
1000,490,495,509,241,511,752
1000,483,522,497,244,517,761
1000,471,502,482,235,477,712
1000,499,518,513,274,477,751
1000,542,498,515,276,502,778
1000,496,504,498,254,479,733
1000,482,495,529,238,509,747
1000,476,491,476,239,484,723
1000,513,529,504,273,480,753
1000,485,478,496,234,507,741
1000,515,478,501,250,510,760
1000,487,508,487,230,497,727
1000,506,474,502,241,511,752
1000,499,507,531,253,502,755
1000,495,498,499,248,508,756
1000,520,477,493,247,514,761
1000,512,493,492,232,520,752
1000,528,474,478,268,486,754
1000,485,482,525,232,537,769
1000,481,478,527,235,519,754
1000,501,485,505,224,522,746
1000,505,483,519,236,528,764
1000,486,508,491,264,479,743
1000,494,478,522,245,528,773
1000,505,478,496,251,494,745
1000,514,504,532,268,520,788
1000,515,471,505,230,533,763
1000,504,464,485,248,502,750
1000,521,498,516,242,531,773
1000,496,538,521,281,484,765
1000,517,498,508,255,511,766
1000,517,479,504,251,503,754
1000,518,496,503,261,494,755
1000,491,487,490,236,501,737
1000,497,481,478,227,505,732
1000,469,474,522,223,516,739
1000,499,486,465,246,485,731
1000,484,504,501,244,484,728
1000,495,484,501,229,520,749
1000,502,502,516,253,500,753
1000,506,499,506,249,508,757
1000,557,510,516,274,504,778
1000,509,502,523,253,521,774
1000,512,521,506,278,488,766
1000,499,522,513,255,499,754
1000,519,495,495,272,490,762
1000,495,490,493,241,520,761
1000,512,498,501,255,502,757
1000,499,507,490,253,505,758
1000,529,513,465,277,469,746
1000,485,514,493,258,484,742
1000,500,522,514,261,486,747
1000,495,507,478,245,502,747
1000,499,518,475,266,483,749
1000,503,487,495,246,505,751
1000,466,490,509,230,517,747
1000,502,531,526,245,524,769
1000,480,475,491,227,514,741
1000,470,524,482,256,463,719
1000,517,524,510,256,516,772
1000,489,483,494,227,525,752
1000,492,491,484,239,498,737
1000,490,478,495,233,510,743
1000,469,513,485,239,479,718
1000,514,489,483,246,519,765
1000,489,478,497,232,508,740
1000,493,488,506,252,502,754
1000,477,494,515,230,510,740
1000,493,536,501,260,487,747
1000,506,488,506,244,513,757
1000,530,502,503,275,473,748
1000,456,463,515,207,526,733
1000,480,516,511,267,481,748
1000,505,517,488,262,496,758
1000,505,515,497,261,492,753
1000,478,538,492,242,498,740
1000,510,501,517,269,482,751
1000,494,487,469,233,503,736
1000,496,495,506,251,495,746
1000,516,480,461,245,502,747
1000,491,488,484,234,491,725
1000,500,512,497,249,511,760
1000,494,496,471,241,483,724
1000,485,491,498,239,497,736
1000,498,523,505,254,495,749
1000,508,497,514,259,509,768
1000,526,489,511,258,486,744
1000,485,495,497,231,508,739
1000,539,511,471,269,485,754
1000,527,506,504,263,496,759
1000,497,500,516,253,507,760
1000,519,507,501,272,492,764
1000,496,514,505,256,497,753
1000,523,476,497,263,504,767
1000,510,496,478,257,495,752
1000,502,490,488,250,497,747
1000,525,507,501,272,464,736
1000,480,507,492,253,467,720
1000,495,490,507,240,505,745
1000,500,500,492,250,484,734
1000,510,520,485,259,490,749
1000,483,503,493,244,482,726
1000,512,486,473,253,494,747
1000,500,509,491,257,499,756
1000,500,494,519,256,506,762
1000,491,502,509,233,505,738
1000,500,506,521,247,522,769
1000,474,505,506,230,521,751
1000,519,487,526,252,528,780
1000,534,504,495,274,481,755
1000,494,501,469,259,469,728
1000,513,500,495,239,515,754
1000,490,499,500,242,492,734
1000,484,485,515,240,502,742
1000,506,525,495,256,510,766
1000,480,522,488,245,484,729
1000,502,488,501,236,525,761
1000,496,496,505,237,513,750
1000,524,475,510,242,528,770
1000,506,504,498,244,506,750
1000,521,508,502,269,490,759
1000,495,492,514,257,492,749
1000,471,500,497,234,497,731
1000,496,495,518,247,509,756
1000,538,496,514,280,506,786
1000,515,483,483,255,495,750
1000,466,482,511,225,526,751
1000,481,498,494,243,499,742
1000,515,527,487,271,478,749
1000,528,488,489,266,487,753
1000,518,519,506,262,491,753
1000,520,476,505,256,514,770
1000,499,512,526,256,508,764
1000,496,499,496,252,492,744
1000,522,482,503,253,510,763
1000,517,503,491,242,509,751
1000,513,488,488,251,506,757
1000,472,456,481,203,526,729
1000,473,487,497,245,492,737
1000,483,491,499,245,489,734
1000,481,493,511,230,520,750
1000,482,492,486,238,481,719
1000,520,517,488,269,502,771
1000,489,509,518,241,524,765
1000,517,479,495,249,504,753
1000,484,502,479,235,500,735
1000,496,478,489,239,504,743
1000,499,507,478,255,486,741
1000,533,483,524,271,491,762
1000,480,491,481,235,502,737
1000,501,529,536,267,488,755
1000,493,504,515,248,510,758
1000,492,483,495,235,510,745
1000,503,485,480,261,488,749
1000,519,521,504,276,478,754
1000,510,507,496,273,480,753
1000,531,511,492,264,484,748
1000,490,484,502,243,499,742
1000,500,495,501,252,499,751
1000,497,483,525,232,529,761
1000,499,514,494,253,495,748
1000,503,510,508,245,518,763
1000,518,507,512,274,505,779
1000,511,473,501,233,518,751
1000,513,515,511,266,501,767
1000,509,496,499,245,505,750
1000,521,516,510,253,519,772
1000,495,498,509,249,514,763
1000,518,528,524,267,499,766
1000,471,507,502,232,511,743
1000,520,526,505,273,493,766
1000,507,479,475,243,496,739
1000,478,501,498,244,501,745
1000,509,503,512,244,519,763
1000,469,515,536,247,493,740
1000,500,482,498,246,505,751
1000,507,486,527,227,540,767
1000,522,502,491,245,522,767
1000,490,503,507,240,510,750
1000,521,502,510,250,519,769
1000,506,520,508,280,467,747
1000,484,488,497,233,510,743
1000,511,529,510,251,504,755
1000,508,504,489,265,472,737
1000,512,504,515,266,506,772
1000,493,503,451,241,484,725
1000,498,509,510,260,489,749
1000,484,525,500,254,487,741
1000,507,484,510,249,506,755
1000,483,504,511,225,528,753
1000,486,506,487,235,514,749
1000,494,495,502,248,487,735
1000,502,489,486,238,516,754
1000,483,475,523,244,520,764
1000,470,502,500,241,492,733
1000,497,501,487,230,498,728
1000,479,506,508,228,510,738
1000,488,522,498,243,508,751
1000,527,506,497,275,489,764
1000,496,505,508,251,504,755
1000,516,492,501,259,508,767
1000,497,520,510,272,514,786
1000,492,495,496,245,490,735
1000,470,479,497,217,515,732
1000,498,520,499,264,476,740
1000,497,501,503,257,496,753
1000,496,491,470,242,486,728
1000,499,504,496,241,488,729
1000,492,507,486,252,489,741
1000,506,487,517,240,514,754
1000,515,468,518,239,525,764
1000,507,496,491,260,495,755
1000,493,516,512,249,505,754
1000,515,480,458,255,483,738
1000,520,508,508,259,508,767
1000,514,481,492,229,531,760
1000,500,482,495,227,523,750
1000,508,497,471,245,479,724
1000,489,536,501,260,476,736
1000,508,505,490,248,500,748
1000,503,498,484,240,516,756
1000,500,497,510,239,519,758
1000,511,498,507,259,508,767
1000,504,501,499,252,496,748
1000,521,491,508,254,524,778
1000,475,494,483,231,500,731
1000,505,505,491,244,501,745
1000,510,480,477,246,502,748
1000,523,524,497,271,487,758
1000,494,484,521,236,520,756
1000,518,468,480,249,492,741
1000,497,486,489,253,489,742
1000,522,486,505,242,526,768
1000,492,496,501,241,508,749
1000,520,517,482,270,478,748
1000,493,506,534,249,509,758
1000,504,514,475,261,469,730
1000,529,483,492,263,506,769
1000,522,500,509,249,528,777
1000,513,513,507,269,488,757
1000,518,540,507,283,484,767
1000,506,510,481,262,492,754
1000,496,506,506,254,491,745
1000,499,502,505,245,502,747
1000,516,510,464,266,477,743
1000,513,505,521,258,522,780
1000,517,485,538,253,516,769
1000,479,477,499,244,508,752
1000,501,471,518,242,531,773
1000,498,494,507,233,519,752
1000,485,501,469,236,499,735
1000,502,501,514,266,489,755
1000,501,505,511,247,514,761
1000,489,509,485,247,485,732
1000,474,477,487,231,497,728
1000,460,502,505,233,505,738
1000,488,506,496,232,505,737
1000,460,480,492,226,507,733
1000,531,497,524,262,516,778
1000,510,512,498,254,490,744
1000,491,505,486,249,495,744
1000,527,509,513,282,485,767
1000,502,517,475,254,486,740
1000,483,489,523,240,520,760
1000,513,513,512,279,489,768
1000,516,506,498,272,473,745
1000,480,493,508,230,520,750
1000,538,484,524,258,526,784
1000,497,486,527,234,515,749
1000,521,513,505,265,488,753
1000,499,502,501,236,500,736
1000,505,505,499,248,498,746
1000,520,502,506,263,484,747
1000,505,481,508,244,520,764
1000,502,481,488,232,520,752
1000,495,486,513,248,503,751
1000,532,494,524,253,535,788
1000,480,483,492,218,500,718
1000,481,524,490,239,494,733
1000,502,476,501,244,523,767
1000,509,504,510,263,500,763
1000,472,510,491,237,502,739
1000,483,519,486,248,489,737
1000,475,497,497,249,495,744
1000,497,500,464,251,482,733
1000,509,505,471,264,482,746
1000,497,487,485,229,518,747
1000,507,512,495,256,500,756
1000,513,507,516,268,491,759
1000,483,501,492,243,485,728
1000,509,520,509,265,503,768
1000,500,508,507,258,491,749
1000,522,501,513,264,499,763
1000,488,491,510,237,526,763
1000,490,491,467,232,504,736
1000,460,500,489,227,508,735
1000,519,487,484,253,507,760
1000,506,493,492,248,505,753
1000,504,528,492,284,452,736
1000,502,514,509,262,498,760
1000,501,516,491,262,492,754
1000,494,519,474,253,487,740
1000,503,502,489,245,509,754
1000,499,475,497,229,510,739
1000,493,499,493,255,484,739
1000,501,508,513,259,512,771
1000,503,507,483,259,490,749
1000,514,491,490,248,513,761
1000,499,506,486,253,492,745
1000,472,480,507,240,494,734
1000,507,506,527,257,513,770
1000,503,523,501,262,491,753
1000,475,515,504,250,484,734
1000,495,503,490,232,518,750
1000,515,516,481,265,484,749
1000,502,488,497,245,502,747
1000,511,486,517,257,523,780
1000,527,511,467,259,492,751
1000,510,483,480,244,483,727
1000,506,546,503,275,490,765
1000,488,534,500,269,480,749
1000,519,499,483,263,479,742
1000,484,492,470,228,495,723
1000,502,511,520,261,495,756
1000,512,508,508,264,489,753
1000,496,515,497,251,505,756
1000,519,523,503,266,489,755
1000,473,475,483,226,491,717
1000,494,514,500,250,506,756
1000,515,500,512,267,486,753
1000,486,507,511,248,499,747
1000,502,513,499,247,503,750
1000,515,483,510,243,520,763
1000,497,496,489,230,525,755
1000,491,491,511,229,520,749
1000,496,487,463,247,494,741
1000,483,520,506,251,497,748
1000,495,513,490,245,493,738
1000,518,497,507,259,516,775
1000,520,500,494,245,528,773
1000,513,489,476,266,481,747
1000,498,500,517,259,503,762
1000,488,467,528,229,538,767
1000,512,475,504,242,509,751
1000,511,487,503,254,495,749
1000,495,491,485,237,487,724
1000,477,496,505,251,498,749
1000,490,503,468,252,488,740
1000,501,498,494,264,471,735
1000,502,498,495,267,476,743
1000,493,527,506,255,490,745
1000,508,480,522,233,533,766
1000,506,503,496,258,493,751
1000,480,493,505,244,498,742
1000,494,480,491,235,489,724
1000,489,503,517,252,505,757
1000,504,491,523,238,532,770
1000,505,508,506,273,474,747
1000,515,509,524,249,520,769
1000,495,486,491,245,488,733
1000,500,495,508,252,511,763
1000,463,493,503,236,493,729
1000,516,489,477,264,485,749
1000,517,496,486,249,503,752
1000,501,493,544,248,528,776
1000,475,466,488,216,532,748
1000,515,475,515,257,515,772
1000,524,507,482,264,482,746
1000,539,495,469,273,473,746
1000,506,500,502,251,513,764
1000,511,501,500,264,491,755
1000,501,483,496,248,487,735
1000,513,506,503,257,502,759
1000,485,515,500,257,484,741
1000,515,494,504,252,510,762
1000,486,468,518,211,550,761
1000,498,511,502,257,494,751
1000,488,483,493,229,512,741
1000,505,508,498,253,510,763
1000,493,503,516,259,493,752
1000,508,489,509,244,514,758
1000,517,480,513,240,526,766
1000,515,524,512,265,508,773
1000,495,508,502,244,499,743
1000,512,493,497,260,491,751
1000,486,510,509,251,495,746
1000,494,490,531,250,514,764
1000,489,493,528,255,508,763
1000,505,502,494,263,481,744
1000,488,507,505,244,498,742
1000,504,496,511,239,522,761
1000,518,494,516,252,512,764
1000,509,489,495,245,503,748
1000,478,519,505,248,498,746
1000,494,499,495,233,507,740
1000,473,509,478,233,497,730
1000,522,530,498,265,483,748
1000,484,506,513,240,505,745
1000,500,464,490,222,522,744
1000,495,511,510,259,502,761
1000,512,476,506,247,505,752
1000,492,489,510,242,522,764
1000,481,516,515,249,500,749
1000,491,497,535,219,547,766
1000,495,490,493,246,486,732
1000,495,483,508,238,513,751
1000,520,495,514,261,505,766
1000,500,495,493,232,508,740
1000,480,506,506,228,518,746
1000,505,499,476,243,497,740
1000,503,494,491,256,491,747
1000,502,510,507,267,492,759
1000,523,494,482,273,483,756
1000,521,512,509,261,492,753
1000,491,486,509,235,523,758
1000,493,502,470,247,476,723
1000,470,497,510,233,513,746
1000,507,491,500,243,500,743
1000,492,491,536,236,520,756
1000,505,472,489,246,498,744
1000,532,497,515,275,497,772
1000,511,489,531,251,523,774
1000,490,526,477,249,486,735
1000,508,494,476,253,502,755
1000,494,507,504,250,496,746
1000,520,503,505,262,501,763
1000,528,494,473,265,490,755
1000,500,499,503,249,508,757
1000,498,521,514,253,492,745
1000,503,522,486,257,489,746
1000,501,497,515,255,516,771
1000,526,499,524,252,518,770
1000,520,510,494,271,484,755
1000,499,494,514,250,503,753
1000,515,490,528,264,513,777
1000,494,488,495,245,488,733
1000,498,514,510,250,493,743
1000,499,531,477,264,467,731
1000,522,484,505,257,512,769
1000,484,493,529,238,500,738
1000,508,507,492,246,507,753
1000,505,487,488,250,502,752
1000,485,497,489,250,485,735
1000,476,518,501,258,488,746
1000,487,509,478,253,474,727
1000,498,486,509,236,525,761
1000,498,476,486,250,481,731
1000,469,507,509,236,496,732
1000,502,492,495,260,490,750
1000,497,506,482,255,486,741
1000,497,495,493,239,488,727
1000,492,537,502,266,479,745
1000,512,500,529,260,512,772
1000,498,490,497,240,492,732
1000,530,509,496,254,520,774
1000,491,535,491,255,479,734
1000,480,486,494,242,491,733
1000,494,482,527,242,520,762
1000,491,509,526,250,505,755
1000,504,518,520,259,497,756
1000,491,494,511,245,505,750
1000,483,503,479,247,473,720
1000,506,502,503,254,489,743
1000,477,487,497,233,507,740
1000,527,531,506,278,496,774
1000,467,496,496,230,513,743
1000,482,489,496,231,511,742
1000,508,527,502,275,486,761
1000,479,524,516,253,487,740
1000,497,498,516,241,498,739
1000,489,518,505,266,477,743
1000,498,512,498,263,499,762
1000,503,528,502,266,496,762
1000,495,469,481,237,487,724
1000,492,481,505,222,516,738
1000,486,518,479,253,470,723
1000,509,520,507,272,490,762
1000,512,512,526,247,533,780
1000,482,512,488,253,486,739
1000,507,507,490,261,490,751
1000,479,467,487,226,507,733
1000,501,460,503,226,547,773
1000,522,492,507,243,533,776
1000,521,509,494,264,483,747
1000,489,547,509,266,486,752
1000,512,502,504,246,505,751
1000,552,494,534,267,514,781
1000,490,495,466,246,483,729
1000,508,482,489,257,485,742
1000,521,506,470,263,480,743
1000,498,486,499,240,523,763
1000,510,501,519,250,506,756
1000,494,480,491,245,486,731
1000,487,511,518,260,490,750
1000,508,479,504,239,530,769
1000,511,509,507,257,496,753
1000,511,494,475,262,481,743
1000,504,494,546,256,517,773
1000,509,500,493,258,507,765
1000,515,518,486,265,479,744
1000,475,489,487,231,491,722
1000,493,493,472,253,484,737
1000,505,500,505,259,497,756
1000,481,508,509,253,487,740
1000,508,512,515,257,504,761
1000,506,477,503,245,514,759
1000,490,486,502,230,510,740
1000,513,491,498,262,475,737
1000,498,529,467,268,461,729
1000,503,487,509,260,497,757
1000,502,507,496,273,476,749
1000,493,503,473,239,482,721
1000,494,498,488,244,506,750
1000,494,472,489,232,528,760
1000,494,504,500,243,492,735
1000,488,490,536,233,529,762
1000,507,527,495,254,511,765
1000,507,512,500,253,507,760
1000,482,532,521,249,502,751
1000,469,519,497,229,503,732
1000,492,494,500,243,512,755
1000,522,512,518,262,511,773
1000,517,516,478,273,473,746
1000,499,482,510,234,518,752
1000,509,497,485,252,497,749
1000,501,500,517,251,508,759
1000,492,514,491,272,473,745
1000,505,522,488,265,488,753
1000,492,520,510,253,495,748
1000,500,486,476,232,494,726
1000,505,485,487,246,497,743
1000,489,519,501,250,503,753
1000,510,506,497,253,495,748
1000,497,467,504,221,521,742
1000,497,499,502,243,502,745
1000,514,528,500,270,493,763
1000,490,518,499,252,484,736
1000,498,528,515,256,504,760
1000,534,505,483,259,505,764
1000,497,503,465,260,468,728
1000,504,495,487,251,503,754
1000,486,522,503,261,492,753
1000,489,521,479,265,467,732
1000,522,514,513,272,499,771
1000,494,526,501,261,489,750
1000,497,488,501,241,492,733
1000,522,482,493,252,509,761
1000,506,510,476,261,467,728
1000,475,499,489,244,479,723
1000,500,485,530,239,525,764
1000,503,473,512,242,515,757
1000,506,517,511,264,501,765
1000,514,522,498,266,502,768
1000,510,472,511,233,526,759
1000,493,479,513,227,517,744
1000,476,500,492,231,506,737
1000,505,505,522,262,493,755
1000,522,516,504,275,489,764
1000,522,519,512,280,484,764
1000,480,481,517,225,524,749
1000,529,513,528,272,516,788
1000,516,503,513,266,499,765
1000,467,494,508,222,506,728
1000,517,495,487,256,495,751
1000,502,485,492,256,491,747
1000,489,487,477,234,506,740
1000,509,490,499,235,521,756
1000,464,523,490,253,464,717
1000,471,506,514,240,498,738
1000,499,484,501,243,516,759
1000,505,507,470,266,483,749
1000,483,513,493,232,499,731
1000,505,529,520,275,484,759
1000,515,496,464,258,483,741
1000,503,539,491,282,471,753
1000,510,494,515,262,497,759
1000,486,511,497,257,494,751
1000,516,505,496,265,505,770
1000,508,500,480,251,489,740
1000,511,487,497,247,521,768
1000,523,512,511,258,516,774
1000,525,493,502,255,519,774
1000,519,512,489,274,463,737
1000,518,504,517,260,526,786
1000,519,483,490,250,511,761
1000,503,506,487,259,490,749
1000,517,465,487,247,514,761
1000,527,509,500,257,494,751
1000,516,479,500,248,510,758
1000,535,475,497,257,501,758
1000,534,508,477,251,501,752
1000,514,482,504,240,520,760
1000,505,508,494,239,506,745
1000,499,513,499,268,481,749
1000,480,507,494,247,489,736
1000,533,521,494,279,486,765
1000,491,495,493,240,510,750
1000,506,507,524,253,499,752
1000,489,513,502,242,510,752
1000,520,487,482,251,499,750
1000,500,519,487,257,488,745
1000,496,508,510,253,501,754
1000,520,490,480,252,502,754
1000,490,492,519,249,507,756
1000,521,520,511,264,518,782
1000,470,481,476,227,498,725
1000,497,535,494,272,471,743
1000,497,485,485,263,468,731
1000,516,496,478,270,482,752
1000,463,506,488,234,492,726
1000,488,533,504,261,484,745
1000,487,498,493,251,489,740
1000,477,474,507,249,507,756
1000,492,478,499,230,516,746
1000,512,510,500,260,491,751
1000,494,525,521,245,510,755
1000,488,514,473,261,477,738
1000,479,510,494,249,488,737
1000,518,492,523,260,509,769
1000,497,518,495,259,494,753
1000,504,492,482,232,514,746
1000,480,495,496,248,486,734
1000,509,487,514,245,497,742
1000,502,497,505,243,510,753
1000,507,488,494,247,516,763
1000,495,490,486,244,498,742
1000,504,503,481,249,492,741
1000,497,527,473,267,468,735
1000,486,528,492,265,481,746
1000,487,492,494,226,507,733
1000,476,508,497,247,496,743
1000,496,498,510,251,511,762
1000,501,497,490,251,497,748
1000,483,521,501,249,493,742
1000,498,505,546,252,525,777
1000,502,513,479,260,472,732
1000,480,509,519,251,498,749
1000,497,523,502,259,509,768
1000,512,502,492,263,498,761
1000,494,508,507,247,514,761
1000,502,500,488,242,508,750
1000,497,477,476,251,474,725
1000,502,523,486,248,494,742
1000,489,511,504,248,501,749
1000,491,513,490,259,482,741
1000,521,504,508,261,512,773
1000,490,517,512,248,499,747
1000,525,516,492,272,484,756
1000,483,483,491,239,514,753
1000,492,497,524,239,525,764
1000,524,506,490,264,494,758
1000,496,521,468,256,477,733
1000,500,486,484,248,498,746
1000,525,512,501,262,497,759
1000,512,500,511,250,505,755
1000,504,497,484,250,502,752
1000,519,521,484,271,482,753
1000,498,487,511,246,503,749
1000,526,525,506,292,476,768
1000,469,512,502,229,497,726
1000,503,522,510,258,490,748
1000,488,506,504,254,492,746
1000,506,485,485,254,485,739
1000,486,498,503,250,501,751
1000,511,470,476,242,503,745
1000,475,493,501,235,498,733
1000,480,476,470,220,498,718
1000,495,519,482,265,480,745
1000,473,497,504,226,512,738
1000,510,499,482,264,493,757
1000,494,484,505,247,503,750
1000,509,495,509,252,508,760
1000,523,468,496,236,539,775
1000,474,520,526,234,508,742
1000,517,495,522,266,500,766
1000,509,522,506,253,500,753
1000,531,524,508,276,496,772
1000,509,492,501,255,493,748
1000,519,477,497,251,498,749
1000,485,499,499,253,496,749
1000,524,523,478,272,482,754
1000,483,520,485,251,488,739
1000,460,485,502,225,516,741
1000,514,513,453,253,485,738
1000,509,480,521,252,517,769
1000,500,490,506,258,479,737
1000,469,496,468,241,483,724
1000,515,491,507,254,496,750
1000,477,503,495,243,491,734
1000,501,488,460,240,484,724
1000,488,467,517,233,524,757
1000,511,493,516,257,514,771
1000,513,505,485,264,478,742
1000,468,516,502,243,494,737
1000,508,489,498,247,511,758
1000,505,465,474,237,515,752
1000,493,507,522,247,512,759
1000,502,502,514,254,511,765
1000,530,501,532,279,485,764
1000,509,483,483,240,510,750
1000,513,510,509,261,499,760
1000,494,503,493,256,503,759
1000,515,491,473,252,489,741
1000,505,505,480,264,488,752
1000,493,499,502,242,508,750
1000,514,496,494,245,514,759
1000,505,478,497,238,517,755
1000,484,503,493,238,502,740
1000,501,515,513,252,497,749
1000,535,473,479,253,526,779
1000,508,492,494,248,518,766
1000,507,517,481,262,478,740
1000,514,514,499,252,502,754
1000,509,499,475,259,487,746
1000,471,494,510,238,497,735
1000,514,519,525,269,503,772
1000,511,515,478,274,462,736
1000,493,511,460,238,484,722
1000,499,510,535,249,510,759
1000,510,531,505,263,491,754
1000,501,498,514,249,508,757
1000,482,496,502,239,504,743
1000,544,463,478,264,495,759
1000,482,480,487,235,487,722
1000,510,496,510,260,503,763
1000,491,502,496,241,505,746
1000,515,523,489,273,468,741
1000,505,498,484,242,501,743
1000,516,526,511,275,487,762
1000,506,529,473,266,481,747
1000,482,504,485,231,496,727
1000,483,495,504,241,523,764
1000,494,522,498,260,482,742
1000,493,494,493,248,491,739
1000,512,482,531,244,517,761
1000,513,480,527,245,537,782
1000,511,488,484,254,501,755
1000,524,490,495,266,502,768
1000,494,504,497,258,504,762
1000,505,524,486,248,497,745
1000,498,526,494,285,458,743
1000,508,528,502,278,469,747
1000,486,496,515,249,507,756
1000,508,495,478,261,467,728
1000,501,516,501,260,499,759
1000,489,486,509,235,520,755
1000,507,473,511,237,524,761
1000,501,500,496,249,490,739
1000,506,503,498,258,491,749
1000,530,489,474,258,501,759
1000,510,513,499,254,507,761
1000,525,496,511,256,510,766
1000,480,493,514,252,492,744
1000,509,494,520,249,509,758
1000,502,487,498,248,490,738
1000,513,514,502,271,495,766
1000,494,488,473,241,478,719
1000,519,493,495,261,498,759
1000,485,476,500,220,523,743
1000,467,490,499,240,503,743
1000,502,471,499,235,508,743
1000,495,508,506,261,480,741
1000,491,488,509,237,514,751
1000,509,454,481,232,506,738
1000,514,486,501,245,516,761
1000,510,496,493,252,511,763
1000,507,495,501,256,487,743
1000,508,515,498,246,511,757
1000,530,504,487,275,495,770
1000,517,499,514,254,509,763
1000,527,494,495,267,507,774
1000,499,489,490,253,492,745
1000,477,534,482,266,457,723
1000,517,523,505,286,475,761
1000,483,497,498,243,495,738
1000,520,508,504,262,508,770
1000,535,508,486,273,503,776
1000,489,501,495,247,493,740
1000,512,486,501,266,484,750
1000,482,500,517,242,503,745
1000,511,545,497,282,479,761
1000,510,486,512,227,523,750
1000,504,490,508,248,509,757
1000,511,485,508,258,492,750
1000,500,477,481,232,507,739
1000,514,498,509,262,505,767
1000,496,495,499,247,510,757
1000,509,475,480,243,514,757
1000,488,489,517,241,520,761
1000,514,493,465,259,488,747
1000,515,521,516,260,509,769
1000,514,505,501,264,508,772
1000,489,497,514,252,497,749
1000,536,489,485,252,520,772
1000,506,483,525,247,516,763
1000,489,497,489,239,490,729
1000,492,501,520,241,523,764
1000,498,504,492,251,494,745
1000,496,508,506,250,502,752
1000,477,486,505,234,520,754
1000,516,482,490,253,498,751
1000,491,523,471,253,484,737
1000,482,475,505,213,531,744
1000,485,458,510,222,530,752
1000,509,504,471,252,497,749
1000,502,520,514,274,473,747
1000,494,490,519,244,512,756
1000,490,519,485,242,497,739
1000,511,528,493,258,492,750
1000,470,498,506,237,502,739
1000,475,529,510,246,495,741
1000,488,504,508,248,497,745
1000,524,507,478,277,483,760
1000,512,519,506,263,490,753
1000,501,506,491,240,508,748
1000,488,485,481,234,498,732
1000,493,505,519,256,503,759
1000,490,490,522,245,515,760
1000,487,514,505,253,493,746
1000,488,503,519,251,508,759
1000,494,479,498,222,521,743
1000,516,503,484,267,492,759
1000,507,496,502,257,508,765
1000,482,507,493,238,499,737
1000,475,520,499,241,495,736
1000,511,519,449,269,465,734
1000,485,493,489,225,505,730
1000,492,526,500,256,489,745
1000,503,473,518,234,536,770
1000,508,502,534,251,528,779
1000,492,496,522,226,515,741
1000,516,515,531,272,508,780
1000,477,503,482,244,483,727
1000,468,505,505,238,498,736
1000,474,498,498,224,516,740
1000,533,472,514,250,528,778
1000,473,512,490,258,456,714
1000,505,494,503,253,504,757
1000,465,491,489,222,484,706
1000,516,498,497,250,524,774
1000,502,490,508,239,520,759
1000,516,495,502,245,515,760
1000,497,503,502,246,498,744
1000,507,484,488,237,496,733
1000,488,503,486,250,488,738
1000,501,494,500,254,494,748
1000,498,511,486,242,499,741
1000,479,505,498,249,493,742
1000,476,510,485,251,480,731
1000,486,499,509,242,515,757
1000,489,500,494,233,519,752
1000,489,531,496,271,488,759
1000,520,533,520,284,500,784
1000,487,489,493,236,502,738
1000,502,480,492,238,508,746
1000,480,524,505,251,503,754
1000,518,516,489,251,517,768
1000,506,490,503,251,498,749
1000,512,537,517,268,492,760
1000,500,532,502,274,487,761
1000,477,479,477,234,509,743
1000,521,505,497,267,475,742
1000,518,504,500,255,508,763
1000,487,529,522,267,487,754
1000,507,477,492,246,517,763
1000,491,496,500,253,489,742
1000,499,516,492,268,478,746
1000,478,503,511,236,522,758
1000,487,539,521,272,495,767
1000,487,493,511,245,504,749
1000,470,510,509,240,504,744
1000,512,471,481,225,515,740
1000,477,494,477,239,477,716
1000,505,481,497,246,507,753
1000,507,530,496,277,466,743
1000,500,476,501,229,513,742
1000,472,506,489,251,489,740
1000,510,515,499,268,499,767
1000,478,493,495,236,492,728
1000,513,499,497,270,489,759
1000,488,496,475,236,493,729
1000,485,497,510,253,486,739
1000,496,494,531,235,522,757
1000,509,513,482,253,485,738
1000,493,479,483,240,499,739
1000,524,518,491,269,492,761
1000,488,498,482,238,511,749
1000,508,494,487,242,507,749
1000,539,511,508,275,493,768
1000,499,512,523,243,512,755
1000,509,487,501,247,504,751
1000,508,485,484,253,474,727
1000,521,509,503,270,494,764
1000,507,503,527,247,524,771
1000,503,496,500,254,489,743
1000,504,520,515,263,484,747
1000,512,484,514,258,496,754
1000,515,498,491,247,497,744
1000,484,520,487,260,473,733
1000,510,493,506,256,504,760
1000,506,500,490,259,486,745
1000,502,511,518,267,510,777
1000,517,539,464,279,478,757
1000,507,512,489,265,490,755
1000,489,497,514,243,507,750
1000,493,498,499,251,496,747
1000,481,503,506,254,489,743
1000,535,496,514,265,514,779
1000,533,499,495,266,503,769
1000,510,527,504,273,495,768
1000,505,502,502,269,477,746
1000,512,481,506,236,534,770
1000,482,530,522,247,505,752
1000,518,515,521,277,503,780
1000,502,494,506,242,508,750
1000,481,497,510,229,510,739
1000,507,523,474,259,488,747
1000,515,504,513,264,505,769
1000,481,517,496,251,481,732
1000,514,520,515,281,481,762
1000,499,516,523,254,486,740
1000,480,529,522,262,494,756
1000,501,523,508,269,496,765
1000,497,475,500,240,508,748
1000,499,496,493,254,481,735
1000,503,492,512,242,509,751
1000,504,508,469,256,477,733
1000,490,503,524,239,519,758
1000,497,497,496,238,517,755
1000,501,507,488,255,486,741
1000,515,530,481,274,470,744
1000,454,482,494,231,488,719
1000,531,498,488,266,486,752
1000,495,520,511,279,493,772
1000,484,531,506,268,487,755
1000,465,504,509,236,507,743
1000,504,474,514,240,513,753
1000,509,470,484,244,505,749
1000,497,508,491,237,509,746
1000,506,493,502,252,508,760
1000,486,489,486,250,489,739
1000,495,509,497,248,496,744
1000,488,517,515,246,504,750
1000,509,516,498,264,479,743
1000,488,488,471,229,491,720
1000,479,488,512,232,504,736
1000,500,505,488,262,487,749
1000,518,499,494,257,503,760
1000,497,532,512,260,497,757
1000,491,507,500,254,488,742
1000,515,510,480,248,497,745
1000,530,522,482,284,473,757
1000,495,526,513,240,511,751
1000,506,520,481,265,480,745
1000,519,502,503,248,527,775
1000,505,509,482,253,501,754
1000,498,501,514,243,519,762
1000,523,472,496,252,506,758
1000,496,486,486,244,495,739
1000,487,496,497,239,516,755
1000,473,495,513,240,495,735
1000,523,509,500,268,495,763
1000,497,502,493,238,509,747
1000,523,511,524,275,499,774
1000,495,501,499,250,492,742
1000,477,470,532,229,536,765
1000,528,498,507,262,504,766
1000,506,466,511,234,524,758
1000,498,515,493,254,495,749
1000,492,455,499,235,511,746
1000,519,502,500,261,506,767
1000,535,520,523,272,507,779
1000,499,489,523,251,511,762
1000,483,499,501,232,515,747
1000,490,522,512,255,503,758
1000,510,513,517,258,509,767
1000,514,521,492,269,471,740
1000,508,506,486,261,482,743
1000,507,528,498,270,475,745
1000,497,499,485,253,490,743
1000,485,521,512,243,501,744
1000,497,529,479,265,479,744
1000,502,496,499,245,514,759
1000,507,505,499,263,485,748
1000,504,511,515,254,510,764
1000,525,513,520,270,509,779
1000,521,530,481,273,478,751
1000,535,495,488,258,500,758
1000,514,493,500,257,505,762
1000,483,481,486,217,518,735
1000,499,494,494,240,507,747
1000,501,490,521,251,505,756
1000,496,513,502,252,505,757
1000,507,530,497,279,476,755
1000,497,487,477,231,513,744
1000,504,491,494,240,495,735
1000,519,514,498,253,499,752
1000,521,499,509,255,511,766
1000,502,528,501,269,472,741
1000,478,503,503,242,501,743
1000,513,500,513,266,490,756
1000,475,507,533,233,510,743
1000,496,492,495,247,495,742
1000,520,476,510,253,503,756
1000,509,502,489,254,498,752
1000,509,480,503,252,490,742
1000,498,500,509,246,516,762
1000,513,520,514,262,507,769
1000,508,488,512,247,512,759
1000,500,527,484,270,467,737
1000,507,514,481,260,485,745
1000,478,511,491,240,499,739
1000,516,500,500,259,502,761
1000,499,505,493,246,501,747
1000,506,500,521,260,514,774
1000,505,482,529,237,536,773
1000,494,472,512,238,514,752
1000,486,515,494,249,488,737
1000,503,515,513,261,488,749
1000,510,475,495,248,501,749
1000,498,501,487,255,477,732
1000,504,505,484,259,485,744
1000,522,502,514,258,495,753
1000,483,518,509,253,510,763
1000,489,486,484,237,505,742
1000,504,509,501,265,509,774
1000,499,525,492,264,492,756
1000,499,486,494,239,505,744
1000,501,509,503,252,489,741
1000,498,500,494,253,502,755
1000,529,510,482,261,489,750
1000,505,493,486,260,484,744
1000,477,495,534,242,524,766
1000,530,506,477,262,492,754
1000,489,508,482,245,495,740
1000,498,487,494,235,512,747
1000,511,491,500,254,498,752
1000,495,502,508,229,505,734
1000,498,491,482,240,510,750
1000,485,529,514,250,501,751
1000,475,505,507,255,494,749
1000,514,523,512,277,486,763
1000,483,520,481,258,474,732
1000,511,519,499,261,506,767
1000,500,507,487,237,497,734
1000,512,496,513,240,515,755
1000,492,495,502,244,509,753
1000,496,504,514,256,492,748
1000,509,499,516,246,524,770
1000,515,488,487,249,502,751
1000,490,488,520,237,508,745
1000,521,511,495,267,493,760
1000,494,506,524,263,485,748
1000,506,528,493,272,468,740
1000,503,524,503,270,467,737
1000,515,511,503,267,496,763
1000,490,509,486,247,504,751
1000,476,521,482,253,490,743
1000,519,502,490,252,507,759
1000,522,505,507,284,487,771
1000,489,486,518,228,530,758
1000,493,492,476,252,484,736
1000,486,507,504,252,502,754
1000,495,518,513,245,497,742
1000,497,502,481,254,492,746
1000,527,476,502,252,518,770
1000,473,477,505,225,513,738
1000,500,529,512,265,485,750
1000,503,475,500,235,513,748
1000,477,511,498,235,500,735
1000,519,503,518,263,509,772
1000,498,502,516,247,511,758
1000,504,495,494,254,500,754
1000,494,508,489,251,495,746
1000,517,494,492,258,484,742
1000,489,505,514,247,508,755
1000,509,506,511,256,503,759
1000,475,516,483,234,479,713
1000,505,491,506,251,497,748
1000,491,488,512,237,518,755
1000,507,480,503,247,510,757
1000,496,476,515,250,516,766
1000,496,475,508,237,516,753
1000,501,478,487,249,491,740
1000,497,502,502,263,490,753
1000,484,478,471,228,505,733
1000,508,487,543,243,540,783
1000,511,476,513,219,546,765
1000,482,509,488,264,461,725
1000,558,502,517,278,505,783
1000,497,495,509,261,499,760
1000,497,516,485,258,490,748
1000,492,502,480,247,497,744
1000,502,518,514,260,495,755
1000,522,494,481,255,492,747
1000,507,479,519,229,527,756
1000,510,511,529,273,502,775
1000,513,461,500,231,518,749
1000,525,499,525,260,515,775
1000,521,499,486,269,491,760
1000,512,486,495,252,494,746
1000,487,500,506,243,512,755
1000,485,494,492,241,496,737
1000,498,486,469,252,477,729
1000,501,496,504,254,498,752
1000,493,498,503,242,514,756
1000,503,509,478,258,484,742
1000,491,492,498,237,508,745
1000,487,494,506,231,515,746
1000,496,487,505,243,505,748
1000,489,489,501,252,491,743
1000,500,483,497,247,508,755
1000,496,516,496,240,511,751
1000,488,526,530,262,500,762
1000,487,517,478,257,478,735
1000,506,525,528,264,510,774
1000,510,519,500,271,496,767
1000,469,510,498,237,492,729
1000,516,507,506,269,487,756
1000,491,482,489,240,492,732
1000,509,491,509,247,500,747
1000,483,497,492,233,507,740
1000,507,499,528,242,531,773
1000,517,495,486,247,482,729
1000,498,496,471,238,501,739
1000,467,501,503,229,493,722
1000,485,488,507,220,524,744
1000,498,514,499,258,492,750
1000,509,482,520,248,518,766
1000,524,481,477,256,499,755
1000,496,529,504,271,470,741
1000,510,511,505,265,485,750
1000,494,502,487,252,478,730
1000,515,498,508,247,507,754
1000,508,472,490,236,522,758
1000,539,521,512,286,494,780
1000,516,494,481,250,504,754
1000,498,504,491,251,502,753
1000,492,503,529,252,500,752
1000,499,486,522,252,499,751
1000,491,482,563,242,513,755
1000,532,482,514,247,536,783
1000,511,491,502,245,495,740
1000,485,455,516,215,549,764
1000,516,495,491,250,508,758
1000,525,502,512,269,501,770
1000,488,472,504,234,519,753
1000,500,471,498,214,539,753
1000,494,522,512,274,475,749
1000,484,526,515,249,473,722
1000,507,516,507,259,508,767
1000,525,481,495,241,512,753
1000,505,495,498,257,491,748
1000,494,476,503,244,524,768
1000,503,499,496,252,495,747
1000,495,471,512,238,525,763
1000,533,516,504,273,505,778
1000,483,511,489,243,493,736
1000,490,501,524,253,508,761
1000,501,504,497,257,490,747
1000,510,496,488,249,486,735
1000,506,508,474,257,490,747
1000,488,526,510,247,489,736
1000,523,509,509,275,482,757
1000,486,515,535,259,496,755
1000,480,489,490,220,516,736
1000,503,507,515,259,501,760
1000,515,490,512,257,524,781
1000,495,463,510,242,504,746
1000,536,495,524,260,515,775
1000,503,497,498,237,492,729
1000,480,504,502,229,507,736
1000,501,495,490,252,501,753
1000,510,485,506,246,502,748
1000,478,484,494,234,497,731
1000,507,517,499,256,495,751
1000,484,520,472,255,477,732
1000,503,500,505,254,509,763
1000,499,493,502,253,497,750
1000,512,518,472,274,471,745
1000,501,509,501,250,516,766
1000,503,505,493,253,487,740
1000,507,526,483,270,477,747
1000,518,520,507,269,501,770
1000,496,492,500,244,491,735
1000,500,504,496,241,510,751
1000,505,473,489,239,501,740
1000,508,502,491,269,485,754
1000,518,488,493,239,522,761
1000,507,506,509,242,519,761
1000,485,499,488,249,501,750
1000,512,476,507,235,523,758
1000,500,482,498,231,511,742
1000,498,495,503,247,501,748
1000,483,502,495,247,482,729
1000,516,456,475,239,512,751
1000,519,505,527,265,509,774
1000,483,512,501,242,493,735
1000,498,498,503,241,520,761
1000,521,490,517,243,524,767
1000,486,494,510,235,518,753
1000,508,504,506,251,495,746
1000,488,505,496,241,500,741
1000,514,514,485,252,495,747
1000,498,511,528,252,505,757
1000,519,489,522,249,528,777
1000,488,511,506,253,497,750
1000,519,511,499,275,482,757
1000,477,509,493,252,484,736
1000,482,541,502,257,487,744
1000,524,511,496,273,483,756
1000,505,522,484,268,481,749
1000,503,492,504,245,507,752
1000,509,489,494,244,515,759
1000,513,470,521,249,515,764
1000,492,482,519,238,516,754
1000,522,502,489,266,494,760
1000,489,501,522,240,511,751
1000,510,502,484,234,529,763
1000,476,488,496,229,510,739
1000,511,499,501,259,513,772
1000,497,520,492,266,473,739
1000,487,533,524,250,506,756
1000,506,518,527,267,512,779
1000,525,497,517,266,501,767
1000,491,488,489,236,505,741
1000,530,525,488,276,484,760
1000,498,479,517,242,518,760
1000,507,499,496,254,508,762
1000,467,522,499,243,511,754
1000,505,516,496,273,490,763
1000,522,529,538,289,489,778
1000,477,492,501,229,505,734
1000,496,533,510,267,480,747
1000,517,539,465,276,468,744
1000,489,506,496,243,496,739
1000,487,491,477,233,504,737
1000,509,500,500,254,490,744
1000,488,498,495,255,488,743
1000,515,505,511,262,505,767
1000,530,497,488,259,488,747
1000,501,507,483,246,499,745
1000,481,506,523,247,498,745
1000,508,491,460,253,476,729
1000,500,480,504,243,497,740
1000,488,469,481,226,508,734
1000,506,490,501,249,499,748
1000,488,491,504,247,495,742
1000,512,507,486,265,482,747
1000,491,505,507,243,513,756
1000,501,505,500,244,501,745
1000,516,484,510,244,522,766
1000,524,503,512,272,515,787
1000,494,490,484,240,501,741
1000,503,491,524,238,529,767
1000,475,503,499,235,500,735
1000,499,494,500,253,495,748
1000,503,497,491,266,479,745
1000,481,518,490,245,484,729
1000,492,500,498,245,517,762
1000,480,511,477,244,494,738
1000,510,520,493,283,467,750
1000,482,530,512,250,494,744
1000,508,513,515,252,505,757
1000,491,466,485,222,515,737
1000,526,500,487,266,499,765
1000,526,497,500,257,500,757
1000,488,523,508,259,487,746
1000,513,499,514,252,522,774
1000,491,487,464,246,486,732
1000,474,495,487,230,490,720
1000,531,491,542,268,521,789
1000,515,497,491,272,483,755
1000,492,493,490,249,486,735
1000,502,498,507,247,512,759
1000,480,478,474,225,504,729
1000,503,499,499,237,503,740
1000,517,523,522,274,495,769
1000,514,487,497,256,503,759
1000,499,519,495,238,503,741
1000,480,497,506,248,476,724
1000,490,487,488,246,493,739
1000,494,476,466,233,492,725
1000,515,475,486,249,486,735
1000,489,502,487,252,476,728
1000,490,512,486,243,504,747
1000,512,492,512,244,519,763
1000,492,493,496,246,512,758
1000,485,494,501,247,497,744
1000,502,516,486,250,485,735
1000,494,487,512,250,510,760
1000,505,495,504,253,496,749
1000,535,530,481,286,456,742
1000,485,526,529,244,510,754
1000,490,498,500,252,502,754
1000,526,524,507,267,493,760
1000,525,478,468,262,484,746
1000,493,485,522,238,527,765
1000,482,507,506,245,503,748
1000,505,524,505,275,485,760
1000,512,502,504,267,485,752
1000,553,484,485,273,489,762
1000,480,479,515,218,534,752
1000,513,510,479,263,491,754
1000,497,495,499,236,513,749
1000,486,506,476,251,485,736
1000,481,483,501,238,509,747
1000,501,505,494,255,481,736
1000,475,495,495,240,489,729
1000,509,509,472,264,468,732
1000,490,496,494,267,466,733
1000,507,492,515,240,513,753
1000,523,490,510,270,496,766
1000,513,517,469,252,499,751
1000,481,489,498,237,508,745
1000,494,486,521,237,506,743
1000,521,517,504,266,507,773
1000,484,505,509,241,510,751
1000,500,502,494,251,503,754
1000,505,509,516,252,502,754
1000,494,510,486,246,485,731
1000,518,506,501,265,490,755
1000,521,509,515,260,506,766
1000,525,497,528,261,508,769
1000,483,498,480,245,479,724
1000,504,502,475,256,489,745
1000,491,521,511,263,492,755
1000,502,481,510,254,502,756
1000,504,468,494,236,514,750
1000,504,492,507,246,511,757
1000,503,495,483,254,491,745
1000,475,498,485,234,485,719
1000,511,504,484,256,488,744
1000,484,515,459,252,465,717
1000,485,514,490,266,466,732
1000,496,492,550,259,505,764
1000,481,510,507,241,491,732
1000,500,510,495,251,494,745
1000,515,502,499,270,488,758
1000,484,506,513,252,485,737
1000,505,500,506,245,490,735
1000,507,501,493,251,498,749
1000,516,526,488,277,487,764
1000,530,502,493,259,498,757
1000,509,509,503,267,491,758
1000,514,497,496,254,483,737
1000,488,487,511,246,503,749
1000,498,505,509,252,514,766
1000,491,482,516,228,541,769
1000,497,508,499,242,508,750
1000,497,489,497,233,523,756
1000,503,485,472,250,483,733
1000,513,514,498,271,485,756
1000,502,501,498,260,485,745
1000,533,499,524,272,497,769
1000,529,491,507,260,520,780
1000,504,489,519,249,511,760
1000,491,521,506,250,498,748
1000,503,468,505,241,515,756
1000,501,527,514,258,502,760
1000,548,470,478,254,510,764
1000,513,534,462,265,462,727
1000,479,497,520,245,506,751
1000,483,479,489,230,525,755
1000,500,490,487,240,507,747
1000,485,512,480,246,489,735
1000,488,500,495,253,497,750
1000,523,510,488,269,493,762
1000,520,518,517,264,509,773
1000,497,501,493,254,509,763
1000,487,505,476,256,485,741
1000,471,535,487,272,456,728
1000,503,483,526,249,522,771
1000,498,472,505,228,516,744
1000,497,504,522,240,505,745
1000,509,497,503,254,513,767
1000,494,518,512,256,496,752
1000,504,502,492,267,492,759
1000,502,506,500,256,491,747
1000,484,487,484,229,505,734
1000,507,508,504,250,517,767
1000,506,482,498,255,502,757
1000,495,485,509,244,524,768
1000,492,483,478,247,490,737
1000,513,514,485,255,491,746
1000,526,507,498,277,491,768
1000,521,521,515,281,493,774
1000,499,476,501,229,524,753
1000,485,491,502,258,487,745
1000,488,490,490,244,485,729
1000,501,510,519,247,506,753
1000,488,509,496,239,490,729
1000,493,527,536,252,521,773
1000,508,488,503,240,517,757
1000,501,519,473,257,493,750
1000,500,462,513,231,529,760
1000,495,506,486,253,486,739
1000,489,478,483,239,494,733
1000,493,507,461,249,469,718
1000,504,512,517,262,497,759
1000,484,493,514,241,507,748
1000,475,488,477,213,500,713
1000,472,514,518,236,519,755
1000,495,495,483,252,476,728
1000,537,477,486,237,525,762
1000,493,487,478,234,492,726
1000,525,518,475,272,478,750
1000,497,516,507,251,504,755
1000,500,523,494,256,483,739
1000,487,488,510,239,513,752
1000,502,496,515,252,506,758
1000,488,488,501,231,524,755
1000,488,479,497,231,503,734
1000,506,475,504,240,507,747
1000,500,526,491,256,475,731
1000,507,506,519,254,505,759
1000,502,485,495,243,501,744
1000,486,506,494,242,504,746
1000,529,504,487,263,499,762
1000,511,529,491,260,490,750
1000,481,516,522,250,507,757
1000,489,489,491,236,504,740
1000,493,488,472,231,503,734
1000,499,500,498,254,498,752
1000,506,515,493,258,493,751
1000,469,506,494,235,498,733
1000,503,497,505,239,511,750
1000,489,479,495,222,514,736
1000,503,468,516,245,510,755
1000,541,520,492,282,489,771
1000,527,514,467,277,476,753
1000,490,475,497,243,488,731
1000,509,521,482,275,459,734
1000,501,485,490,250,502,752
1000,527,463,490,238,506,744
1000,503,504,524,246,518,764
1000,502,506,492,255,499,754
1000,469,508,508,237,511,748
1000,476,531,530,255,502,757
1000,519,531,496,265,481,746
1000,520,499,494,245,514,759
1000,490,507,505,229,518,747
1000,489,491,521,237,521,758
1000,513,497,533,260,514,774
1000,492,510,509,245,510,755
1000,474,485,524,228,522,750
1000,532,507,518,269,504,773
1000,498,527,487,255,492,747
1000,499,491,499,243,496,739
1000,498,524,525,263,486,749
1000,475,501,492,248,481,729
1000,509,505,510,253,505,758
1000,501,487,479,230,530,760
1000,466,516,530,232,513,745
1000,528,498,504,264,501,765
1000,512,491,518,250,501,751
1000,500,491,486,249,483,732
1000,507,524,530,255,516,771
1000,489,513,504,261,502,763
1000,513,532,510,268,494,762
1000,511,482,482,240,516,756
1000,526,494,500,257,504,761
1000,492,494,491,247,488,735
1000,511,481,487,244,504,748
1000,512,526,485,270,479,749
1000,502,507,483,250,493,743
1000,499,471,468,235,487,722
1000,503,469,496,236,512,748
1000,483,495,490,239,490,729
1000,466,508,528,228,516,744
1000,481,496,505,231,513,744
1000,473,518,477,243,477,720
1000,516,522,504,274,470,744
1000,472,479,477,206,533,739
1000,501,517,478,257,479,736
1000,495,483,485,237,498,735
1000,526,504,494,266,491,757
1000,482,488,508,231,514,745
1000,502,521,519,252,510,762
1000,509,499,525,255,513,768
1000,502,512,507,263,507,770
1000,469,502,483,240,493,733
1000,505,518,501,246,513,759
1000,501,516,499,274,482,756
1000,501,509,491,248,492,740
1000,509,489,497,253,515,768
1000,498,455,498,216,523,739
1000,514,495,513,248,514,762
1000,502,497,509,250,500,750
1000,497,500,496,240,506,746
1000,482,487,522,221,515,736
1000,508,516,467,249,488,737
1000,497,522,509,273,486,759
1000,492,457,506,226,511,737
1000,498,488,505,227,527,754
1000,506,470,503,237,505,742
1000,524,490,498,267,493,760
1000,500,490,502,240,503,743
1000,513,503,506,258,487,745
1000,492,484,498,235,515,750
1000,503,493,524,236,532,768
1000,485,463,538,225,539,764
1000,491,504,512,240,515,755
1000,519,517,529,268,503,771
1000,486,484,499,238,489,727
1000,483,482,480,241,489,730
1000,490,488,521,235,521,756
1000,489,487,482,232,508,740
1000,489,511,500,259,489,748
1000,499,476,515,234,523,757
1000,511,505,486,260,486,746
1000,490,492,455,239,481,720
1000,534,516,481,273,483,756
1000,485,484,502,231,514,745
1000,507,485,512,254,503,757
1000,503,500,494,257,489,746
1000,517,500,496,252,509,761
1000,521,503,478,256,493,749
1000,475,505,509,244,498,742
1000,520,513,515,262,502,764
1000,496,489,525,249,513,762
1000,499,481,499,229,509,738
1000,515,494,526,246,521,767
1000,508,506,516,248,519,767
1000,508,478,505,242,511,753
1000,497,527,500,254,485,739
1000,499,478,524,242,515,757
1000,497,501,497,257,507,764
1000,499,505,477,268,463,731
1000,482,504,515,239,513,752
1000,500,492,493,246,500,746
1000,511,480,500,241,519,760
1000,498,513,500,266,480,746
1000,493,482,504,237,509,746
1000,504,505,499,259,491,750
1000,516,526,493,275,485,760
1000,470,487,547,249,513,762
1000,517,492,502,258,492,750
1000,511,499,501,251,510,761
1000,511,504,492,259,494,753
1000,478,485,486,236,496,732
1000,478,489,521,242,521,763
1000,472,497,491,230,507,737
1000,524,496,488,254,501,755
1000,536,523,498,278,486,764
1000,517,475,490,241,509,750
1000,497,504,540,265,503,768
1000,489,550,506,263,480,743
1000,485,491,493,255,492,747
1000,494,512,490,256,486,742
1000,474,516,483,237,488,725
1000,470,500,450,232,473,705
1000,522,525,531,278,492,770
1000,508,502,510,254,496,750
1000,473,514,512,246,499,745
1000,507,490,499,248,498,746
1000,492,492,486,249,481,730
1000,498,506,485,259,468,727
1000,483,512,505,244,507,751
1000,549,501,484,276,504,780
1000,510,517,515,258,517,775
1000,511,491,515,244,503,747
1000,515,521,504,273,477,750
1000,516,496,496,244,523,767
1000,462,474,494,220,511,731
1000,507,487,474,257,499,756
1000,472,501,508,233,500,733
1000,523,527,504,272,490,762
1000,496,512,505,267,482,749
1000,504,516,491,262,475,737
1000,499,502,526,251,519,770
1000,491,501,503,233,518,751
1000,485,516,535,258,501,759
1000,509,505,499,259,485,744
1000,503,486,506,235,527,762
1000,506,515,504,265,502,767
1000,502,483,507,233,509,742
1000,511,545,504,294,474,768
1000,507,486,483,248,480,728
1000,490,479,502,245,498,743
1000,493,517,489,262,473,735
1000,485,487,509,240,501,741
1000,511,506,507,261,494,755
1000,526,478,489,264,494,758
1000,496,511,463,259,474,733
1000,501,489,502,234,514,748
1000,540,488,513,250,533,783
1000,517,500,498,268,502,770
1000,498,509,496,246,491,737
1000,506,495,479,255,477,732
1000,516,518,495,272,480,752
1000,527,486,526,254,522,776
1000,507,487,518,249,501,750
1000,514,517,547,263,507,770
1000,498,493,512,246,504,750
1000,505,506,494,247,495,742
1000,495,507,517,257,502,759
1000,474,500,498,241,493,734
1000,484,513,490,258,472,730
1000,506,484,504,258,477,735
1000,501,518,488,246,501,747
1000,494,484,508,246,501,747
1000,492,500,485,243,485,728
1000,509,487,512,247,508,755
1000,484,500,504,237,515,752
1000,478,486,490,232,501,733
1000,503,510,514,258,506,764
1000,474,526,487,246,484,730
1000,487,540,496,275,462,737
1000,495,496,512,248,507,755
1000,511,525,497,277,467,744
1000,514,479,495,247,507,754
1000,499,502,528,245,521,766
1000,498,511,508,260,499,759
1000,503,492,519,238,529,767
1000,496,509,509,257,501,758
1000,491,499,505,257,481,738
1000,505,486,506,238,506,744
1000,513,484,489,252,498,750
1000,485,490,520,229,529,758
1000,509,497,511,243,520,763
1000,506,514,516,264,490,754
1000,516,492,494,269,482,751
1000,501,503,516,254,520,774
1000,477,515,496,245,503,748
1000,500,502,496,263,483,746
1000,520,498,493,260,492,752
1000,522,501,503,272,491,763
1000,494,513,494,250,510,760
1000,510,493,516,260,482,742
1000,484,515,473,248,464,712
1000,493,502,477,239,494,733
1000,507,498,493,241,518,759
1000,486,515,503,256,494,750
1000,510,515,485,269,471,740
1000,501,509,500,249,498,747
1000,496,499,529,256,491,747
1000,508,497,504,257,512,769
1000,496,508,499,245,497,742
1000,487,457,502,230,509,739
1000,478,510,521,243,510,753
1000,480,521,521,256,503,759
1000,515,513,502,267,508,775
1000,492,509,480,242,482,724
1000,498,508,509,258,503,761
1000,507,506,469,258,483,741
1000,496,495,499,245,526,771
1000,516,526,512,272,490,762
1000,505,531,485,290,446,736
1000,484,521,477,263,460,723
1000,509,502,518,253,501,754
1000,506,490,516,275,477,752
1000,508,483,504,229,525,754
1000,480,519,491,265,479,744
1000,500,479,497,230,497,727
1000,500,531,496,272,472,744
1000,494,510,500,256,502,758
1000,508,473,479,251,484,735
1000,469,495,502,223,513,736
1000,491,488,528,240,530,770
1000,504,458,469,243,486,729
1000,482,481,539,237,521,758
1000,512,502,514,261,499,760
1000,504,488,506,254,507,761
1000,463,534,528,240,506,746
1000,468,506,467,243,470,713
1000,498,538,494,274,457,731
1000,505,473,496,231,530,761
1000,487,499,497,253,487,740
1000,508,504,506,260,487,747
1000,489,511,486,254,480,734
1000,492,481,473,248,482,730
1000,502,518,485,261,489,750
1000,489,507,508,244,507,751
1000,510,490,530,247,518,765
1000,512,492,503,263,489,752
1000,460,506,479,226,497,723
1000,511,528,504,263,502,765
1000,497,503,503,247,518,765
1000,465,498,521,243,509,752
1000,491,500,494,239,503,742
1000,495,522,478,256,471,727
1000,505,490,495,257,475,732
1000,501,495,502,247,515,762
1000,472,516,511,241,492,733
1000,522,510,532,251,514,765
1000,478,496,519,239,510,749
1000,513,484,475,253,495,748
1000,529,536,499,286,469,755
1000,509,477,503,245,507,752
1000,506,498,525,258,501,759
1000,497,486,488,261,481,742
1000,501,505,511,265,477,742
1000,499,535,527,271,496,767
1000,496,472,472,241,500,741
1000,519,489,497,258,504,762
1000,505,452,520,240,518,758
1000,490,496,499,251,506,757
1000,522,514,504,278,486,764
1000,501,490,482,242,487,729
1000,515,511,509,277,476,753
1000,489,518,500,238,522,760
1000,495,535,509,264,483,747
1000,482,492,481,232,502,734
1000,491,516,527,253,512,765
1000,505,493,499,256,483,739
1000,479,502,477,241,487,728
1000,509,500,510,255,518,773
1000,505,443,483,231,516,747
1000,499,496,476,242,501,743
1000,496,478,499,235,503,738
1000,524,505,503,265,491,756
1000,509,532,490,273,477,750
1000,525,512,498,260,508,768
1000,483,514,511,253,486,739
1000,490,519,478,248,486,734
1000,500,502,503,258,487,745
1000,457,514,510,240,503,743
1000,498,511,493,258,506,764
1000,528,506,497,265,515,780
1000,513,483,508,233,534,767
1000,488,503,473,245,499,744
1000,520,513,484,267,469,736
1000,499,501,490,256,486,742
1000,506,502,521,257,512,769
1000,523,474,504,244,518,762
1000,491,495,497,249,493,742
1000,526,500,493,266,498,764
1000,521,490,511,246,520,766
1000,509,514,522,259,498,757
1000,487,498,516,242,503,745
1000,506,500,486,248,502,750
1000,489,498,507,225,528,753
1000,526,476,476,254,509,763
1000,503,516,502,267,490,757
1000,493,504,494,254,489,743
1000,499,509,523,245,518,763
1000,480,474,469,216,498,714
1000,484,530,506,239,502,741
1000,483,502,505,236,513,749
1000,485,504,491,242,492,734
1000,491,470,503,226,518,744
1000,498,520,506,260,488,748
1000,484,525,498,254,494,748
1000,503,539,511,265,483,748
1000,490,518,497,260,472,732
1000,495,487,510,240,513,753
1000,525,499,510,240,524,764
1000,502,499,470,253,479,732
1000,502,499,500,249,503,752
1000,499,524,498,260,507,767
1000,511,483,507,254,517,771
1000,504,500,491,238,510,748
1000,488,507,511,249,514,763
1000,479,488,485,224,518,742
1000,483,482,496,229,508,737
1000,523,505,506,268,501,769
1000,496,508,496,257,484,741
1000,512,477,493,240,516,756
1000,528,487,471,251,503,754
1000,507,519,489,261,484,745
1000,520,487,478,250,507,757
1000,478,522,507,246,496,742
1000,482,481,483,223,496,719
1000,517,501,485,259,485,744
1000,504,481,516,247,499,746
1000,511,485,502,240,517,757
1000,470,511,468,256,452,708
1000,514,498,534,254,536,790
1000,505,495,515,261,492,753
1000,479,514,482,245,491,736
1000,484,512,520,243,501,744
1000,492,482,498,234,510,744
1000,521,499,504,266,483,749
1000,504,501,512,253,520,773
1000,493,510,519,240,517,757
1000,479,510,491,249,491,740
1000,529,495,484,265,490,755
1000,522,484,485,261,489,750
1000,521,513,488,255,496,751
1000,494,497,497,241,504,745
1000,506,487,474,265,472,737
1000,497,511,511,253,502,755
1000,518,489,495,242,505,747
1000,496,475,502,250,502,752
1000,499,526,486,264,474,738
1000,516,494,532,241,531,772
1000,525,470,492,241,521,762
1000,515,521,484,270,485,755
1000,510,516,517,268,479,747
1000,519,503,483,251,494,745
1000,498,498,505,254,482,736
1000,473,492,469,225,497,722
1000,496,497,467,222,515,737
1000,473,488,506,232,508,740
1000,485,499,510,236,520,756
1000,476,494,525,223,529,752
1000,480,498,487,233,498,731
1000,489,511,490,244,488,732
1000,518,478,524,242,523,765
1000,495,504,518,264,498,762
1000,510,525,484,260,504,764
1000,511,488,515,248,514,762
1000,527,506,497,274,489,763
1000,498,492,474,238,494,732
1000,512,496,491,279,483,762
1000,487,502,508,241,510,751
1000,507,505,483,265,474,739
1000,524,514,488,268,499,767
1000,495,528,480,236,497,733
1000,516,499,502,250,515,765
1000,475,511,515,234,515,749
1000,516,512,528,253,518,771
1000,481,507,494,236,498,734
1000,490,503,517,243,501,744
1000,489,483,529,240,521,761
1000,501,498,497,251,489,740
1000,499,507,496,256,497,753
1000,525,480,505,247,521,768
1000,491,506,498,254,490,744
1000,491,488,500,238,520,758
1000,490,485,495,230,523,753
1000,535,523,506,278,493,771
1000,483,497,477,236,495,731
1000,527,480,512,238,540,778
1000,512,522,482,263,472,735
1000,491,503,526,264,502,766
1000,507,467,517,239,517,756
1000,492,507,506,248,502,750
1000,516,500,481,274,480,754
1000,488,496,476,237,489,726
1000,479,481,498,238,502,740
1000,497,481,481,236,502,738
1000,511,520,517,255,502,757
1000,508,509,530,255,523,778
1000,491,494,520,237,519,756
1000,502,514,508,253,496,749
1000,509,508,470,265,479,744
1000,494,537,480,257,482,739
1000,505,549,499,275,483,758
1000,506,468,510,239,524,763
1000,477,513,505,250,502,752
1000,522,533,507,280,484,764
1000,489,500,496,241,514,755
1000,495,489,521,245,511,756
1000,511,516,494,264,493,757
1000,500,516,488,255,489,744
1000,489,487,503,231,516,747
1000,539,509,453,278,464,742
1000,507,505,507,258,501,759
1000,531,503,500,265,500,765
1000,465,539,505,250,494,744
1000,507,507,482,262,485,747
1000,522,518,492,275,484,759
1000,498,494,505,243,508,751
1000,480,491,473,233,487,720
1000,513,512,477,264,485,749
1000,489,538,498,271,472,743
1000,518,464,515,234,531,765
1000,491,484,510,236,504,740
1000,505,484,493,253,499,752
1000,494,489,509,235,524,759
1000,485,490,498,246,484,730
1000,507,510,472,264,473,737
1000,514,520,532,264,510,774
1000,486,518,514,251,494,745
1000,520,508,485,272,474,746
1000,514,532,489,270,494,764
1000,501,495,484,244,501,745
1000,502,499,531,271,513,784
1000,480,472,495,240,493,733
1000,506,479,481,229,509,738
1000,497,498,500,245,513,758
1000,497,500,482,249,501,750
1000,504,526,512,273,479,752
1000,478,521,471,247,478,725
1000,512,489,503,241,519,760
1000,506,491,505,249,505,754
1000,512,501,498,244,520,764
1000,500,502,519,262,494,756
1000,515,479,498,252,499,751
1000,504,496,483,249,505,754
1000,493,495,510,252,506,758
1000,498,505,490,264,482,746
1000,504,532,470,267,476,743
1000,484,477,528,236,532,768
1000,491,502,500,229,523,752
1000,514,505,479,266,474,740
1000,512,508,489,253,482,735
1000,520,511,496,252,511,763
1000,516,506,465,260,480,740
1000,511,509,483,261,470,731
1000,485,487,520,239,514,753
1000,511,491,505,252,507,759
1000,491,487,501,231,509,740
1000,484,475,499,224,536,760
1000,503,490,483,238,502,740
1000,490,492,511,238,507,745
1000,500,515,517,268,493,761
1000,499,501,511,253,514,767
1000,520,505,518,275,490,765
1000,499,506,486,240,496,736
1000,512,495,496,245,495,740
1000,499,509,486,266,476,742
1000,490,487,487,238,488,726
1000,510,498,496,264,492,756
1000,509,502,496,247,510,757
1000,479,512,498,244,500,744
1000,505,510,507,254,501,755
1000,481,517,529,248,509,757
1000,486,487,464,233,490,723
1000,508,490,490,257,492,749
1000,507,495,493,263,486,749
1000,514,498,508,264,484,748
1000,533,485,460,262,488,750
1000,518,499,509,254,512,766
1000,481,511,514,238,526,764
1000,499,501,521,256,520,776
1000,494,503,492,250,478,728
1000,504,501,484,260,492,752
1000,507,475,497,245,526,771
1000,506,503,516,254,506,760
1000,486,524,510,251,501,752
1000,490,491,502,242,522,764
1000,470,479,503,242,495,737
1000,519,534,490,268,491,759
1000,495,536,486,261,485,746
1000,523,507,493,272,483,755
1000,501,507,482,260,480,740
1000,507,510,516,269,498,767
1000,490,480,506,221,530,751
1000,500,492,526,238,515,753
1000,495,506,521,258,490,748
1000,491,497,530,230,532,762
1000,527,507,501,265,506,771
1000,505,493,512,248,509,757
1000,493,513,491,258,469,727
1000,528,534,485,282,472,754
1000,495,500,488,262,474,736
1000,515,511,474,255,500,755
1000,490,486,494,228,498,726
1000,502,527,486,263,479,742
1000,497,496,511,222,524,746
1000,515,506,523,258,516,774
1000,498,490,460,248,501,749
1000,504,529,501,275,470,745
1000,477,488,508,238,503,741
1000,490,497,494,248,497,745
1000,515,489,484,241,496,737
1000,508,529,501,279,486,765
1000,490,485,494,228,526,754
1000,521,533,499,278,484,762
1000,516,467,511,244,527,771
1000,488,511,502,252,512,764
1000,492,493,481,240,485,725
1000,514,517,467,271,471,742
1000,546,508,490,279,493,772
1000,493,512,492,251,478,729
1000,475,495,509,231,499,730
1000,473,500,483,233,493,726
1000,455,493,495,239,472,711
1000,497,469,538,233,548,781
1000,480,510,486,256,475,731
1000,500,494,488,254,480,734
1000,482,509,481,241,485,726
1000,509,505,471,262,456,718
1000,500,509,471,247,502,749
1000,485,521,530,256,502,758
1000,491,523,499,257,484,741
1000,493,503,498,248,486,734
1000,519,483,477,253,500,753
1000,491,498,508,240,503,743
1000,501,506,509,253,496,749
1000,495,520,503,240,505,745
1000,500,480,491,231,517,748
1000,479,512,495,228,500,728
1000,489,522,511,247,509,756
1000,501,490,492,250,511,761
1000,542,507,504,260,503,763
1000,506,484,515,239,512,751
1000,522,520,492,271,471,742
1000,514,500,517,257,510,767
1000,501,471,483,242,501,743
1000,479,501,494,245,479,724
1000,506,480,509,249,512,761
1000,511,496,491,259,488,747
1000,518,529,494,267,493,760
1000,501,514,528,247,519,766
1000,534,486,502,247,514,761
1000,491,502,486,255,464,719
1000,495,495,500,264,478,742
1000,484,480,515,220,520,740
1000,511,519,515,273,485,758
1000,501,500,515,238,517,755
1000,531,506,494,274,477,751
1000,516,478,501,240,507,747
1000,516,527,524,280,481,761
1000,526,512,503,271,487,758
1000,500,523,468,251,472,723
1000,497,491,498,243,496,739
1000,510,499,498,249,520,769
1000,489,515,518,253,506,759
1000,516,510,518,269,486,755
1000,480,504,498,246,493,739
1000,510,503,493,257,489,746
1000,503,517,490,267,477,744
1000,518,495,527,262,495,757
1000,516,481,479,259,496,755
1000,518,492,511,254,510,764
1000,504,492,496,250,504,754
1000,485,500,482,244,496,740
1000,495,502,489,246,495,741
1000,482,515,505,250,493,743
1000,514,493,496,253,500,753
1000,523,494,499,242,506,748
1000,512,502,489,260,494,754
1000,512,542,484,277,464,741
1000,516,493,512,248,516,764
1000,513,512,498,255,490,745
1000,474,481,479,229,501,730
1000,480,530,525,263,496,759
1000,507,499,487,249,496,745
1000,475,510,498,236,489,725
1000,511,499,480,260,497,757
1000,500,501,493,265,496,761
1000,516,484,498,247,509,756
1000,525,514,507,264,487,751
1000,499,500,499,258,505,763
1000,489,510,512,241,511,752
1000,490,483,502,235,500,735
1000,513,503,479,259,505,764
1000,486,506,499,246,505,751
1000,499,518,505,257,494,751
1000,518,493,512,248,524,772
1000,521,465,514,234,528,762
1000,504,520,520,253,500,753
1000,520,517,510,275,494,769
1000,516,487,497,253,507,760
1000,507,514,516,255,491,746
1000,480,496,481,246,484,730
1000,498,492,489,244,508,752
1000,478,482,484,227,503,730
1000,503,494,496,253,504,757
1000,495,511,504,256,509,765
1000,505,516,477,255,491,746
1000,494,481,485,227,512,739
1000,469,494,524,236,504,740
1000,487,503,506,263,462,725
1000,503,493,505,257,511,768
1000,463,498,501,228,503,731
1000,456,499,512,222,519,741
1000,503,494,478,245,493,738
1000,490,513,507,241,520,761
1000,506,518,487,255,499,754
1000,495,537,489,276,449,725
1000,496,478,497,240,506,746
1000,500,559,500,286,458,744
1000,500,515,509,258,485,743
1000,515,509,511,268,487,755
1000,505,492,464,254,467,721
1000,489,511,498,252,486,738
1000,538,497,503,261,506,767
1000,516,495,515,236,519,755
1000,507,505,525,257,509,766
1000,494,524,482,255,478,733
1000,518,476,469,244,499,743
1000,507,500,500,268,489,757
1000,488,506,492,240,491,731
1000,499,505,493,257,489,746
1000,473,507,498,249,485,734
1000,485,524,524,257,496,753
1000,514,500,503,247,503,750
1000,505,496,503,248,510,758
1000,498,535,515,277,475,752
1000,495,501,479,261,474,735
1000,505,468,491,231,512,743
1000,498,522,472,269,464,733
1000,495,499,493,245,515,760
1000,521,531,543,283,512,795
1000,489,488,505,242,516,758
1000,532,496,487,260,501,761
1000,494,530,509,263,483,746
1000,510,480,484,244,506,750
1000,499,486,528,250,515,765
1000,514,469,504,236,512,748
1000,498,521,505,247,507,754
1000,492,519,517,264,498,762
1000,517,506,491,249,503,752
1000,532,485,492,262,503,765
1000,524,498,511,254,496,750
1000,481,517,517,248,511,759
1000,489,493,479,246,489,735
1000,486,519,541,258,505,763
1000,491,494,530,224,542,766
1000,486,519,466,260,476,736
1000,501,517,496,259,483,742
1000,491,500,508,252,490,742
1000,526,494,525,256,508,764
1000,508,500,474,251,487,738
1000,490,520,497,250,484,734
1000,486,500,525,247,502,749
1000,509,502,471,250,474,724
1000,499,490,496,231,511,742
1000,475,516,519,242,506,748
1000,483,517,519,249,510,759
1000,510,510,498,250,499,749
1000,513,514,458,265,473,738
1000,493,489,501,241,500,741
1000,519,492,487,274,491,765
1000,502,514,505,246,505,751
1000,503,494,475,243,483,726
1000,495,516,518,263,484,747
1000,481,512,493,240,500,740
1000,542,536,494,293,479,772
1000,496,479,496,248,501,749
1000,498,489,514,239,516,755
1000,494,489,494,246,505,751
1000,513,486,504,261,502,763
1000,492,494,519,246,511,757
1000,503,504,480,252,494,746
1000,503,495,479,253,484,737
1000,483,484,504,237,507,744
1000,514,515,505,259,513,772
1000,517,509,491,255,506,761
1000,501,518,509,258,493,751
1000,518,506,525,265,513,778
1000,499,508,493,254,505,759
1000,476,501,520,230,521,751
1000,472,527,491,244,481,725
1000,514,497,506,248,505,753
1000,506,504,499,247,487,734
1000,489,500,493,241,483,724
1000,479,503,486,236,503,739
1000,497,481,485,251,499,750
1000,512,495,506,254,507,761
1000,520,550,502,284,478,762
1000,507,506,490,255,487,742
1000,479,545,508,264,470,734
1000,503,509,483,254,503,757
1000,514,507,475,249,496,745
1000,535,508,513,278,496,774
1000,511,507,489,264,493,757
1000,511,487,500,257,496,753
1000,481,506,514,244,501,745
1000,509,482,493,244,509,753
1000,512,488,495,246,501,747
1000,495,517,501,264,488,752
1000,496,522,508,247,497,744
1000,513,538,487,280,477,757
1000,510,487,519,247,517,764
1000,473,503,479,246,483,729
1000,504,505,488,243,496,739
1000,508,530,487,276,478,754
1000,486,509,513,242,499,741
1000,499,518,513,250,512,762
1000,498,490,527,246,520,766
1000,488,510,480,246,491,737
1000,481,492,471,231,485,716
1000,496,483,508,248,505,753
1000,499,493,534,244,527,771
1000,486,503,512,240,501,741
1000,505,513,502,261,491,752
1000,506,487,496,238,531,769
1000,506,518,516,262,513,775
1000,510,505,498,260,479,739
1000,502,533,475,270,472,742
1000,487,507,508,247,504,751
1000,499,478,476,246,487,733
1000,500,496,500,240,518,758
1000,511,499,485,251,500,751
1000,501,497,517,254,494,748
1000,465,512,497,238,499,737
1000,509,517,502,260,509,769
1000,504,488,483,235,513,748
1000,489,481,460,231,495,726
1000,507,512,512,262,513,775
1000,492,492,509,244,505,749
1000,511,469,482,240,493,733
1000,487,504,503,242,496,738
1000,521,497,493,259,496,755
1000,535,501,497,257,511,768
1000,493,491,508,249,510,759
1000,479,504,496,242,486,728
1000,512,480,499,238,506,744
1000,478,505,517,249,495,744
1000,504,463,528,236,537,773
1000,500,493,488,250,501,751
1000,501,478,483,235,515,750
1000,500,501,499,253,495,748
1000,498,531,480,253,490,743
1000,511,514,501,262,487,749
1000,508,527,533,263,510,773
1000,515,516,494,258,494,752
1000,500,491,530,237,531,768
1000,524,503,501,255,497,752
1000,527,505,514,259,495,754
1000,487,518,495,249,480,729
1000,460,491,473,225,485,710
1000,512,519,504,261,498,759
1000,490,501,512,238,525,763
1000,475,491,511,248,481,729
1000,497,516,514,250,497,747
1000,485,522,511,251,496,747
1000,495,504,509,258,485,743
1000,481,477,458,233,477,710
1000,485,499,494,232,512,744
1000,480,517,511,240,487,727
1000,517,498,475,257,500,757
1000,506,487,485,245,492,737
1000,488,501,498,253,482,735
1000,491,512,506,241,506,747
1000,533,492,503,245,516,761
1000,471,489,508,230,501,731
1000,529,491,483,254,516,770
1000,519,507,494,262,490,752
1000,514,475,495,256,499,755
1000,448,520,503,231,505,736
1000,514,485,522,257,515,772
1000,488,532,486,257,469,726
1000,500,484,487,239,511,750
1000,503,485,532,249,508,757
1000,517,493,509,267,508,775
1000,493,497,523,249,492,741
1000,492,487,488,243,485,728
1000,510,474,528,242,519,761
1000,491,514,497,264,470,734
1000,529,504,532,258,523,781
1000,504,496,505,259,491,750
1000,490,513,520,242,504,746
1000,479,503,522,236,508,744
1000,477,496,473,230,487,717
1000,518,513,513,269,495,764
1000,498,487,504,245,523,768
1000,488,500,491,250,482,732
1000,497,501,486,242,486,728
1000,510,490,521,237,549,786
1000,481,500,485,250,494,744
1000,502,518,519,263,496,759
1000,523,506,478,254,499,753
1000,494,507,499,241,518,759
1000,534,499,498,265,487,752
1000,508,499,497,256,497,753
1000,520,510,503,268,486,754
1000,503,499,499,269,502,771
1000,516,498,513,250,529,779
1000,499,489,523,249,509,758
1000,508,486,498,241,520,761
1000,516,498,479,258,495,753
1000,481,475,508,218,527,745
1000,506,518,495,260,497,757
1000,478,488,520,224,537,761
1000,486,519,492,253,486,739
1000,506,488,532,254,510,764
1000,499,525,515,268,486,754
1000,514,491,485,245,477,722
1000,495,524,481,261,473,734
1000,516,504,506,266,497,763
1000,488,499,496,255,496,751
1000,478,494,516,224,528,752
1000,508,497,521,257,506,763
1000,516,503,469,251,487,738
1000,484,505,494,255,485,740
1000,493,525,488,253,493,746
1000,523,491,534,239,521,760
1000,489,466,508,224,519,743
1000,493,492,512,248,495,743
1000,492,534,488,272,465,737
1000,485,500,500,250,502,752
1000,499,470,521,234,532,766
1000,489,521,519,243,512,755
1000,504,516,470,265,477,742
1000,485,463,485,222,510,732
1000,473,492,497,231,494,725
1000,484,460,523,220,539,759
1000,516,500,519,243,521,764
1000,486,517,504,245,510,755
1000,496,500,476,255,466,721
1000,512,479,499,234,514,748
1000,509,500,495,267,488,755
1000,500,495,514,256,505,761
1000,505,480,491,239,508,747
1000,486,484,463,234,490,724
1000,509,496,484,255,497,752
1000,511,481,488,252,484,736
1000,471,505,475,243,487,730
1000,494,500,485,238,493,731
1000,459,487,517,219,519,738
1000,502,519,488,246,505,751
1000,495,481,497,231,519,750
1000,497,479,528,226,535,761
1000,492,496,492,249,493,742
1000,465,487,484,234,490,724
1000,492,500,507,245,509,754
1000,503,508,516,252,507,759
1000,502,477,489,244,501,745
1000,501,514,479,253,486,739
1000,501,518,480,262,482,744
1000,507,522,501,258,513,771
1000,504,493,506,260,497,757
1000,489,489,501,238,503,741
1000,498,497,511,247,497,744
1000,519,490,469,252,484,736
1000,480,482,492,236,497,733
1000,505,482,488,239,503,742
1000,466,511,511,250,483,733
1000,491,528,492,271,475,746
1000,507,505,496,263,512,775
1000,495,510,498,265,476,741
1000,483,481,470,234,473,707
1000,494,515,482,268,469,737
1000,482,504,517,257,496,753
1000,518,513,479,273,482,755
1000,500,493,502,238,526,764
1000,506,456,499,243,523,766
1000,490,510,493,246,489,735
1000,508,512,495,255,506,761
1000,528,479,505,248,514,762
1000,499,520,504,255,502,757
1000,488,484,511,236,515,751
1000,531,486,506,267,506,773
1000,500,492,539,254,524,778
1000,543,511,515,283,487,770
1000,500,519,519,254,511,765
1000,509,480,492,252,513,765
1000,484,481,473,228,496,724
1000,502,503,493,253,485,738
1000,494,518,466,262,478,740
1000,522,498,487,268,474,742
1000,494,518,490,277,471,748
1000,501,508,510,260,501,761
1000,514,475,485,245,522,767
1000,499,494,484,260,475,735
1000,476,493,462,232,481,713
1000,510,509,534,257,520,777
1000,519,488,498,248,502,750
1000,503,498,501,259,479,738
1000,473,523,491,246,482,728
1000,486,501,500,246,503,749
1000,487,480,504,237,506,743
1000,484,504,522,239,520,759
1000,475,510,509,250,492,742
1000,501,514,489,276,481,757
1000,511,481,486,241,507,748
1000,522,496,507,261,515,776
1000,504,489,515,244,527,771
1000,485,511,502,252,487,739
1000,506,496,512,259,495,754
1000,489,516,506,240,493,733
1000,486,519,520,246,513,759
1000,488,493,476,241,497,738
1000,532,516,483,286,461,747
1000,517,481,518,234,534,768
1000,500,467,489,238,488,726
1000,522,516,498,263,507,770
1000,498,527,491,267,472,739
1000,518,494,475,246,515,761
1000,483,503,508,238,519,757
1000,520,507,488,256,498,754
1000,504,503,513,250,512,762
1000,481,532,511,252,479,731
1000,486,519,494,254,491,745
1000,491,490,521,237,526,763
1000,497,486,512,240,509,749
1000,509,500,516,246,517,763
1000,504,485,507,258,492,750
1000,527,480,511,263,499,762
1000,475,516,502,261,474,735
1000,511,488,493,234,508,742
1000,543,495,497,268,505,773
1000,486,481,517,237,512,749
1000,497,525,508,251,505,756
1000,519,536,513,265,499,764
1000,509,511,545,269,519,788
1000,484,487,494,235,508,743
1000,491,503,512,251,494,745
1000,495,490,511,242,513,755
1000,523,503,526,270,503,773
1000,479,491,503,229,505,734
1000,485,495,526,242,512,754
1000,497,498,487,249,496,745
1000,495,473,489,235,510,745
1000,512,511,485,270,482,752
1000,490,517,496,234,496,730
1000,505,501,483,273,468,741
1000,500,502,502,240,513,753
1000,502,476,526,220,551,771
1000,493,517,495,250,493,743
1000,485,495,492,241,494,735
1000,511,528,503,248,513,761
1000,465,520,496,241,499,740
1000,517,542,501,269,495,764
1000,481,518,503,245,505,750
1000,512,502,484,252,496,748
1000,484,477,476,229,505,734
1000,499,465,499,239,506,745
1000,510,471,502,240,522,762
1000,500,497,504,252,506,758
1000,517,487,524,254,510,764
1000,495,487,489,241,499,740
1000,499,491,504,237,513,750
1000,500,503,504,249,503,752
1000,502,495,496,260,487,747
1000,491,503,513,250,500,750
1000,495,521,485,265,476,741
1000,487,507,484,232,504,736
1000,491,494,478,247,477,724
1000,511,512,492,248,503,751
1000,509,528,507,255,508,763
1000,501,520,478,254,488,742
1000,512,533,508,272,493,765
1000,516,517,493,257,500,757
1000,518,522,492,284,468,752
1000,505,503,465,252,478,730
1000,501,487,498,248,498,746
1000,486,504,493,252,491,743
1000,474,499,473,222,501,723
1000,505,478,510,235,534,769
1000,493,495,536,249,513,762
1000,476,487,502,239,511,750
1000,513,514,508,266,495,761
1000,519,480,466,249,490,739
1000,505,503,493,261,480,741
1000,485,505,513,239,503,742
1000,517,509,485,260,477,737
1000,476,503,486,229,509,738
1000,511,502,515,255,499,754
1000,489,493,488,244,500,744
1000,496,512,502,267,474,741
1000,505,483,517,251,512,763
1000,477,486,469,227,487,714
1000,511,522,510,259,496,755
1000,497,500,494,246,502,748
1000,513,508,501,256,506,762
1000,504,514,504,264,482,746
1000,469,499,492,239,483,722
1000,503,525,479,269,483,752
1000,501,483,487,235,497,732
1000,508,504,509,252,505,757
1000,507,511,526,266,512,778
1000,489,493,486,241,496,737
1000,525,496,501,260,504,764
1000,495,509,496,256,496,752
1000,505,493,504,251,517,768
1000,490,494,525,252,505,757
1000,470,473,516,216,526,742
1000,495,502,499,255,505,760
1000,497,524,538,251,517,768
1000,478,497,497,241,508,749
1000,504,478,499,223,535,758
1000,500,512,482,259,476,735
1000,483,487,479,238,494,732
1000,476,506,514,242,501,743
1000,463,478,491,218,510,728
1000,522,497,494,265,496,761
1000,501,495,505,243,498,741
1000,515,500,474,247,495,742
1000,516,524,534,266,500,766
1000,495,483,470,236,509,745
1000,521,509,501,247,509,756
1000,515,484,518,234,528,762
1000,513,503,516,260,498,758
1000,507,508,491,262,492,754
1000,472,489,487,247,476,723
1000,486,496,483,241,484,725
1000,522,507,511,260,511,771
1000,502,499,512,243,518,761
1000,487,498,491,242,505,747
1000,506,511,506,260,497,757
1000,495,497,481,258,480,738
1000,489,508,528,258,504,762
1000,474,467,504,223,511,734
1000,480,477,505,218,528,746
1000,507,471,483,250,503,753
1000,483,474,501,232,515,747
1000,497,503,507,253,500,753
1000,525,490,528,264,504,768
1000,485,492,513,234,519,753
1000,522,496,511,268,484,752
1000,493,468,480,244,481,725
1000,494,503,478,252,481,733
1000,497,488,491,240,492,732
1000,515,506,519,255,504,759
1000,516,526,483,270,491,761
1000,503,500,504,256,499,755
1000,490,482,493,219,529,748
1000,510,520,484,264,480,744
1000,476,485,497,236,496,732
1000,501,472,491,242,511,753
1000,498,482,515,228,528,756
1000,490,462,476,237,486,723
1000,479,497,474,237,487,724
1000,483,514,497,237,511,748
1000,497,483,507,235,515,750
1000,510,488,505,252,502,754
1000,503,509,489,253,495,748
1000,522,504,506,255,514,769
1000,492,504,487,251,504,755
1000,498,471,478,232,502,734
1000,493,491,473,237,494,731
1000,512,480,493,246,516,762
1000,495,519,468,240,485,725
1000,481,507,534,247,522,769
1000,500,500,490,265,487,752
1000,493,466,527,235,525,760
1000,500,496,510,237,521,758
1000,483,521,510,258,486,744
1000,487,502,519,244,506,750
1000,488,465,489,224,526,750
1000,495,511,502,250,501,751
1000,505,511,467,265,467,732
1000,492,496,517,253,504,757
1000,539,489,525,263,514,777
1000,488,499,502,244,502,746
1000,503,490,527,256,505,761
1000,500,508,496,260,487,747
1000,493,476,508,233,511,744
1000,484,500,515,258,495,753
1000,495,481,497,228,518,746
1000,511,485,503,239,508,747
1000,513,481,508,261,510,771
1000,501,490,496,237,511,748
1000,481,487,455,226,489,715
1000,506,497,472,258,489,747
1000,515,486,488,242,510,752
1000,459,469,505,211,528,739
1000,489,484,490,238,507,745
1000,480,514,470,244,466,710
1000,507,522,514,266,500,766
1000,468,502,534,254,495,749
1000,493,518,541,243,533,776
1000,510,488,491,244,503,747
1000,498,514,504,264,491,755
1000,503,514,501,264,486,750
1000,525,528,527,267,495,762
1000,474,487,506,238,504,742
1000,484,502,499,240,507,747
1000,489,497,493,243,491,734
1000,528,524,500,274,496,770
1000,518,499,488,247,512,759
1000,509,517,500,260,492,752
1000,505,497,488,237,515,752
1000,521,493,499,264,486,750
1000,501,488,507,241,518,759
1000,497,506,510,258,503,761
1000,489,488,521,247,493,740
1000,491,493,519,236,523,759
1000,512,506,486,268,476,744
1000,488,489,488,246,498,744
1000,487,526,493,261,486,747
1000,488,497,483,255,487,742
1000,504,481,492,244,500,744
1000,483,514,513,243,514,757
1000,506,496,478,243,501,744
1000,475,462,511,211,542,753
1000,490,483,495,240,486,726
1000,504,474,498,223,527,750
1000,532,506,511,270,497,767
1000,495,516,490,248,496,744
1000,472,537,495,253,485,738
1000,500,524,474,258,477,735
1000,491,511,518,245,514,759
1000,508,484,518,249,509,758
1000,515,497,486,251,500,751
1000,478,509,524,226,529,755
1000,475,490,527,218,535,753
1000,489,538,522,249,501,750
1000,495,527,515,255,498,753
1000,488,491,482,241,485,726
1000,511,503,454,254,467,721
1000,485,497,513,256,487,743
1000,501,490,519,248,504,752
1000,496,481,498,233,511,744
1000,497,496,511,251,517,768
1000,495,509,476,247,490,737
1000,474,502,495,249,482,731
1000,499,514,479,261,465,726
1000,526,490,470,253,514,767
1000,482,488,503,232,509,741
1000,465,473,480,222,505,727
1000,497,496,524,255,516,771
1000,529,486,494,259,496,755
1000,504,509,506,255,509,764
1000,507,499,512,250,506,756
1000,505,502,490,272,479,751
1000,496,499,515,255,502,757
1000,509,495,522,259,507,766
1000,470,507,488,245,476,721
1000,510,477,497,248,509,757
1000,503,510,519,256,504,760
1000,512,511,504,271,490,761
1000,507,504,509,253,503,756
1000,472,510,504,248,489,737
1000,503,506,518,227,543,770
1000,488,525,479,255,484,739
1000,516,496,516,257,506,763
1000,501,486,520,234,526,760
1000,505,481,492,248,497,745
1000,523,501,497,267,504,771
1000,507,515,520,258,521,779
1000,482,477,516,232,497,729
1000,516,478,510,251,510,761
1000,485,508,514,231,517,748
1000,501,535,476,256,480,736
1000,505,523,479,264,496,760
1000,494,497,521,234,521,755
1000,508,518,522,271,499,770
1000,498,489,533,237,525,762
1000,537,499,497,272,505,777
1000,509,519,500,260,488,748
1000,515,506,494,267,483,750
1000,502,503,502,249,491,740
1000,531,501,492,275,486,761
1000,515,503,505,254,501,755
1000,509,497,521,260,510,770
1000,499,509,486,258,479,737
1000,515,488,525,253,516,769
1000,479,522,503,248,495,743
1000,530,509,511,268,501,769
1000,470,514,502,239,496,735
1000,495,506,507,255,493,748
1000,486,475,511,233,501,734
1000,516,506,480,267,476,743
1000,507,483,486,244,489,733
1000,527,504,478,271,489,760
1000,494,507,499,252,489,741
1000,484,482,501,238,505,743
1000,489,491,520,243,507,750
1000,523,501,528,269,517,786
1000,499,476,493,233,513,746
1000,526,499,525,255,509,764
1000,501,511,510,256,491,747
1000,468,504,505,248,498,746
1000,506,491,513,238,536,774
1000,504,519,488,260,490,750
1000,479,497,516,241,511,752
1000,497,479,512,245,515,760
1000,485,495,498,237,505,742
1000,505,496,488,256,495,751
1000,514,493,478,252,501,753
1000,496,519,512,266,502,768
1000,491,503,517,241,510,751
1000,502,538,508,277,473,750
1000,509,514,493,268,475,743
1000,489,504,511,266,475,741
1000,493,501,506,264,489,753
1000,497,499,498,248,504,752
1000,517,495,489,267,476,743
1000,501,514,514,262,505,767
1000,495,516,512,259,491,750
1000,512,469,499,242,505,747
1000,504,517,502,263,486,749
1000,519,523,476,269,479,748
1000,489,467,499,229,516,745
1000,494,498,511,259,496,755
1000,472,522,504,236,496,732
1000,510,499,522,245,531,776
1000,531,479,511,242,521,763
1000,534,534,506,287,483,770
1000,483,480,508,223,519,742
1000,466,529,529,263,486,749
1000,522,463,528,260,503,763
1000,515,501,484,252,499,751
1000,508,484,485,249,504,753
1000,477,514,490,250,504,754
1000,496,478,491,249,504,753
1000,514,493,514,260,504,764
1000,496,513,518,260,502,762
1000,498,498,496,253,490,743
1000,517,524,477,285,462,747
1000,513,489,463,256,492,748
1000,534,510,485,272,484,756
1000,498,511,475,247,481,728
1000,488,478,472,220,495,715
1000,481,487,496,238,502,740
1000,487,479,512,222,540,762
1000,501,499,494,237,519,756
1000,485,497,483,238,487,725
1000,489,524,484,247,470,717
1000,487,494,503,233,513,746
1000,501,498,499,248,507,755
1000,507,494,486,242,507,749
1000,509,512,492,258,502,760
1000,490,489,479,236,483,719
1000,454,473,495,204,527,731
1000,486,511,524,239,524,763
1000,506,514,523,255,512,767
1000,510,475,503,246,516,762
1000,508,507,510,251,502,753
1000,519,512,509,262,497,759
1000,504,497,493,248,504,752
1000,495,497,514,249,504,753
1000,458,482,498,213,507,720
1000,496,512,500,247,500,747
1000,524,480,488,258,492,750
1000,497,493,520,236,533,769
1000,501,493,497,248,507,755
1000,487,509,467,251,471,722
1000,510,505,518,257,509,766
1000,498,500,500,253,496,749
1000,503,520,508,264,492,756
1000,465,500,477,239,487,726
1000,510,502,511,238,527,765
1000,521,512,480,257,497,754
1000,485,492,505,235,522,757
1000,481,508,512,238,513,751
1000,519,494,534,254,516,770
1000,530,487,505,260,501,761
1000,508,534,482,275,469,744
1000,485,513,501,243,511,754
1000,519,527,504,290,489,779
1000,497,495,488,256,484,740
1000,492,512,507,253,494,747
1000,500,518,481,272,464,736
1000,517,510,525,258,508,766
1000,506,490,494,252,515,767
1000,474,516,499,241,496,737
1000,502,504,507,246,502,748
1000,488,491,520,233,527,760
1000,476,493,522,220,527,747
1000,491,530,495,263,466,729
1000,511,505,490,261,488,749
1000,521,502,515,258,514,772
1000,504,480,496,256,494,750
1000,507,477,531,242,521,763
1000,501,470,488,246,499,745
1000,515,495,506,260,499,759
1000,502,491,513,243,511,754
1000,537,459,476,249,500,749
1000,492,486,493,241,491,732
1000,491,497,484,250,483,733
1000,516,508,516,271,509,780
1000,497,501,510,259,500,759
1000,514,470,493,247,495,742
1000,498,501,532,239,523,762
1000,530,511,493,264,497,761
1000,495,507,480,253,482,735
1000,490,496,493,251,484,735
1000,510,473,511,226,535,761
1000,502,503,499,258,486,744
1000,492,498,489,244,492,736
1000,464,500,508,242,507,749
1000,513,500,512,246,503,749
1000,516,513,497,269,475,744
1000,529,495,486,250,503,753
1000,495,468,490,227,526,753
1000,509,499,500,245,529,774
1000,496,504,498,234,498,732
1000,510,490,497,247,514,761
1000,504,479,478,241,494,735
1000,504,508,520,251,517,768
1000,502,514,524,261,501,762
1000,497,507,502,250,499,749
1000,497,512,492,253,486,739
1000,525,471,511,256,516,772
1000,484,490,504,220,538,758
1000,516,473,492,233,529,762
1000,523,511,503,260,499,759
1000,503,482,477,240,497,737
1000,538,504,505,260,511,771
1000,487,507,487,250,483,733
1000,504,539,533,258,508,766
1000,482,451,502,220,522,742
1000,502,479,475,236,497,733
1000,480,511,495,252,485,737
1000,501,483,476,231,524,755
1000,500,509,507,265,482,747
1000,491,514,455,242,475,717
1000,524,519,546,273,499,772
1000,511,494,516,264,489,753
1000,498,519,479,264,475,739
1000,498,472,468,237,485,722
1000,492,521,513,259,510,769
1000,496,499,517,241,505,746
1000,479,472,521,231,534,765
1000,521,518,507,275,483,758
1000,487,501,491,234,519,753
1000,505,491,513,244,527,771
1000,502,516,495,258,497,755
1000,524,488,491,268,488,756
1000,504,499,513,256,502,758
1000,507,507,500,268,472,740
1000,483,504,500,244,504,748
1000,504,491,466,254,475,729
1000,531,520,480,272,473,745
1000,498,507,503,243,499,742
1000,496,504,476,258,471,729
1000,519,494,484,259,486,745
1000,466,508,495,227,495,722
1000,499,516,520,257,508,765
1000,476,501,501,241,488,729
1000,496,494,491,248,496,744
1000,486,488,487,239,496,735
1000,515,508,501,262,484,746
1000,504,472,526,234,523,757
1000,495,519,488,259,489,748
1000,517,463,499,239,527,766
1000,521,492,494,268,498,766
1000,510,528,522,262,511,773
1000,504,493,498,266,497,763
1000,494,526,509,257,501,758
1000,518,491,490,252,502,754
1000,518,514,509,265,496,761
1000,481,512,495,243,512,755
1000,519,500,481,265,476,741
1000,513,496,498,253,497,750
1000,494,505,530,245,529,774
1000,519,498,496,250,504,754
1000,501,499,460,246,485,731
1000,480,505,490,253,492,745
1000,516,491,521,263,504,767
1000,485,506,519,250,511,761
1000,501,507,508,263,472,735
1000,509,492,479,253,487,740
1000,490,533,500,254,497,751
1000,488,522,539,254,512,766
1000,489,489,510,240,492,732
1000,499,506,491,250,486,736
1000,503,520,502,271,477,748
1000,489,501,490,261,471,732
1000,475,482,492,231,496,727
1000,491,493,499,257,486,743
1000,524,518,496,264,508,772
1000,513,502,489,251,484,735
1000,502,482,486,254,492,746
1000,495,492,485,234,502,736
1000,503,506,510,251,514,765
1000,504,490,489,254,492,746
1000,499,503,504,254,505,759
1000,514,461,444,253,476,729
1000,499,514,494,258,483,741
1000,499,500,527,236,530,766
1000,492,495,535,241,519,760
1000,489,497,508,240,506,746
1000,514,520,488,272,489,761
1000,506,474,494,241,503,744
1000,514,515,502,262,491,753
1000,504,515,491,274,469,743
1000,524,504,512,258,513,771
1000,500,494,511,249,517,766
1000,482,502,496,229,513,742
1000,500,485,511,249,516,765
1000,514,490,487,249,515,764
1000,524,519,490,274,487,761
1000,520,491,490,261,495,756
1000,519,494,492,257,506,763
1000,524,464,508,240,523,763
1000,516,486,479,255,484,739
1000,505,522,522,257,508,765
1000,514,501,473,263,480,743
1000,473,478,500,237,494,731
1000,511,492,506,239,536,775
1000,517,498,497,252,505,757
1000,478,476,492,223,505,728
1000,481,519,485,244,481,725
1000,496,487,519,254,501,755
1000,486,495,510,237,509,746
1000,532,521,486,285,485,770
1000,508,492,507,264,493,757
1000,498,494,495,256,488,744
1000,507,503,500,257,507,764
1000,482,527,494,262,470,732
1000,506,488,498,245,524,769
1000,504,482,494,236,510,746
1000,506,495,519,245,530,775
1000,505,483,508,242,525,767
1000,469,517,519,237,506,743
1000,489,470,494,234,499,733
1000,491,503,476,240,499,739
1000,497,508,502,242,515,757
1000,496,504,489,261,494,755
1000,478,501,498,231,506,737
1000,478,467,503,211,529,740
1000,491,500,502,248,508,756
1000,521,497,506,263,503,766
1000,501,494,489,254,484,738
1000,498,483,490,242,492,734
1000,503,497,502,251,507,758
1000,498,498,518,233,529,762
1000,496,448,515,216,552,768
1000,499,514,486,245,488,733
1000,495,513,494,246,499,745
1000,501,486,505,237,519,756
1000,482,516,478,253,483,736
1000,521,498,511,269,481,750
1000,527,473,490,244,506,750
1000,512,502,509,270,497,767
1000,505,522,527,266,495,761
1000,521,506,502,262,500,762
1000,506,495,495,252,496,748
1000,500,457,514,226,528,754
1000,490,497,468,246,486,732
1000,511,503,488,254,500,754
1000,500,527,475,268,477,745
1000,500,503,493,253,496,749
1000,490,482,519,250,512,762
1000,480,490,481,252,484,736
1000,504,495,495,255,504,759
1000,529,516,533,285,507,792
1000,465,520,516,237,499,736
1000,528,487,503,265,504,769
1000,476,483,492,243,495,738
1000,525,524,513,265,485,750
1000,493,476,489,245,485,730
1000,524,505,487,262,494,756
1000,489,498,490,233,502,735
1000,506,491,507,250,506,756
1000,524,485,492,252,500,752
1000,510,478,478,231,516,747
1000,500,514,508,259,499,758
1000,514,499,519,265,501,766
1000,495,513,514,260,508,768
1000,485,516,486,253,487,740
1000,498,505,502,235,508,743
1000,488,507,483,246,494,740
1000,484,478,509,218,541,759
1000,531,465,501,233,528,761
1000,520,532,505,291,467,758
1000,509,482,496,244,512,756
1000,518,532,487,274,478,752
1000,480,488,491,237,495,732
1000,507,514,501,257,486,743
1000,495,486,496,244,505,749
1000,495,507,495,242,513,755
1000,514,512,509,262,500,762
1000,508,523,491,260,493,753
1000,482,489,518,236,503,739
1000,516,493,495,251,508,759
1000,496,513,469,258,478,736
1000,486,481,505,237,510,747
1000,516,500,492,256,503,759
1000,515,493,477,267,483,750
1000,503,498,498,246,499,745
1000,485,496,508,238,496,734
1000,503,492,507,244,513,757
1000,517,475,520,241,531,772
1000,540,504,503,270,491,761
1000,517,520,498,267,498,765
1000,510,506,535,265,500,765
1000,502,477,516,253,500,753
1000,519,507,479,274,473,747
1000,486,484,504,248,498,746
1000,496,522,496,268,474,742
1000,497,528,489,263,470,733
1000,510,495,493,250,511,761
1000,513,502,466,260,486,746
1000,512,480,496,236,514,750
1000,500,519,503,252,511,763
1000,503,501,483,255,497,752
1000,505,503,491,252,508,760
1000,512,502,486,254,486,740
1000,489,479,470,232,504,736
1000,521,509,486,264,488,752
1000,479,520,478,236,499,735
1000,519,512,479,255,483,738
1000,500,485,488,241,490,731
1000,513,502,526,267,493,760
1000,524,508,514,261,505,766
1000,513,484,506,251,506,757
1000,490,476,480,246,501,747
1000,494,471,507,239,521,760
1000,504,509,498,256,501,757
1000,515,480,495,259,501,760
1000,485,507,499,223,525,748
1000,480,494,503,238,503,741
1000,522,484,497,264,496,760
1000,495,512,526,254,509,763
1000,507,503,491,252,489,741
1000,516,486,512,258,503,761
1000,501,507,522,247,508,755
1000,492,473,497,221,526,747
1000,512,473,497,245,499,744
1000,465,508,514,226,512,738
1000,480,526,499,251,484,735
1000,515,496,518,257,516,773
1000,489,488,500,250,493,743
1000,523,512,507,267,484,751
1000,489,500,490,241,504,745
1000,483,512,458,250,480,730
1000,511,498,490,256,500,756
1000,488,476,491,211,518,729
1000,486,530,497,268,486,754
1000,520,532,522,276,491,767
1000,498,473,489,217,517,734
1000,493,477,483,242,514,756
1000,470,504,462,236,492,728
1000,513,493,504,252,496,748
1000,518,510,531,269,513,782
1000,501,492,488,257,477,734
1000,490,486,510,236,513,749
1000,480,496,499,231,513,744
1000,521,493,492,254,499,753
1000,510,490,501,254,511,765
1000,503,493,513,257,500,757
1000,500,472,517,243,510,753
1000,491,480,509,237,503,740
1000,486,483,525,245,507,752
1000,497,494,480,257,473,730
1000,530,505,482,262,503,765
1000,503,499,520,259,492,751
1000,500,481,518,240,511,751
1000,495,482,499,229,515,744
1000,486,501,483,252,481,733
1000,509,511,516,256,503,759
1000,520,520,492,281,482,763
1000,511,530,478,271,478,749
1000,470,497,503,226,506,732
1000,504,476,487,233,517,750
1000,507,497,518,242,510,752
1000,487,497,474,241,497,738
1000,530,497,504,248,510,758
1000,473,477,510,230,522,752
1000,499,510,502,255,491,746
1000,507,512,507,260,492,752
1000,500,537,475,277,454,731
1000,510,513,494,267,490,757
1000,512,512,512,246,523,769
1000,512,478,482,240,506,746
1000,485,492,490,240,497,737
1000,515,486,474,253,497,750
1000,490,499,521,248,510,758
1000,482,513,500,238,497,735
1000,500,492,502,252,506,758
1000,528,506,514,278,499,777
1000,490,517,475,250,470,720
1000,518,507,495,261,497,758
1000,507,509,524,263,503,766
1000,510,500,511,251,508,759
1000,496,485,505,246,504,750
1000,518,458,498,225,524,749
1000,493,511,513,252,509,761
1000,463,516,490,226,504,730
1000,534,510,497,267,496,763
1000,495,500,481,247,506,753
1000,508,521,482,259,495,754
1000,490,493,508,258,484,742
1000,504,499,505,241,503,744
1000,482,526,491,249,500,749
1000,480,497,506,249,511,760
1000,501,505,501,253,503,756
1000,520,489,486,246,504,750
1000,496,515,488,259,468,727
1000,492,501,517,251,505,756
1000,508,498,480,251,485,736
1000,479,508,510,246,503,749
1000,508,475,512,248,517,765
1000,503,528,474,262,482,744
1000,496,520,508,252,501,753
1000,527,490,500,255,507,762
1000,493,495,478,245,484,729
1000,509,466,502,224,531,755
1000,498,519,491,257,493,750
1000,496,517,511,253,493,746
1000,496,494,481,237,515,752
1000,476,505,506,237,502,739
1000,513,503,507,247,505,752
1000,522,509,469,275,478,753
1000,512,528,494,278,479,757
1000,515,488,491,253,508,761
1000,505,496,519,243,523,766
1000,493,489,510,237,521,758
1000,509,525,511,271,497,768
1000,523,498,508,259,509,768
1000,504,505,483,245,501,746
1000,505,501,509,268,482,750
1000,504,507,502,246,501,747
1000,468,487,510,228,519,747
1000,520,491,461,263,480,743
1000,492,492,489,236,493,729
1000,500,485,485,242,516,758
1000,488,477,489,225,523,748
1000,509,514,492,245,507,752
1000,526,516,496,269,508,777
1000,511,502,476,261,486,747
1000,511,474,522,260,508,768
1000,506,461,486,230,533,763
1000,495,505,490,251,486,737
1000,484,462,487,225,512,737
1000,525,490,482,270,485,755
1000,482,483,506,243,502,745
1000,499,506,525,247,508,755
1000,496,500,496,249,496,745
1000,484,473,509,225,531,756
1000,483,505,495,251,496,747
1000,496,518,481,263,470,733
1000,490,468,498,228,525,753
1000,519,528,506,269,491,760
1000,534,524,515,270,509,779
1000,512,510,482,263,497,760
1000,522,489,524,263,513,776
1000,507,494,501,262,502,764
1000,511,519,496,265,481,746
1000,480,504,515,239,502,741
1000,528,503,515,272,502,774
1000,507,521,531,260,504,764
1000,484,508,525,257,496,753
1000,509,492,523,257,495,752
1000,497,523,477,253,486,739
1000,508,500,509,259,491,750
1000,481,509,489,250,484,734
1000,484,494,489,241,503,744
1000,506,503,528,262,519,781
1000,529,536,508,282,505,787
1000,500,498,506,241,494,735
1000,495,523,503,254,505,759
1000,489,508,466,258,464,722
1000,489,508,503,262,478,740
1000,471,492,535,231,523,754
1000,466,487,519,216,533,749
1000,502,496,486,250,497,747
1000,536,520,513,270,521,791
1000,490,500,518,243,505,748
1000,511,513,509,255,496,751
1000,494,524,509,252,492,744
1000,518,484,477,259,488,747
1000,490,521,501,249,500,749
1000,518,491,502,250,505,755
1000,513,534,509,267,505,772
1000,496,517,457,255,472,727
1000,469,505,490,246,478,724
1000,510,494,476,243,495,738
1000,481,515,509,262,491,753
1000,480,509,493,254,473,727
1000,514,488,526,253,527,780
1000,512,519,478,258,476,734
1000,520,488,502,248,504,752
1000,528,508,516,264,510,774
1000,530,489,505,269,501,770
1000,494,494,515,255,506,761
1000,517,522,513,266,491,757
1000,506,495,481,263,481,744
1000,496,515,479,263,466,729
1000,513,502,509,253,506,759
1000,486,493,519,233,527,760
1000,492,514,504,258,485,743
1000,494,523,485,246,492,738
1000,520,488,479,260,491,751
1000,528,472,504,249,510,759
1000,524,510,488,266,487,753
1000,505,500,500,257,485,742
1000,512,504,488,257,511,768
1000,505,503,506,242,527,769
1000,532,488,504,260,513,773
1000,504,520,485,269,472,741
1000,488,496,526,245,521,766
1000,522,474,529,233,534,767
1000,504,518,509,253,513,766
1000,511,480,508,243,516,759
1000,490,531,512,258,482,740
1000,520,496,529,263,516,779
1000,504,469,494,248,501,749
1000,505,519,497,247,503,750
1000,499,507,507,263,488,751
1000,526,470,506,262,515,777
1000,488,486,483,239,503,742
1000,492,493,506,240,501,741
1000,474,500,498,254,487,741
1000,504,517,510,261,502,763
1000,535,476,493,248,506,754
1000,498,522,520,253,511,764
1000,511,500,512,259,504,763
1000,492,524,495,256,490,746
1000,503,492,517,249,502,751
1000,507,499,502,245,514,759
1000,524,515,490,278,490,768
1000,504,519,497,277,485,762
1000,509,504,497,251,499,750
1000,503,497,513,249,508,757
1000,483,472,494,233,491,724
1000,480,511,499,253,506,759
1000,498,478,495,241,510,751
1000,506,509,505,260,501,761
1000,472,528,478,249,467,716
1000,509,492,520,248,521,769
1000,525,522,498,281,475,756
1000,524,515,488,268,477,745
1000,510,510,480,252,506,758
1000,510,515,512,256,515,771
1000,480,502,507,241,493,734
1000,483,503,500,237,495,732
1000,485,502,506,235,507,742
1000,499,502,511,252,497,749
1000,505,487,493,247,498,745
1000,486,498,512,238,497,735
1000,533,512,523,283,478,761
1000,483,502,497,234,502,736
1000,488,512,499,248,502,750
1000,500,500,516,259,494,753
1000,520,484,472,253,498,751
1000,510,494,502,254,495,749
1000,520,490,491,253,501,754
1000,507,498,522,246,516,762
1000,486,513,516,252,489,741
1000,520,530,501,267,510,777
1000,460,502,519,234,516,750
1000,486,499,515,237,511,748
1000,480,496,498,220,531,751
1000,512,511,486,241,500,741
1000,494,464,516,218,541,759
1000,509,480,466,240,489,729
1000,507,484,505,257,494,751
1000,500,489,511,249,490,739
1000,517,504,500,271,491,762
1000,477,488,500,233,518,751
1000,479,512,501,246,486,732
1000,506,484,514,252,509,761
1000,521,498,500,271,492,763
1000,489,486,493,256,484,740
1000,502,484,514,251,510,761
1000,510,508,519,269,486,755
1000,520,503,485,257,507,764
1000,523,506,510,270,499,769
1000,517,485,506,251,521,772
1000,507,506,472,281,451,732
1000,500,504,513,251,519,770
1000,520,527,487,294,469,763
1000,482,511,492,244,490,734
1000,522,509,503,272,500,772
1000,499,528,532,262,504,766
1000,511,467,490,234,522,756
1000,506,489,492,248,507,755
1000,520,465,458,238,509,747
1000,495,504,491,237,517,754
1000,499,518,522,247,535,782
1000,515,515,504,265,496,761
1000,516,498,508,259,509,768
1000,496,522,499,254,498,752
1000,487,529,493,266,481,747
1000,525,512,515,257,507,764
1000,501,480,533,249,527,776
1000,493,501,496,245,498,743
1000,486,472,448,234,481,715
1000,494,510,484,260,480,740
1000,501,484,467,231,506,737
1000,501,498,481,249,498,747
1000,495,496,509,238,517,755
1000,509,509,507,243,516,759
1000,496,512,494,253,488,741
1000,508,481,512,240,528,768
1000,504,478,522,234,530,764
1000,521,499,493,251,513,764
1000,496,493,499,244,506,750
1000,497,516,516,267,492,759
1000,508,525,511,272,493,765
1000,481,505,521,249,489,738
1000,500,489,503,259,479,738
1000,498,528,488,253,499,752
1000,508,503,500,274,477,751
1000,505,497,514,262,482,744
1000,479,532,495,260,474,734
1000,504,508,499,249,504,753
1000,519,530,519,281,485,766
1000,515,504,492,257,490,747
1000,500,516,502,248,506,754
1000,498,487,509,256,506,762
1000,478,485,497,239,514,753
1000,504,515,494,272,472,744
1000,510,518,502,268,487,755
1000,512,499,508,268,485,753
1000,506,498,484,243,507,750
1000,492,496,518,243,510,753
1000,488,490,500,239,503,742
1000,527,537,509,278,498,776
1000,517,505,502,274,473,747
1000,488,505,491,246,491,737
1000,527,500,510,261,511,772
1000,505,500,490,246,502,748
1000,510,490,491,243,514,757
1000,511,480,517,250,519,769
1000,499,488,505,251,504,755
1000,478,507,490,240,485,725
1000,494,510,500,249,511,760
1000,497,501,505,252,509,761
1000,493,500,456,256,474,730
1000,487,492,506,234,512,746
1000,511,496,481,246,509,755
1000,489,504,513,249,510,759
1000,505,501,497,254,490,744
1000,509,499,465,258,488,746
1000,485,509,492,243,500,743
1000,490,508,491,249,491,740
1000,498,511,502,251,509,760
1000,522,514,467,270,489,759
1000,506,486,495,244,506,750
1000,502,511,496,267,477,744
1000,497,506,496,265,487,752
1000,518,516,512,266,522,788
1000,470,510,498,242,484,726
1000,480,520,500,261,467,728
1000,524,486,494,262,505,767
1000,462,515,476,231,489,720
1000,519,496,516,233,540,773
1000,474,472,527,214,527,741
1000,512,505,502,267,485,752
1000,503,496,527,230,551,781
1000,505,516,513,252,502,754
1000,498,517,521,262,504,766
1000,477,500,486,239,506,745
1000,500,498,488,246,498,744
1000,512,504,498,263,492,755
1000,525,504,485,268,489,757
1000,493,488,521,255,507,762
1000,516,527,515,267,503,770
1000,510,518,481,273,479,752
1000,498,481,512,243,505,748
1000,516,501,517,254,524,778
1000,524,506,535,269,502,771
1000,505,471,505,233,519,752
1000,482,492,498,239,502,741
1000,501,504,491,260,504,764
1000,492,516,511,251,500,751
1000,507,506,491,257,493,750
1000,497,485,490,231,516,747
1000,471,484,492,238,494,732
1000,516,485,496,243,516,759
1000,491,514,481,252,486,738
1000,505,517,514,253,512,765
1000,480,510,518,247,497,744
1000,504,508,521,255,510,765
1000,482,507,492,231,501,732
1000,484,508,518,244,517,761
1000,492,523,507,249,501,750
1000,498,490,493,241,486,727
1000,517,490,513,262,511,773
1000,517,512,494,251,509,760
1000,482,520,488,251,486,737
1000,504,493,482,247,498,745
1000,504,543,521,257,501,758
1000,524,480,496,253,523,776
1000,524,524,483,284,471,755
1000,477,479,481,230,498,728
1000,489,492,501,237,513,750
1000,504,498,485,254,490,744
1000,493,523,525,255,513,768
1000,497,512,523,259,506,765
1000,513,497,513,256,501,757
1000,506,477,505,236,516,752
1000,489,482,473,238,501,739
1000,517,487,517,260,492,752
1000,529,507,486,260,499,759
1000,510,506,513,252,506,758
1000,482,518,525,253,501,754
1000,508,498,472,240,507,747
1000,524,494,477,269,485,754
1000,493,484,488,246,499,745
1000,509,495,494,252,500,752
1000,516,528,524,262,497,759
1000,526,521,507,286,500,786
1000,492,478,476,241,486,727
1000,479,492,490,228,507,735
1000,523,495,501,256,502,758
1000,481,507,516,228,524,752
1000,532,487,491,265,515,780
1000,472,515,520,241,505,746
1000,471,496,519,239,507,746
1000,495,511,487,263,472,735
1000,481,516,487,244,497,741
1000,513,491,464,252,481,733
1000,489,506,482,248,485,733
1000,504,499,479,255,478,733
1000,495,514,502,268,477,745
1000,468,509,490,229,499,728
1000,515,524,478,269,472,741
1000,498,535,507,279,460,739
1000,494,523,478,253,493,746
1000,506,504,522,252,516,768
1000,496,510,488,256,494,750
1000,514,480,490,251,507,758
1000,471,519,498,240,497,737
1000,537,497,522,265,517,782
1000,509,497,491,246,510,756
1000,476,493,496,234,509,743
1000,502,517,532,255,514,769
1000,495,492,510,233,509,742
1000,503,506,503,259,504,763
1000,512,497,523,252,507,759
1000,481,502,482,234,519,753
1000,497,496,490,245,513,758
1000,510,501,504,251,510,761
1000,478,485,503,234,502,736
1000,501,466,524,228,525,753
1000,507,482,485,255,480,735
1000,482,504,496,249,494,743
1000,498,481,509,242,512,754
1000,476,528,493,249,489,738
1000,476,496,486,246,489,735
1000,532,526,492,280,489,769
1000,537,491,477,268,490,758
1000,461,497,494,221,507,728
1000,522,469,491,258,502,760
1000,495,493,498,257,491,748
1000,507,507,480,267,476,743
1000,502,491,513,258,493,751
1000,501,482,496,243,490,733
1000,502,461,485,236,505,741
1000,524,500,501,261,498,759
1000,522,494,508,267,504,771
1000,502,512,528,267,491,758
1000,508,500,507,260,490,750
1000,534,484,480,261,495,756
1000,519,504,520,264,499,763
1000,504,502,480,248,486,734
1000,485,525,499,247,486,733
1000,476,502,519,230,514,744
1000,496,491,470,247,489,736
1000,489,510,517,258,491,749
1000,471,488,485,234,477,711
1000,511,509,463,250,482,732
1000,511,495,498,245,516,761
1000,451,518,511,225,503,728
1000,491,510,485,251,491,742
1000,487,509,495,246,504,750
1000,491,490,494,248,499,747
1000,496,475,503,241,519,760
1000,498,489,506,248,506,754
1000,499,534,516,281,474,755
1000,501,497,492,238,512,750
1000,497,538,506,264,501,765
1000,508,508,460,256,481,737
1000,501,513,513,255,505,760
1000,535,499,506,277,500,777
1000,506,524,495,267,479,746
1000,516,508,514,275,490,765
1000,524,506,489,269,490,759
1000,487,515,525,247,512,759
1000,510,518,508,267,497,764
1000,508,502,514,254,522,776
1000,485,492,507,245,488,733
1000,495,509,520,257,495,752
1000,497,478,492,235,505,740
1000,521,514,519,275,477,752
1000,507,505,511,255,505,760
1000,509,495,494,252,505,757
1000,501,511,493,249,504,753
1000,513,507,496,255,495,750
1000,489,528,516,259,507,766
1000,507,497,515,248,511,759
1000,509,519,505,272,486,758
1000,506,498,493,241,501,742
1000,492,492,503,232,525,757
1000,507,492,499,253,505,758
1000,514,473,492,244,484,728
1000,482,493,489,241,490,731
1000,508,531,494,272,484,756
1000,499,482,462,246,489,735
1000,490,491,507,243,514,757
1000,491,519,527,259,502,761
1000,518,487,490,254,504,758
1000,496,516,525,265,500,765
1000,507,518,467,256,481,737
1000,469,523,499,253,466,719
1000,495,500,501,244,495,739
1000,524,506,490,262,488,750
1000,508,509,486,274,464,738
1000,499,499,533,262,500,762
1000,482,500,507,224,511,735
1000,509,506,501,267,480,747
1000,484,507,481,240,492,732
1000,495,496,490,253,499,752
1000,482,475,508,239,500,739
1000,493,520,495,256,483,739
1000,501,481,517,248,519,767
1000,526,494,511,250,522,772
1000,515,505,472,265,478,743
1000,476,497,509,225,520,745
1000,514,503,476,243,496,739
1000,486,502,473,243,476,719
1000,472,505,501,239,488,727
1000,468,505,507,227,503,730
1000,518,537,509,270,495,765
1000,484,495,523,243,513,756
1000,474,519,505,252,493,745
1000,497,492,505,243,508,751
1000,529,546,482,281,481,762
1000,485,486,487,237,490,727
1000,479,503,474,240,495,735
1000,497,496,515,249,508,757
1000,481,505,492,254,488,742
1000,516,497,503,267,501,768
1000,498,504,497,261,494,755
1000,496,498,526,253,508,761
1000,457,512,517,233,500,733
1000,515,498,498,254,497,751
1000,470,507,506,234,506,740
1000,480,523,489,247,490,737
1000,516,490,475,263,493,756
1000,477,491,485,227,495,722
1000,488,516,524,261,508,769
1000,515,492,503,245,526,771
1000,504,500,527,271,492,763
1000,489,495,457,240,497,737
1000,477,472,513,227,517,744
1000,518,501,491,259,482,741
1000,525,496,518,250,511,761
1000,487,496,507,229,516,745
1000,494,495,508,251,485,736
1000,502,494,511,250,501,751
1000,483,488,499,229,510,739
1000,493,516,474,260,491,751
1000,480,529,510,247,486,733
1000,490,482,496,232,505,737
1000,513,488,501,255,495,750
1000,495,495,507,246,495,741
1000,493,511,494,255,479,734
1000,506,511,489,254,491,745
1000,513,500,501,264,502,766
1000,495,481,482,251,491,742
1000,491,525,504,253,501,754
1000,504,506,511,251,498,749
1000,519,495,495,263,483,746
1000,526,501,491,273,495,768
1000,505,509,463,252,487,739
1000,515,516,516,277,474,751
1000,479,500,510,244,502,746
1000,516,486,530,255,509,764
1000,476,507,498,241,489,730
1000,506,505,507,251,503,754
1000,511,480,504,246,519,765
1000,487,488,520,238,525,763
1000,489,486,523,247,502,749
1000,524,507,495,266,499,765
1000,494,464,473,243,473,716
1000,510,495,492,247,514,761
1000,501,534,491,265,479,744
1000,485,496,514,244,498,742
1000,518,544,523,287,476,763
1000,489,505,466,255,477,732
1000,512,488,506,248,511,759
1000,523,493,505,252,519,771
1000,486,470,516,229,531,760
1000,514,487,514,238,533,771
1000,493,482,492,242,490,732
1000,498,527,487,245,506,751
1000,485,477,526,228,531,759
1000,465,521,512,236,510,746
1000,485,496,516,239,514,753
1000,490,492,509,243,508,751
1000,495,528,493,252,503,755
1000,495,466,484,222,522,744
1000,523,498,507,265,509,774
1000,506,480,528,232,534,766
1000,487,481,466,236,501,737
1000,491,475,509,238,515,753
1000,496,519,528,241,530,771
1000,470,508,479,237,496,733
1000,497,519,534,254,495,749
1000,481,493,513,240,515,755
1000,481,509,464,249,475,724
1000,498,521,514,250,508,758
1000,522,521,522,279,507,786
1000,481,512,508,248,493,741
1000,496,462,501,220,536,756
1000,491,520,498,248,495,743
1000,500,505,521,259,496,755
1000,490,493,522,248,501,749
1000,510,481,502,230,530,760
1000,509,493,515,255,504,759
1000,495,506,504,248,497,745
1000,486,514,493,246,491,737
1000,500,499,482,244,501,745
1000,519,506,490,263,495,758
1000,534,504,501,264,498,762
1000,487,517,496,256,478,734
1000,496,517,506,265,485,750
1000,486,487,524,238,526,764
1000,491,462,495,215,537,752
1000,484,491,508,240,496,736
1000,499,487,501,242,507,749
1000,469,480,482,223,505,728
1000,501,488,504,247,512,759
1000,490,474,510,237,528,765
1000,513,513,510,256,511,767
1000,512,477,513,236,522,758
1000,530,478,507,251,517,768
1000,492,502,507,246,490,736
1000,508,503,495,256,489,745
1000,509,491,497,261,492,753
1000,498,507,505,260,486,746
1000,489,500,532,232,533,765
1000,487,526,512,251,505,756
1000,525,504,498,266,510,776
1000,497,500,518,244,513,757
1000,526,522,488,276,486,762
1000,502,514,500,259,491,750
1000,512,490,505,257,506,763
1000,489,489,492,233,516,749
1000,510,485,492,278,484,762
1000,517,532,496,275,478,753
1000,489,474,461,230,494,724
1000,483,516,510,259,487,746
1000,496,500,516,238,515,753
1000,497,487,531,248,521,769
1000,497,509,487,251,491,742
1000,510,516,518,272,482,754
1000,503,509,501,254,487,741
1000,488,488,511,239,507,746
1000,474,496,488,232,488,720
1000,467,518,490,228,505,733
1000,500,491,471,236,490,726
1000,512,510,507,264,496,760
1000,500,491,480,247,494,741
1000,505,501,488,240,516,756
1000,500,493,533,238,527,765
1000,526,508,522,269,503,772
1000,495,500,513,241,528,769
1000,500,487,503,235,517,752
1000,514,514,479,252,489,741
1000,502,521,496,256,500,756
1000,487,546,540,267,507,774
1000,467,514,499,240,493,733
1000,499,515,472,253,485,738
1000,528,507,513,275,491,766
1000,497,494,490,256,483,739
1000,493,506,519,242,500,742
1000,504,512,498,260,504,764
1000,482,529,501,257,479,736
1000,498,490,514,245,506,751
1000,510,512,508,269,491,760
1000,493,486,494,248,488,736
1000,518,490,516,257,515,772
1000,496,471,503,214,532,746
1000,480,486,484,222,501,723
1000,473,513,533,245,516,761
1000,462,482,512,222,521,743
1000,488,484,522,251,515,766
1000,497,498,521,256,507,763
1000,512,476,493,238,519,757
1000,519,493,515,251,515,766
1000,496,501,498,242,509,751
1000,498,479,464,233,509,742
1000,506,495,482,249,498,747
1000,509,487,509,257,505,762
1000,491,520,500,271,467,738
1000,503,501,477,258,482,740
1000,500,473,516,241,524,765
1000,506,481,529,254,514,768
1000,510,475,508,247,512,759
1000,492,515,502,267,476,743
1000,504,500,525,267,485,752
1000,532,487,499,263,507,770
1000,494,505,476,247,494,741
1000,487,491,503,237,501,738
1000,479,520,504,253,479,732
1000,500,494,506,227,533,760
1000,492,498,509,249,491,740
1000,475,519,484,248,477,725
1000,464,495,481,241,474,715
1000,533,513,518,282,485,767
1000,473,503,496,255,476,731
1000,481,500,498,243,492,735
1000,478,496,518,239,515,754
1000,505,520,505,269,489,758
1000,488,506,506,252,519,771
1000,504,492,495,247,490,737
1000,513,496,487,257,484,741
1000,526,478,499,252,515,767
1000,508,483,506,233,520,753
1000,527,528,499,268,492,760
1000,493,482,507,230,510,740
1000,524,501,490,281,458,739
1000,506,498,504,273,475,748
1000,495,506,502,247,509,756
1000,487,513,529,263,477,740
1000,490,514,516,254,503,757
1000,519,500,494,260,502,762
1000,511,491,512,262,505,767
1000,526,496,506,273,487,760
1000,481,493,503,227,514,741
1000,467,528,494,250,481,731
1000,488,472,510,219,531,750
1000,523,503,486,272,487,759
1000,518,500,561,259,548,807
1000,488,491,481,236,495,731
1000,499,509,506,249,520,769
1000,518,508,483,257,499,756
1000,542,511,482,272,491,763
1000,515,506,508,268,490,758
1000,520,500,485,251,513,764
1000,499,520,532,266,495,761
1000,488,509,521,254,505,759
1000,534,505,505,272,510,782
1000,537,485,501,259,517,776
1000,470,470,486,224,514,738
1000,489,501,475,247,481,728
1000,504,506,507,272,490,762
1000,486,543,508,255,491,746
1000,478,494,499,230,519,749
1000,507,497,515,256,502,758
1000,509,511,486,262,470,732
1000,480,496,494,246,483,729
1000,491,527,528,248,517,765
1000,497,492,477,243,486,729
1000,504,513,517,267,495,762
1000,505,488,516,247,514,761
1000,484,490,503,235,506,741
1000,515,504,507,254,499,753
1000,513,497,515,249,518,767
1000,503,482,522,236,520,756
1000,515,479,491,239,515,754
1000,503,505,505,252,494,746
1000,518,487,503,228,536,764
1000,482,477,512,227,503,730
1000,499,498,477,255,470,725
1000,488,480,472,238,478,716
1000,500,493,460,245,478,723
1000,505,495,502,259,499,758
1000,551,501,505,273,504,777
1000,482,529,506,255,482,737
1000,495,482,508,229,540,769
1000,515,478,496,240,517,757
1000,495,518,513,245,502,747
1000,545,496,509,258,516,774
1000,489,502,494,249,493,742
1000,500,490,508,234,510,744
1000,516,474,517,236,527,763
1000,496,514,495,258,482,740
1000,527,516,516,281,489,770
1000,501,488,515,231,531,762
1000,509,484,486,248,490,738
1000,508,496,500,249,506,755
1000,499,477,495,231,511,742
1000,511,499,496,265,496,761
1000,474,482,497,225,519,744
1000,505,495,519,232,521,753
1000,513,501,480,257,506,763
1000,497,470,530,239,534,773
1000,479,503,496,251,492,743
1000,514,485,481,246,507,753
1000,491,503,474,254,478,732
1000,484,513,514,250,495,745
1000,481,478,490,216,509,725
1000,495,480,512,241,504,745
1000,487,471,509,233,530,763
1000,487,498,497,246,491,737
1000,461,492,498,241,486,727
1000,527,499,507,259,521,780
1000,498,484,472,249,483,732
1000,522,495,495,254,508,762
1000,489,509,521,258,492,750
1000,481,483,522,233,509,742
1000,458,504,509,227,495,722
1000,514,482,505,248,508,756
1000,500,503,485,239,513,752
1000,494,471,491,230,508,738
1000,513,497,502,261,497,758
1000,510,479,503,245,519,764
1000,471,500,496,231,505,736
1000,503,494,503,242,514,756
1000,482,509,499,245,493,738
1000,508,506,508,253,507,760
1000,475,515,505,253,490,743
1000,496,514,490,250,490,740
1000,519,507,518,269,496,765
1000,507,496,505,245,505,750
1000,529,519,521,283,493,776
1000,513,524,511,261,489,750
1000,496,476,504,242,499,741
1000,507,487,530,247,518,765
1000,511,495,504,248,513,761
1000,487,521,495,258,485,743
1000,503,505,487,249,495,744
1000,495,526,482,246,495,741
1000,472,510,485,235,496,731
1000,464,479,504,233,496,729
1000,478,456,496,207,539,746
1000,510,505,495,241,502,743
1000,484,508,485,248,489,737
1000,475,507,512,252,497,749
1000,490,497,522,251,504,755
1000,514,501,493,279,470,749
1000,497,517,523,255,499,754
1000,478,471,494,230,529,759
1000,466,505,478,237,487,724
1000,493,488,505,233,512,745
1000,489,485,500,247,498,745
1000,528,514,479,275,474,749
1000,475,520,508,238,502,740
1000,492,487,505,240,507,747
1000,498,536,497,270,479,749
1000,492,469,493,254,482,736
1000,522,491,505,267,500,767
1000,524,526,526,270,506,776
1000,496,512,514,258,498,756
1000,507,499,507,257,497,754
1000,488,478,506,226,515,741
1000,497,475,478,222,526,748
1000,491,467,526,246,513,759
1000,491,505,517,246,506,752
1000,517,489,482,262,461,723
1000,521,499,506,271,503,774
1000,507,507,505,241,510,751
1000,482,492,504,242,495,737
1000,489,509,508,246,498,744
1000,505,487,508,235,510,745
1000,523,508,487,249,504,753
1000,508,492,507,247,513,760
1000,498,506,499,264,481,745
1000,497,516,507,243,498,741
1000,502,518,507,270,477,747
1000,504,471,510,235,531,766
1000,520,492,496,242,494,736
1000,482,496,518,241,507,748
1000,497,522,502,264,463,727
1000,493,508,509,263,487,750
1000,496,523,524,250,503,753
1000,496,508,509,257,486,743
1000,525,495,508,262,501,763
1000,507,501,478,257,490,747
1000,475,505,526,247,499,746
1000,493,482,491,237,505,742
1000,479,491,498,235,513,748
1000,485,506,504,245,500,745
1000,498,520,485,261,478,739
1000,480,512,496,241,490,731
1000,504,478,482,236,504,740
1000,503,523,495,274,472,746
1000,495,513,484,257,490,747
1000,517,515,501,265,498,763
1000,515,509,491,264,494,758
1000,478,473,475,230,500,730
1000,470,497,472,236,483,719
1000,489,510,493,249,491,740
1000,504,523,502,268,488,756
1000,515,513,495,255,509,764
1000,516,474,504,227,541,768
1000,501,492,489,243,506,749
1000,486,520,501,240,509,749
1000,524,528,504,262,500,762
1000,479,516,501,258,481,739
1000,496,517,495,262,482,744
1000,507,511,519,257,495,752
1000,484,502,501,247,495,742
1000,508,494,492,259,491,750
1000,503,483,512,238,526,764
1000,496,491,509,246,510,756
1000,519,514,491,266,489,755
1000,489,491,483,239,502,741
1000,516,477,500,243,517,760
1000,514,493,495,253,499,752
1000,510,494,498,261,508,769
1000,494,510,491,241,499,740
1000,534,501,501,253,503,756
1000,528,488,486,261,484,745
1000,528,496,482,253,509,762
1000,510,515,500,266,500,766
1000,509,481,506,256,509,765
1000,504,485,511,240,519,759
1000,509,508,495,257,486,743
1000,487,477,491,233,501,734
1000,502,488,518,248,500,748
1000,505,518,497,249,499,748
1000,495,493,522,237,519,756
1000,508,482,483,244,492,736
1000,483,523,508,243,501,744
1000,486,508,505,250,496,746
1000,508,534,497,268,483,751
1000,505,499,523,248,517,765
1000,485,492,491,247,497,744
1000,488,481,490,237,498,735
1000,509,507,527,252,517,769
1000,528,488,474,253,501,754
1000,489,500,528,232,527,759
1000,498,489,506,250,505,755
1000,490,510,494,257,468,725
1000,496,510,511,259,493,752
1000,489,499,475,233,491,724
1000,477,474,499,236,502,738
1000,488,519,501,256,491,747
1000,500,484,492,242,507,749
1000,518,497,500,266,496,762
1000,481,520,514,253,490,743
1000,494,506,488,253,484,737
1000,490,463,487,228,510,738
1000,498,510,498,255,506,761
1000,522,510,471,271,463,734
1000,507,527,516,274,494,768
1000,514,495,490,262,496,758
1000,504,502,474,247,496,743
1000,523,506,502,260,496,756
1000,489,497,492,252,506,758
1000,498,488,489,242,510,752
1000,484,474,488,233,506,739
1000,494,484,475,239,490,729
1000,491,507,505,242,523,765
1000,502,496,516,248,516,764
1000,510,520,491,276,461,737
1000,483,514,498,256,482,738
1000,494,528,483,270,468,738
1000,502,474,488,236,505,741
1000,489,470,529,231,545,776
1000,522,524,525,282,498,780
1000,493,518,492,266,476,742
1000,494,512,539,260,510,770
1000,517,518,507,271,484,755
1000,500,528,499,259,480,739
1000,514,478,494,244,510,754
1000,506,515,500,258,493,751
1000,526,512,516,273,502,775
1000,482,511,513,248,492,740
1000,512,489,474,251,482,733
1000,500,536,513,270,486,756
1000,544,497,478,273,495,768
1000,505,526,504,260,499,759
1000,504,493,498,252,484,736
1000,491,505,493,255,496,751
1000,486,475,483,244,483,727
1000,504,491,510,257,509,766
1000,498,522,509,264,494,758
1000,504,508,498,247,506,753
1000,521,482,491,249,516,765
1000,517,503,536,252,519,771
1000,497,523,507,260,489,749
1000,488,503,530,252,507,759
1000,519,485,512,254,525,779
1000,500,520,499,258,492,750
1000,502,504,483,243,512,755
1000,495,499,483,251,499,750
1000,472,490,512,220,525,745
1000,518,497,497,247,502,749
1000,483,526,508,244,504,748
1000,501,523,503,267,493,760
1000,498,511,505,255,500,755
1000,488,509,495,255,480,735
1000,494,492,480,238,503,741
1000,517,485,496,261,498,759
1000,538,523,505,285,483,768
1000,486,517,492,241,496,737
1000,515,497,506,242,529,771
1000,500,505,516,265,506,771
1000,523,494,523,256,517,773
1000,515,501,492,241,510,751
1000,507,481,493,233,517,750
1000,490,467,505,233,510,743
1000,501,548,490,272,459,731
1000,485,502,523,236,525,761
1000,503,507,506,263,482,745
1000,502,485,517,249,515,764
1000,489,512,507,246,501,747
1000,513,480,505,257,513,770
1000,524,480,521,256,528,784
1000,513,500,504,266,485,751
1000,487,492,509,235,514,749
1000,509,483,496,248,508,756
1000,510,528,503,257,500,757
1000,525,516,495,283,474,757
1000,465,499,503,233,501,734
1000,506,491,517,257,508,765
1000,472,524,467,233,475,708
1000,513,509,485,246,504,750
1000,508,496,514,245,510,755
1000,514,487,500,249,504,753
1000,503,531,491,282,449,731
1000,479,507,489,254,490,744
1000,517,483,500,242,508,750
1000,475,492,472,219,518,737
1000,522,496,482,255,486,741
1000,515,495,497,255,504,759
1000,523,508,507,263,500,763
1000,501,494,498,261,481,742
1000,501,499,497,246,498,744
1000,528,512,477,266,485,751
1000,504,495,498,255,512,767
1000,484,507,475,235,490,725
1000,506,487,484,239,500,739
1000,511,522,494,260,502,762
1000,497,513,490,257,494,751
1000,485,492,507,239,505,744
1000,516,510,475,266,481,747
1000,509,492,499,268,478,746
1000,502,528,525,275,492,767
1000,507,500,506,259,504,763
1000,500,499,547,257,523,780
1000,517,513,508,277,479,756
1000,508,511,527,267,499,766
1000,486,484,494,232,509,741
1000,484,511,472,234,503,737
1000,511,505,512,265,494,759
1000,494,516,497,245,506,751
1000,489,505,510,239,519,758
1000,494,520,512,251,500,751
1000,524,507,476,253,500,753
1000,510,484,490,252,491,743
1000,498,496,512,243,510,753
1000,517,499,488,263,482,745
1000,481,470,511,235,507,742
1000,492,497,484,259,472,731
1000,489,486,491,232,500,732
1000,545,508,514,276,494,770
1000,496,492,502,240,524,764
1000,533,516,517,283,492,775
1000,471,510,511,250,486,736
1000,478,508,536,245,522,767
1000,513,497,485,253,501,754
1000,482,513,488,243,492,735
1000,482,525,502,240,506,746
1000,485,501,495,234,509,743
1000,504,529,476,283,456,739
1000,513,513,496,272,475,747
1000,513,486,519,256,500,756
1000,485,526,490,253,501,754
1000,487,507,471,245,494,739
1000,506,486,497,240,506,746
1000,513,518,482,262,483,745
1000,500,524,456,266,463,729
1000,484,530,488,268,474,742
1000,477,489,496,234,495,729
1000,494,509,498,247,500,747
1000,461,507,481,251,463,714
1000,511,508,525,256,511,767
1000,502,486,497,248,495,743
1000,490,499,507,241,495,736
1000,491,491,462,245,475,720
1000,499,479,492,230,528,758
1000,489,505,479,253,488,741
1000,493,488,511,235,511,746
1000,483,475,547,231,546,777
1000,493,502,484,250,492,742
1000,535,492,487,266,495,761
1000,486,492,490,240,486,726
1000,497,506,510,247,503,750
1000,485,515,508,245,498,743
1000,505,512,476,251,487,738
1000,482,525,499,255,488,743
1000,500,477,506,230,527,757
1000,459,513,531,228,520,748
1000,507,525,482,265,479,744
1000,487,515,498,242,506,748
1000,477,497,473,247,476,723
1000,506,485,507,246,518,764
1000,514,489,509,252,526,778
1000,505,521,488,271,483,754
1000,504,470,496,228,524,752
1000,519,484,506,247,500,747
1000,497,498,474,261,463,724
1000,485,491,527,232,521,753
1000,479,509,502,244,483,727
1000,533,509,521,271,508,779
1000,519,471,500,258,501,759
1000,519,470,504,239,530,769
1000,499,527,494,265,486,751
1000,491,486,495,252,496,748
1000,484,482,480,232,503,735
1000,486,489,498,232,502,734
1000,494,492,508,240,520,760
1000,486,494,520,250,517,767
1000,503,526,492,267,473,740
1000,503,530,488,259,491,750
1000,500,526,504,260,484,744
1000,500,529,487,256,485,741
1000,512,514,510,270,491,761
1000,503,506,489,261,476,737
1000,507,512,487,248,498,746
1000,486,505,516,245,504,749
1000,514,504,493,265,503,768
1000,495,481,520,232,523,755
1000,491,511,482,259,472,731
1000,511,510,509,257,514,771
1000,495,484,483,246,492,738
1000,514,499,508,259,490,749
1000,512,494,512,254,505,759
1000,484,523,488,253,478,731
1000,481,499,518,246,507,753
1000,504,477,501,249,508,757
1000,474,514,507,242,494,736
1000,472,500,476,228,504,732
1000,497,512,479,249,485,734
1000,536,526,485,290,480,770
1000,499,483,491,241,502,743
1000,484,489,513,237,510,747
1000,501,489,528,253,527,780
1000,507,498,518,236,522,758
1000,473,484,491,232,483,715
1000,508,507,519,247,520,767
1000,526,482,513,247,521,768
1000,498,499,497,240,505,745
1000,505,511,499,260,492,752
1000,460,506,494,239,496,735
1000,499,497,491,246,492,738
1000,525,477,501,262,491,753
1000,504,496,499,252,488,740
1000,531,515,478,282,474,756
1000,490,528,518,266,486,752
1000,511,515,506,275,486,761
1000,490,484,509,235,523,758
1000,473,508,495,236,495,731
1000,508,518,479,274,474,748
1000,515,515,493,250,510,760
1000,515,482,503,248,502,750
1000,522,471,473,250,486,736
1000,511,520,517,282,475,757
1000,521,541,513,289,471,760
1000,475,497,508,229,510,739
1000,490,511,490,257,485,742
1000,507,483,498,239,514,753
1000,530,503,509,273,492,765
1000,498,504,517,245,500,745
1000,465,509,486,232,498,730
1000,484,473,486,220,518,738
1000,507,488,491,238,515,753
1000,521,529,511,264,499,763
1000,516,505,483,265,481,746
1000,509,493,513,260,500,760
1000,491,481,468,232,493,725
1000,516,530,479,280,482,762
1000,494,484,515,232,512,744
1000,485,497,490,239,506,745
1000,501,483,495,250,506,756
1000,473,494,504,230,506,736
1000,502,502,483,244,496,740
1000,530,473,472,252,500,752
1000,490,482,513,246,506,752
1000,493,533,484,265,479,744
1000,497,483,480,230,506,736
1000,530,509,529,282,502,784
1000,477,520,500,243,506,749
1000,495,512,510,259,483,742
1000,511,531,495,283,469,752
1000,491,506,509,254,496,750
1000,499,517,485,263,481,744
1000,477,495,519,240,511,751
1000,508,497,491,250,501,751
1000,518,517,479,261,500,761
1000,502,480,494,249,507,756
1000,485,502,509,240,510,750
1000,499,497,492,239,502,741
1000,497,514,505,248,485,733
1000,514,495,515,247,506,753
1000,490,524,504,257,494,751
1000,496,517,508,256,488,744
1000,484,481,492,226,502,728
1000,488,503,497,243,505,748
1000,513,517,490,266,478,744
1000,484,480,496,225,505,730
1000,509,491,483,243,510,753
1000,509,503,487,260,482,742
1000,530,507,484,271,488,759
1000,477,506,517,226,526,752
1000,515,524,487,270,474,744
1000,504,493,514,260,488,748
1000,509,524,490,269,489,758
1000,515,486,504,270,483,753
1000,503,476,500,236,508,744
1000,517,521,478,274,476,750
1000,523,476,532,260,529,789
1000,497,523,488,256,501,757
1000,511,514,499,274,469,743
1000,497,495,513,236,517,753
1000,530,484,506,260,512,772
1000,508,526,519,269,502,771
1000,493,523,490,255,486,741
1000,508,516,512,267,509,776
1000,516,494,471,242,499,741
1000,492,510,488,247,481,728
1000,476,504,505,240,504,744
1000,533,495,473,267,487,754
1000,520,503,490,272,489,761
1000,508,499,484,248,506,754
1000,524,491,502,254,520,774
1000,512,511,479,260,489,749
1000,507,518,516,272,493,765
1000,513,517,515,268,502,770
1000,519,504,492,264,496,760
1000,534,486,500,259,506,765
1000,509,476,471,237,507,744
1000,528,491,487,257,510,767
1000,490,497,487,231,507,738
1000,489,495,482,250,480,730
1000,495,537,488,253,489,742
1000,516,504,459,262,483,745
1000,495,482,515,240,520,760
1000,517,515,498,261,504,765
1000,494,529,504,259,495,754
1000,487,527,510,249,499,748
1000,495,513,484,250,490,740
1000,480,485,511,214,540,754
1000,511,524,485,256,487,743
1000,479,506,496,244,488,732
1000,498,503,512,230,532,762
1000,514,478,475,257,492,749
1000,493,545,496,277,457,734
1000,493,519,490,264,482,746
1000,492,505,477,258,482,740
1000,481,503,498,239,489,728
1000,505,512,504,259,495,754
1000,477,511,489,235,480,715
1000,489,494,493,247,492,739
1000,507,506,498,255,494,749
1000,517,477,488,245,503,748
1000,490,511,514,258,508,766
1000,508,480,502,236,526,762
1000,515,483,491,232,526,758
1000,462,480,470,215,495,710
1000,527,492,504,267,498,765
1000,494,482,508,232,522,754
1000,520,498,516,259,515,774
1000,506,503,505,243,509,752
1000,501,492,529,258,513,771
1000,481,480,492,232,511,743
1000,517,526,491,270,499,769
1000,508,525,501,278,477,755
1000,488,504,504,238,504,742
1000,495,490,499,233,523,756
1000,534,508,500,277,486,763
1000,492,480,523,237,519,756
1000,496,516,509,249,511,760
1000,503,482,511,253,502,755
1000,495,524,509,253,498,751
1000,483,508,486,245,478,723
1000,491,512,510,247,521,768
1000,536,497,483,284,481,765
1000,512,499,496,261,492,753
1000,483,503,502,243,491,734
1000,488,478,509,236,501,737
1000,497,478,517,238,517,755
1000,514,503,485,258,485,743
1000,495,509,505,260,481,741
1000,507,513,518,265,505,770
1000,487,510,506,259,484,743
1000,509,501,482,257,476,733
1000,515,494,515,254,508,762
1000,502,481,501,237,510,747
1000,505,493,501,243,511,754
1000,503,502,478,250,498,748
1000,508,483,487,244,503,747
1000,511,529,492,274,476,750
1000,510,493,490,243,527,770
1000,461,524,506,230,497,727
1000,470,502,536,240,517,757
1000,497,493,483,255,483,738
1000,532,500,470,276,479,755
1000,507,467,500,229,521,750
1000,514,490,510,259,495,754
1000,487,497,509,242,506,748
1000,511,479,498,252,500,752
1000,502,506,479,245,498,743
1000,502,501,509,256,494,750
1000,507,477,511,245,517,762
1000,483,496,480,230,504,734
1000,507,485,506,251,516,767
1000,487,493,503,246,499,745
1000,495,469,486,214,529,743
1000,494,516,513,258,489,747
1000,492,505,512,242,492,734
1000,515,508,493,260,510,770
1000,523,498,475,267,483,750
1000,512,497,467,245,509,754
1000,506,508,513,254,511,765
1000,496,486,506,239,510,749
1000,496,502,479,257,468,725
1000,483,504,497,249,493,742
1000,474,509,495,245,489,734
1000,514,507,493,259,494,753
1000,473,476,492,212,534,746
1000,493,504,501,248,499,747
1000,501,498,501,252,507,759
1000,499,507,541,266,522,788
1000,509,502,503,250,509,759
1000,508,467,496,239,518,757
1000,513,484,533,250,517,767
1000,490,501,512,243,505,748
1000,493,525,490,253,505,758
1000,498,459,533,232,528,760
1000,497,498,499,248,491,739
1000,501,493,513,257,505,762
1000,485,502,485,240,501,741
1000,519,487,485,253,496,749
1000,496,476,512,240,509,749
1000,500,477,525,228,533,761
1000,507,500,474,246,501,747
1000,479,512,517,250,509,759
1000,492,495,523,247,521,768
1000,533,480,531,253,536,789
1000,517,490,517,255,521,776
1000,490,492,541,229,539,768
1000,514,496,515,271,500,771
1000,501,484,510,243,511,754
1000,510,519,530,260,502,762
1000,508,503,507,258,496,754
1000,495,473,486,220,515,735
1000,498,508,522,250,516,766
1000,512,518,482,274,480,754
1000,506,507,507,267,495,762
1000,493,507,503,234,518,752
1000,501,501,492,253,508,761
1000,509,466,478,240,497,737
1000,518,518,482,278,473,751
1000,511,508,506,262,486,748
1000,502,477,536,249,526,775
1000,484,489,505,238,505,743
1000,486,495,498,227,514,741
1000,507,493,508,248,507,755
1000,478,517,510,235,504,739
1000,484,511,517,245,514,759
1000,507,516,496,268,491,759
1000,489,483,465,242,481,723
1000,512,523,508,255,511,766
1000,489,521,494,265,477,742
1000,500,532,512,276,476,752
1000,515,491,496,253,500,753
1000,486,486,515,237,507,744
1000,465,500,495,242,489,731
1000,490,477,501,228,503,731
1000,488,516,503,265,473,738
1000,495,514,504,249,490,739
1000,475,500,530,243,510,753
1000,525,512,492,273,490,763
1000,506,522,534,263,513,776
1000,505,512,497,277,476,753
1000,528,502,503,275,489,764
1000,492,509,497,256,487,743
1000,478,523,472,259,458,717
1000,499,507,511,245,514,759
1000,485,488,472,236,490,726
1000,499,501,494,252,490,742
1000,500,487,495,240,514,754
1000,522,508,511,273,502,775
1000,485,479,504,232,509,741
1000,501,520,483,270,463,733
1000,503,503,480,255,494,749
1000,488,542,504,267,481,748
1000,494,510,502,247,504,751
1000,500,514,520,258,494,752
1000,492,528,518,249,495,744
1000,496,506,501,260,480,740
1000,494,485,530,238,524,762
1000,513,487,480,266,475,741
1000,491,482,494,245,492,737
1000,504,482,522,247,509,756
1000,490,491,513,240,515,755
1000,495,508,477,260,480,740
1000,469,503,492,237,503,740
1000,519,487,502,254,497,751
1000,485,506,518,233,515,748
1000,497,473,482,243,507,750
1000,481,496,490,234,513,747
1000,508,491,502,258,503,761
1000,499,493,496,246,509,755
1000,497,475,492,226,533,759
1000,495,487,497,249,510,759
1000,478,505,530,244,512,756
1000,525,471,516,258,508,766
1000,474,480,498,225,507,732
1000,499,517,521,251,509,760
1000,496,478,498,226,525,751
1000,516,489,511,252,503,755
1000,526,509,455,267,484,751
1000,532,499,505,279,490,769
1000,512,492,477,267,477,744
1000,477,515,488,245,506,751
1000,513,495,509,254,495,749
1000,494,500,492,250,496,746
1000,526,503,504,254,516,770
1000,502,514,493,252,497,749
1000,497,505,472,250,485,735
1000,477,520,501,250,478,728
1000,508,498,487,264,484,748
1000,471,506,489,242,495,737
1000,516,495,507,266,492,758
1000,525,520,511,278,479,757
1000,471,499,487,237,507,744
1000,465,488,493,219,504,723
1000,497,500,520,263,495,758
1000,521,526,507,289,475,764
1000,474,501,493,234,500,734
1000,500,508,494,259,490,749
1000,500,464,511,240,521,761
1000,485,515,520,249,502,751
1000,515,482,487,252,494,746
1000,515,509,495,256,494,750
1000,490,510,469,247,485,732
1000,483,482,496,232,513,745
1000,494,514,506,251,501,752
1000,511,488,519,242,527,769
1000,493,533,503,256,499,755
1000,508,487,479,248,484,732
1000,515,497,521,259,516,775
1000,512,494,510,238,507,745
1000,511,500,485,243,513,756
1000,486,511,520,248,524,772
1000,525,519,493,271,484,755
1000,511,489,499,243,510,753
1000,486,530,501,245,486,731
1000,476,509,522,247,516,763
1000,480,520,488,232,503,735
1000,518,551,492,270,496,766
1000,507,522,529,257,532,789
1000,509,514,505,269,495,764
1000,511,521,479,263,479,742
1000,527,486,508,260,498,758
1000,505,479,497,235,521,756
1000,503,493,484,250,491,741
1000,511,527,480,260,490,750
1000,516,489,504,257,499,756
1000,505,496,504,252,504,756
1000,509,505,509,264,492,756
1000,492,487,465,244,486,730
1000,515,499,523,266,499,765
1000,493,485,511,243,508,751
1000,521,499,496,256,496,752
1000,495,501,527,238,521,759
1000,488,517,517,269,467,736
1000,504,520,520,265,494,759
1000,498,496,487,257,487,744
1000,526,509,535,270,506,776
1000,507,485,473,247,488,735
1000,498,493,521,230,530,760
1000,491,508,492,246,510,756
1000,486,500,502,251,492,743
1000,488,496,481,246,470,716
1000,505,514,495,264,480,744
1000,482,501,508,232,509,741
1000,491,496,510,244,512,756
1000,511,497,499,266,491,757
1000,455,476,516,213,522,735
1000,490,514,514,243,520,763
1000,501,514,513,271,481,752
1000,491,481,509,227,532,759
1000,498,508,484,241,496,737
1000,519,511,499,272,481,753
1000,512,496,465,261,469,730
1000,494,511,499,265,489,754
1000,479,504,474,238,488,726
1000,530,506,505,276,474,750
1000,494,535,518,261,498,759
1000,484,499,491,234,511,745
1000,505,498,516,270,496,766
1000,511,514,505,259,495,754
1000,503,513,514,261,487,748
1000,492,500,503,239,510,749
1000,498,472,518,245,506,751
1000,484,532,483,255,470,725
1000,511,490,488,253,493,746
1000,504,485,524,254,502,756
1000,496,483,500,245,504,749
1000,507,492,505,240,513,753
1000,528,500,498,274,494,768
1000,505,495,480,249,500,749
1000,499,503,486,251,492,743
1000,492,508,502,254,498,752
1000,492,458,482,223,504,727
1000,521,492,491,260,505,765
1000,495,501,479,238,485,723
1000,521,515,468,266,469,735
1000,482,503,453,228,499,727
1000,499,501,493,256,489,745
1000,509,498,502,254,510,764
1000,511,513,537,267,507,774
1000,498,512,508,248,512,760
1000,500,513,504,262,499,761
1000,499,506,500,258,481,739
1000,498,467,513,234,516,750
1000,493,506,521,243,508,751
1000,487,509,499,256,496,752
1000,486,487,487,242,499,741
1000,508,526,518,272,491,763
1000,497,505,513,241,536,777
1000,519,495,517,246,515,761
1000,489,515,491,240,500,740
1000,497,487,506,255,492,747
1000,517,484,467,263,481,744
1000,487,479,494,256,491,747
1000,481,502,516,247,501,748
1000,483,533,488,270,464,734
1000,457,518,467,235,488,723
1000,504,498,505,248,514,762
1000,531,499,483,266,477,743
1000,529,501,514,274,500,774
1000,500,518,512,268,499,767
1000,497,499,496,249,498,747
1000,510,510,507,248,515,763
1000,502,510,491,246,501,747
1000,490,501,489,244,490,734
1000,475,502,499,240,497,737
1000,494,475,481,242,489,731
1000,520,515,501,268,492,760
1000,484,514,477,253,486,739
1000,530,494,497,264,489,753
1000,537,487,503,264,514,778
1000,503,522,492,262,480,742
1000,489,481,518,227,520,747
1000,495,502,510,247,499,746
1000,480,506,496,253,494,747
1000,491,476,504,232,517,749
1000,495,490,487,249,490,739
1000,516,477,488,255,499,754
1000,501,525,475,263,475,738
1000,496,516,500,251,490,741
1000,512,469,499,232,521,753
1000,468,477,498,229,501,730
1000,515,481,513,247,507,754
1000,489,541,515,258,510,768
1000,497,506,479,237,490,727
1000,517,479,501,254,496,750
1000,498,515,490,250,498,748
1000,497,498,511,246,511,757
1000,513,485,506,257,510,767
1000,482,501,501,238,511,749
1000,485,502,507,238,501,739
1000,494,510,505,237,521,758
1000,491,495,501,248,491,739
1000,497,474,518,245,497,742
1000,498,519,508,261,489,750
1000,522,510,505,264,493,757
1000,502,501,482,245,492,737
1000,508,500,499,255,512,767
1000,504,507,496,264,502,766
1000,487,512,499,250,490,740
1000,504,481,480,243,506,749
1000,497,497,497,261,489,750
1000,503,474,511,225,539,764
1000,481,491,499,245,499,744
1000,513,503,488,273,476,749
1000,518,529,473,282,491,773
1000,501,511,474,261,473,734
1000,514,519,482,280,471,751
1000,501,493,511,249,520,769
1000,499,476,464,247,484,731
1000,489,493,453,241,473,714
1000,531,466,532,240,538,778
1000,481,508,475,256,457,713
1000,518,505,501,280,483,763
1000,516,484,475,258,484,742
1000,491,492,509,266,474,740
1000,494,496,530,246,505,751
1000,506,492,487,251,498,749
1000,510,499,500,256,499,755
1000,483,494,502,228,508,736
1000,492,469,499,224,535,759
1000,508,506,512,264,489,753
1000,499,525,504,263,485,748
1000,496,521,476,255,474,729
1000,478,514,516,248,504,752
1000,509,496,506,255,487,742
1000,489,489,483,233,490,723
1000,500,504,505,257,488,745
1000,485,498,494,245,493,738
1000,489,500,515,240,515,755
1000,513,531,504,270,488,758
1000,508,482,516,237,518,755
1000,501,481,472,248,485,733
1000,536,500,522,276,508,784
1000,501,532,506,267,486,753
1000,517,539,524,288,476,764
1000,510,481,508,249,518,767
1000,496,500,509,263,494,757
1000,489,504,531,256,491,747
1000,486,509,514,253,499,752
1000,476,508,491,248,479,727
1000,510,524,479,269,483,752
1000,500,504,488,243,505,748
1000,501,476,539,243,521,764
1000,494,497,519,246,515,761
1000,520,502,526,260,498,758
1000,489,498,502,255,504,759
1000,493,495,490,255,477,732
1000,516,495,495,254,489,743
1000,488,509,495,252,491,743
1000,490,515,480,263,475,738
1000,508,490,481,247,495,742
1000,503,498,512,246,504,750
1000,529,515,497,272,484,756
1000,524,495,492,242,518,760
1000,507,513,499,262,492,754
1000,495,532,513,268,488,756
1000,502,498,467,241,489,730
1000,484,509,513,242,511,753
1000,500,471,525,221,536,757
1000,495,512,504,245,500,745
1000,528,535,509,299,476,775
1000,510,488,532,259,504,763
1000,489,474,494,228,512,740
1000,521,522,497,278,487,765
1000,498,494,479,241,488,729
1000,517,487,509,253,509,762
1000,465,515,515,232,508,740
1000,513,498,483,262,479,741
1000,498,511,498,262,480,742
1000,485,490,483,240,503,743
1000,498,466,493,222,531,753
1000,508,489,482,250,497,747
1000,507,518,521,272,491,763
1000,531,489,513,244,539,783
1000,511,508,507,258,515,773
1000,505,475,508,246,520,766
1000,497,501,496,247,481,728
1000,493,506,513,260,496,756
1000,509,496,511,255,516,771
1000,506,518,504,261,509,770
1000,470,500,489,247,483,730
1000,497,517,526,246,513,759
1000,502,480,492,232,515,747
1000,509,529,504,249,513,762
1000,485,493,490,230,514,744
1000,530,481,525,250,530,780
1000,483,516,522,252,496,748
1000,503,499,508,251,513,764
1000,530,477,501,248,531,779
1000,501,511,480,257,472,729
1000,499,467,496,228,533,761
1000,501,488,475,240,506,746
1000,503,517,488,250,495,745
1000,492,491,501,235,526,761
1000,493,509,522,260,494,754
1000,511,497,507,260,507,767
1000,519,478,493,246,520,766
1000,488,500,508,249,497,746
1000,505,485,477,243,504,747
1000,498,474,486,250,504,754
1000,490,489,522,247,512,759
1000,473,502,496,252,473,725
1000,498,525,485,261,488,749
1000,531,519,486,283,472,755
1000,492,514,527,249,501,750
1000,488,526,487,255,491,746
1000,501,531,497,258,486,744
1000,509,543,535,270,502,772
1000,502,536,532,267,507,774
1000,498,490,493,256,501,757
1000,482,485,513,245,499,744
1000,501,502,506,256,503,759
1000,515,492,524,244,519,763
1000,500,506,508,266,490,756
1000,500,492,495,249,505,754
1000,510,474,493,252,498,750
1000,491,497,488,252,479,731
1000,520,495,497,258,489,747
1000,479,510,522,251,483,734
1000,510,500,516,270,480,750
1000,484,483,486,244,497,741
1000,502,494,482,239,496,735
1000,479,531,491,269,478,747
1000,499,516,502,256,488,744
1000,503,493,495,242,501,743
1000,521,494,503,249,504,753
1000,491,549,504,274,462,736
1000,503,506,502,246,517,763
1000,484,486,499,243,498,741
1000,494,499,530,257,512,769
1000,515,469,506,247,513,760
1000,515,490,522,248,511,759
1000,520,521,506,273,502,775
1000,500,502,505,251,481,732
1000,512,471,505,245,503,748
1000,495,526,504,262,492,754
1000,502,491,466,234,497,731
1000,474,496,494,226,509,735
1000,500,513,489,251,483,734
1000,488,506,483,247,479,726
1000,513,504,510,265,492,757
1000,479,474,481,230,495,725
1000,510,500,498,253,519,772
1000,493,514,517,260,499,759
1000,497,497,508,261,495,756
1000,472,503,512,234,502,736
1000,496,507,542,253,509,762
1000,506,498,493,238,520,758
1000,456,504,499,232,497,729
1000,529,494,504,269,501,770
1000,484,513,492,268,473,741
1000,503,524,479,255,485,740
1000,505,505,515,248,510,758
1000,478,524,489,239,496,735
1000,514,499,521,269,500,769
1000,512,483,497,235,526,761
1000,497,491,521,248,502,750
1000,529,525,514,273,485,758
1000,519,480,512,269,494,763
1000,478,459,481,214,499,713
1000,499,472,485,234,504,738
1000,525,482,512,263,506,769
1000,466,493,529,229,519,748
1000,484,487,498,250,497,747
1000,520,492,498,248,505,753
1000,488,500,495,219,520,739
1000,524,496,513,259,511,770
1000,493,477,518,244,514,758
1000,513,504,491,259,487,746
1000,505,494,478,242,505,747
1000,484,502,495,249,494,743
1000,503,499,521,253,503,756
1000,466,497,518,241,505,746
1000,505,509,507,249,501,750
1000,494,484,531,244,532,776
1000,477,490,491,227,510,737
1000,486,506,508,248,484,732
1000,501,505,492,245,509,754
1000,518,515,502,264,505,769
1000,515,520,486,271,478,749
1000,528,498,485,256,497,753
1000,491,488,504,245,495,740
1000,487,532,484,246,493,739
1000,500,511,516,258,517,775
1000,481,489,498,234,506,740
1000,510,525,496,247,496,743
1000,463,503,505,241,492,733
1000,481,509,512,244,496,740
1000,495,487,500,241,493,734
1000,502,516,520,254,504,758
1000,505,516,511,261,491,752
1000,483,492,506,231,515,746
1000,503,534,509,272,483,755
1000,522,499,513,273,504,777
1000,486,481,507,227,526,753
1000,505,486,496,245,504,749
1000,494,505,502,258,499,757
1000,509,484,503,250,506,756
1000,484,471,491,234,499,733
1000,501,532,520,271,486,757
1000,515,505,488,256,488,744
1000,505,506,516,247,514,761
1000,499,488,491,241,491,732
1000,502,508,477,254,478,732
1000,512,499,516,248,513,761
1000,489,510,483,248,503,751
1000,482,524,509,248,499,747
1000,505,492,464,245,489,734
1000,493,498,512,243,497,740
1000,500,489,492,226,527,753
1000,517,484,497,257,496,753
1000,495,481,497,232,522,754
1000,527,491,506,265,514,779
1000,508,494,520,245,532,777
1000,481,518,496,262,484,746
1000,514,495,492,245,514,759
1000,506,504,467,254,480,734
1000,506,485,493,241,510,751
1000,527,503,490,263,507,770
1000,505,503,507,250,513,763
1000,517,500,475,263,484,747
1000,513,480,495,249,508,757
1000,502,512,506,249,505,754
1000,489,482,483,228,499,727
1000,513,507,493,267,479,746
1000,502,478,481,248,486,734
1000,506,497,485,257,498,755
1000,495,501,482,246,495,741
1000,488,502,511,241,502,743
1000,507,495,481,233,509,742
1000,473,493,502,231,513,744
1000,498,499,512,259,483,742
1000,494,488,486,239,494,733
1000,480,510,501,248,492,740
1000,489,519,492,256,478,734
1000,471,499,473,240,486,726
1000,495,496,496,258,481,739
1000,489,489,501,244,491,735
1000,502,492,499,254,507,761
1000,495,495,496,250,485,735
1000,474,518,500,255,481,736
1000,489,494,515,246,494,740
1000,521,474,504,240,516,756
1000,509,492,499,255,498,753
1000,509,508,495,263,485,748
1000,492,495,489,247,493,740
1000,505,497,501,251,489,740
1000,502,504,474,256,482,738
1000,473,488,529,223,530,753
1000,532,483,479,265,497,762
1000,502,508,495,254,502,756
1000,517,500,507,265,500,765
1000,510,499,472,260,482,742
1000,503,484,514,235,497,732
1000,481,485,493,241,498,739
1000,514,488,506,258,506,764
1000,521,503,519,266,506,772
1000,537,492,490,249,523,772
1000,493,498,526,246,503,749
1000,506,494,509,247,487,734
1000,516,493,504,261,502,763
1000,486,513,510,248,494,742
1000,489,485,500,253,506,759
1000,505,483,491,240,499,739
1000,472,490,498,226,523,749
1000,502,508,495,260,485,745
1000,520,512,494,271,481,752
1000,524,512,491,270,494,764
1000,527,511,501,277,484,761
1000,491,508,495,243,501,744
1000,532,521,483,267,491,758
1000,518,504,487,244,513,757
1000,498,510,517,250,506,756
1000,501,493,523,246,512,758
1000,514,526,490,263,494,757
1000,477,545,510,256,495,751
1000,486,495,512,254,500,754
1000,527,508,488,255,492,747
1000,539,484,482,260,497,757
1000,501,508,521,258,517,775
1000,489,507,507,245,504,749
1000,490,499,498,253,497,750
1000,513,489,531,252,517,769
1000,499,489,521,243,512,755
1000,496,489,500,240,506,746
1000,496,494,493,241,505,746
1000,498,485,497,243,499,742
1000,493,480,514,227,536,763
1000,501,510,501,246,511,757
1000,505,492,519,246,496,742
1000,506,519,512,268,490,758
1000,469,514,487,230,499,729
1000,480,501,494,235,509,744
1000,512,480,506,247,509,756
1000,496,505,508,267,493,760
1000,499,518,510,253,498,751
1000,517,497,524,265,494,759
1000,472,491,520,236,514,750
1000,502,519,497,253,505,758
1000,494,495,491,231,522,753
1000,485,499,528,246,520,766
1000,503,505,504,251,495,746
1000,505,513,502,261,501,762
1000,494,489,467,242,497,739
1000,498,512,487,276,465,741
1000,472,512,502,247,488,735
1000,476,473,521,218,524,742
1000,471,490,501,235,497,732
1000,484,494,525,247,515,762
1000,508,491,508,245,503,748
1000,521,469,463,243,499,742
1000,493,532,492,255,497,752
1000,487,499,528,250,492,742
1000,497,498,513,242,506,748
1000,474,480,513,225,519,744
1000,504,494,478,251,501,752
1000,502,490,516,245,508,753
1000,492,503,482,261,475,736
1000,494,499,496,248,497,745
1000,495,486,484,250,502,752
1000,520,509,479,272,471,743
1000,496,504,500,250,489,739
1000,519,510,484,261,487,748
1000,488,512,474,245,467,712
1000,485,495,481,249,482,731
1000,507,503,490,256,494,750
1000,520,506,501,257,515,772
1000,479,531,511,264,463,727
1000,472,485,496,231,510,741
1000,494,506,503,251,493,744
1000,512,515,504,265,481,746
1000,492,522,500,259,471,730
1000,499,508,491,258,478,736
1000,504,517,494,259,494,753
1000,513,508,487,271,466,737
1000,526,500,502,267,503,770
1000,490,525,512,258,505,763
1000,519,498,484,245,514,759
1000,518,497,492,267,500,767
1000,484,488,503,236,516,752
1000,508,499,521,262,506,768
1000,494,485,485,237,515,752
1000,522,533,499,283,497,780
1000,513,480,506,239,517,756
1000,514,496,506,243,517,760
1000,508,493,490,243,520,763
1000,489,502,501,235,518,753
1000,488,496,518,240,506,746
1000,510,489,512,244,507,751
1000,475,494,469,231,481,712
1000,516,490,510,251,500,751
1000,514,504,510,258,500,758
1000,513,490,480,263,496,759
1000,491,503,510,248,502,750
1000,496,508,470,267,460,727
1000,494,505,509,254,503,757
1000,492,496,492,243,486,729
1000,506,501,497,261,497,758
1000,518,507,490,272,499,771
1000,510,491,489,250,498,748
1000,520,464,475,250,490,740
1000,464,490,525,220,523,743
1000,516,490,521,251,513,764
1000,497,491,505,250,498,748
1000,513,484,487,248,506,754
1000,511,501,492,256,494,750
1000,491,501,488,234,501,735
1000,490,506,499,238,518,756
1000,507,509,485,251,492,743
1000,495,504,519,239,530,769
1000,508,540,501,286,485,771
1000,514,511,472,259,498,757
1000,485,504,527,238,515,753
1000,511,502,507,253,507,760
1000,506,535,506,267,484,751
1000,464,505,502,233,507,740
1000,476,466,501,241,501,742
1000,497,493,507,239,503,742
1000,495,509,489,243,509,752
1000,504,531,516,273,489,762
1000,515,494,518,267,508,775
1000,507,501,513,258,497,755
1000,497,516,509,258,494,752
1000,524,505,504,261,496,757
1000,490,492,497,235,512,747
1000,497,490,508,234,516,750
1000,498,522,531,257,514,771
1000,495,524,450,256,459,715
1000,486,512,477,251,486,737
1000,523,511,471,273,474,747
1000,507,510,478,256,490,746
1000,474,472,500,242,497,739
1000,484,481,488,233,505,738
1000,484,469,534,232,533,765
1000,497,487,502,225,535,760
1000,495,510,514,243,524,767
1000,489,494,519,235,516,751
1000,485,518,454,232,487,719
1000,471,521,514,250,479,729
1000,522,495,525,276,509,785
1000,493,520,482,269,473,742
1000,501,536,539,270,508,778
1000,508,515,518,261,500,761
1000,485,515,523,232,531,763
1000,496,505,498,257,480,737
1000,483,486,519,234,522,756
1000,503,515,498,250,492,742
1000,514,500,522,240,518,758
1000,478,521,511,263,487,750
1000,518,501,488,255,517,772
1000,510,506,496,270,477,747
1000,485,466,547,243,515,758
1000,505,479,509,249,506,755
1000,487,496,505,244,525,769
1000,486,508,489,247,495,742
1000,484,474,480,218,508,726
1000,493,511,505,249,520,769
1000,499,477,522,226,538,764
1000,533,491,487,252,504,756
1000,535,482,507,262,507,769
1000,511,513,522,272,505,777
1000,490,539,517,254,505,759
1000,493,516,537,243,526,769
1000,471,512,473,229,493,722
1000,497,500,477,253,500,753
1000,491,466,491,223,523,746
1000,496,493,511,258,500,758
1000,476,521,486,251,465,716
1000,514,489,508,249,509,758
1000,508,500,504,270,479,749
1000,491,514,514,258,502,760
1000,495,501,511,236,504,740
1000,522,511,494,255,499,754
1000,507,484,508,244,513,757
1000,503,519,519,258,496,754
1000,510,513,501,277,480,757
1000,480,488,505,229,519,748
1000,505,502,514,255,499,754
1000,510,516,503,258,499,757
1000,502,503,491,260,479,739
1000,509,522,524,259,509,768
1000,512,497,504,268,473,741
1000,481,503,492,245,503,748
1000,482,475,517,228,539,767
1000,507,516,504,267,488,755
1000,503,503,499,264,494,758
1000,475,527,499,261,469,730
1000,491,514,519,246,514,760
1000,485,479,493,240,496,736
1000,500,513,503,266,489,755
1000,521,494,493,265,485,750
1000,497,526,515,265,486,751
1000,481,516,514,245,502,747
1000,513,507,503,257,513,770
1000,483,488,498,236,512,748
1000,480,486,500,240,511,751
1000,502,488,479,246,496,742
1000,525,503,499,264,487,751
1000,496,510,492,259,479,738
1000,507,497,489,259,481,740
1000,487,487,515,222,531,753
1000,498,505,531,262,497,759
1000,488,497,512,245,499,744
1000,506,508,495,251,496,747
1000,488,505,509,235,515,750
1000,483,511,525,241,499,740
1000,483,503,488,239,499,738
1000,513,501,507,248,508,756
1000,490,514,489,253,489,742
1000,491,500,522,248,507,755
1000,474,491,515,233,513,746
1000,501,519,532,257,505,762
1000,493,508,501,250,483,733
1000,483,501,524,242,512,754
1000,469,511,480,240,484,724
1000,483,500,485,244,493,737
1000,498,501,504,231,533,764
1000,494,516,507,250,507,757
1000,515,511,471,251,488,739
1000,504,466,499,240,514,754
1000,497,506,494,251,483,734
1000,503,510,500,252,481,733
1000,511,518,490,257,499,756
1000,506,500,513,264,479,743
1000,499,512,490,258,483,741
1000,512,484,512,251,512,763
1000,500,507,472,259,470,729
1000,480,507,543,243,514,757
1000,483,495,515,238,512,750
1000,465,492,514,225,505,730
1000,486,502,507,232,516,748
1000,514,486,515,251,507,758
1000,479,512,502,238,504,742
1000,482,479,474,249,490,739
1000,503,474,494,232,517,749
1000,503,484,496,236,504,740
1000,504,504,503,263,480,743
1000,509,508,487,252,498,750
1000,490,506,473,238,480,718
1000,499,487,467,245,491,736
1000,542,505,508,265,513,778
1000,516,498,470,259,468,727
1000,494,534,467,261,463,724
1000,499,501,464,239,493,732
1000,469,543,496,259,480,739
1000,481,512,487,246,484,730
1000,487,512,473,254,499,753
1000,504,505,519,269,484,753
1000,506,500,525,262,504,766
1000,506,508,516,238,522,760
1000,473,488,502,244,500,744
1000,469,478,496,228,504,732
1000,501,498,516,240,529,769
1000,502,480,492,228,525,753
1000,485,503,497,230,499,729
1000,517,537,512,275,495,770
1000,492,489,523,241,520,761
1000,509,528,495,267,476,743
1000,479,509,496,245,493,738
1000,482,490,519,246,498,744
1000,479,487,495,240,508,748
1000,486,517,506,250,501,751
1000,473,507,514,245,494,739
1000,483,489,523,234,517,751
1000,531,509,522,277,491,768
1000,484,498,498,255,477,732
1000,512,492,487,252,501,753
1000,500,517,489,254,501,755
1000,469,502,515,235,523,758
1000,485,501,495,237,504,741
1000,474,541,495,262,478,740
1000,481,502,496,235,499,734
1000,498,525,521,254,505,759
1000,513,483,502,254,511,765
1000,502,486,513,238,514,752
1000,505,524,486,266,493,759
1000,496,512,490,244,493,737
1000,498,517,541,262,504,766
1000,533,492,500,263,516,779
1000,509,481,484,255,493,748
1000,519,488,517,253,498,751
1000,491,507,496,242,507,749
1000,503,504,493,244,505,749
1000,485,511,490,237,513,750
1000,509,505,500,242,508,750
1000,500,477,480,243,495,738
1000,504,508,527,248,507,755
1000,483,515,485,254,467,721
1000,516,511,483,259,503,762
1000,506,515,513,249,523,772
1000,492,512,488,260,483,743
1000,501,480,497,244,491,735
1000,495,476,495,230,513,743
1000,484,509,482,251,473,724
1000,488,501,498,239,494,733
1000,525,523,484,275,475,750
1000,507,484,512,248,515,763
1000,480,487,492,224,503,727
1000,473,512,508,257,486,743
1000,524,489,477,265,488,753
1000,500,507,512,250,501,751
1000,498,512,465,232,469,701
1000,507,530,492,277,471,748
1000,489,517,508,241,515,756
1000,516,517,493,269,501,770
1000,481,522,515,252,496,748
1000,514,489,503,254,520,774
1000,515,482,502,248,519,767
1000,510,517,508,277,485,762
1000,507,505,501,261,498,759
1000,491,515,494,247,492,739
1000,523,523,504,271,490,761
1000,515,489,506,266,503,769
1000,520,509,510,269,514,783
1000,514,502,540,262,503,765
1000,499,488,504,240,519,759
1000,501,520,499,265,487,752
1000,475,458,469,210,485,695
1000,475,519,497,244,499,743
1000,515,497,524,274,502,776
1000,482,501,493,237,496,733
1000,465,526,507,238,488,726
1000,501,500,488,263,483,746
1000,495,504,511,240,514,754
1000,527,487,498,246,514,760
1000,493,501,511,246,525,771
1000,500,485,505,246,506,752
1000,513,505,511,264,510,774
1000,488,493,502,258,491,749
1000,508,498,490,238,519,757
1000,504,499,530,251,507,758
1000,501,503,497,247,506,753
1000,499,502,496,242,507,749
1000,514,464,524,248,538,786
1000,509,529,479,267,478,745
1000,500,511,504,254,503,757
1000,497,546,495,276,484,760
1000,511,488,507,244,522,766
1000,514,511,478,264,478,742
1000,493,516,485,250,503,753
1000,513,533,453,273,452,725
1000,500,501,489,246,510,756
1000,504,500,521,248,516,764
1000,490,499,513,239,505,744
1000,518,532,529,293,486,779
1000,504,498,508,257,500,757
1000,483,491,485,243,488,731
1000,512,492,508,256,506,762
1000,493,479,500,233,519,752
1000,491,505,505,253,483,736
1000,519,488,497,251,507,758
1000,535,534,496,298,475,773
1000,520,465,516,248,514,762
1000,517,507,491,268,490,758
1000,492,525,495,252,478,730
1000,506,487,526,259,507,766
1000,528,487,476,264,478,742
1000,497,478,491,234,514,748
1000,490,508,507,246,496,742
1000,525,497,508,264,502,766
1000,536,517,507,280,480,760
1000,508,476,516,247,526,773
1000,470,519,497,250,479,729
1000,493,504,534,248,519,767
1000,477,521,488,249,496,745
1000,513,507,502,257,509,766
1000,511,477,519,236,545,781
1000,509,494,495,263,481,744
1000,503,489,497,243,500,743
1000,506,515,511,269,501,770
1000,522,500,508,274,478,752
1000,502,511,483,258,476,734
1000,519,484,500,251,517,768
1000,511,487,489,249,503,752
1000,486,529,500,253,479,732
1000,483,498,495,252,481,733
1000,509,527,521,266,507,773
1000,496,467,522,220,544,764
1000,489,508,515,262,489,751
1000,497,515,480,255,490,745
1000,517,527,547,277,507,784
1000,494,517,500,261,491,752
1000,515,501,512,274,490,764
1000,492,513,493,253,475,728
1000,503,481,502,235,517,752
1000,496,478,491,242,507,749
1000,490,521,485,246,501,747
1000,518,471,507,254,504,758
1000,485,486,484,237,503,740
1000,509,490,507,254,511,765
1000,476,495,505,241,497,738
1000,470,474,504,219,527,746
1000,483,508,515,255,497,752
1000,517,492,497,248,507,755
1000,481,504,515,248,494,742
1000,510,518,475,278,461,739
1000,502,495,502,256,489,745
1000,495,520,461,257,468,725
1000,509,511,500,263,492,755
1000,502,482,480,249,506,755
1000,524,481,506,258,503,761
1000,477,496,489,237,480,717
1000,527,492,493,272,489,761
1000,496,515,500,251,497,748
1000,492,516,501,251,494,745
1000,531,502,502,274,476,750
1000,484,512,518,247,501,748
1000,493,489,524,240,524,764
1000,508,493,521,253,518,771
1000,502,509,497,256,502,758
1000,504,496,503,245,497,742
1000,491,495,476,258,477,735
1000,521,485,480,242,515,757
1000,489,502,513,241,511,752
1000,516,510,493,253,502,755
1000,492,522,489,255,485,740
1000,491,506,515,255,491,746
1000,516,530,498,277,482,759
1000,502,469,533,230,534,764
1000,481,506,480,237,506,743
1000,480,500,517,240,503,743
1000,496,502,511,249,498,747
1000,523,482,506,256,511,767
1000,518,506,481,252,489,741
1000,493,491,523,235,537,772
1000,497,507,503,240,508,748
1000,480,488,522,236,535,771
1000,526,486,505,264,506,770
1000,507,495,511,245,518,763
1000,498,498,508,247,505,752
1000,489,463,514,216,544,760
1000,519,495,502,259,498,757
1000,481,503,495,235,506,741
1000,507,460,512,226,527,753
1000,502,500,504,254,505,759
1000,528,495,522,254,523,777
1000,519,502,513,266,501,767
1000,504,513,484,260,479,739
1000,509,506,519,242,511,753
1000,467,536,504,253,473,726
1000,494,517,502,268,479,747
1000,525,504,489,272,492,764
1000,503,495,509,255,510,765
1000,491,528,508,267,494,761
1000,502,521,517,237,517,754
1000,497,493,526,227,535,762
1000,482,521,508,246,490,736
1000,495,505,489,255,489,744
1000,469,495,487,229,485,714
1000,507,530,502,264,503,767
1000,502,523,483,271,476,747
1000,494,516,510,255,497,752
1000,488,519,546,249,521,770
1000,483,493,487,235,509,744
1000,447,491,506,208,510,718
1000,488,490,505,223,519,742
1000,525,472,491,259,501,760
1000,477,488,514,245,502,747
1000,512,503,522,259,499,758
1000,491,472,512,220,534,754
1000,491,499,508,240,505,745
1000,506,499,482,255,485,740
1000,491,515,515,254,489,743
1000,488,492,520,234,518,752
1000,515,514,510,269,500,769
1000,516,486,499,250,517,767
1000,522,499,497,265,499,764
1000,489,528,469,270,450,720
1000,506,506,479,246,497,743
1000,489,501,494,254,490,744
1000,511,489,511,239,516,755
1000,496,508,487,255,483,738
1000,522,497,499,259,508,767
1000,528,496,500,261,508,769
1000,518,493,502,245,506,751
1000,505,485,505,237,525,762
1000,498,528,499,261,484,745
1000,527,499,507,254,522,776
1000,523,507,520,257,501,758
1000,512,518,523,268,487,755
1000,522,492,505,256,511,767
1000,498,517,502,266,486,752
1000,498,481,498,242,510,752
1000,475,487,501,216,537,753
1000,490,492,510,232,515,747
1000,483,509,500,248,493,741
1000,528,489,499,264,500,764
1000,504,493,516,253,498,751
1000,500,512,502,264,481,745
1000,475,514,492,248,489,737
1000,482,514,473,243,493,736
1000,488,520,499,248,498,746
1000,501,515,476,264,471,735
1000,519,506,507,262,508,770
1000,533,513,503,277,481,758
1000,493,506,522,257,512,769
1000,506,506,485,252,489,741
1000,507,514,532,253,509,762
1000,535,484,516,250,534,784
1000,502,482,494,237,500,737
1000,504,470,510,248,520,768
1000,496,483,505,252,506,758
1000,516,506,507,257,513,770
1000,519,482,483,261,487,748
1000,484,521,504,257,466,723
1000,477,492,504,234,529,763
1000,482,462,504,219,527,746
1000,491,488,494,249,487,736
1000,523,500,490,272,472,744
1000,484,488,487,232,501,733
1000,500,525,531,265,500,765
1000,497,487,514,243,500,743
1000,475,477,497,219,525,744
1000,503,499,501,255,495,750
1000,495,514,478,260,488,748
1000,502,508,510,259,508,767
1000,505,517,510,254,507,761
1000,491,510,530,254,518,772
1000,499,497,495,242,505,747
1000,515,509,513,270,491,761
1000,463,480,501,216,514,730
1000,532,472,513,236,534,770
1000,494,520,486,248,502,750
1000,512,484,491,246,511,757
1000,478,503,485,242,480,722
1000,508,491,512,253,502,755
1000,478,488,526,246,506,752
1000,514,496,504,261,494,755
1000,479,474,485,216,527,743
1000,479,508,502,242,500,742
1000,498,483,507,231,514,745
1000,495,477,493,227,527,754
1000,524,516,496,274,497,771
1000,489,532,506,260,488,748
1000,526,494,509,273,497,770
1000,502,496,510,258,498,756
1000,514,518,511,277,475,752
1000,506,495,499,265,490,755
1000,523,490,490,262,502,764
1000,524,499,467,265,484,749
1000,504,497,479,233,512,745
1000,500,491,507,238,511,749
1000,505,484,502,243,502,745
1000,483,510,509,254,497,751
1000,500,484,481,244,492,736
1000,553,517,508,286,500,786
1000,485,488,497,251,484,735
1000,498,494,504,250,490,740
1000,496,513,493,256,490,746
1000,475,486,523,237,507,744
1000,508,502,503,254,498,752
1000,501,489,470,240,512,752
1000,496,517,504,246,496,742
1000,473,491,483,235,505,740
1000,515,494,494,249,507,756
1000,521,486,535,247,530,777
1000,513,497,478,248,495,743
1000,518,501,504,265,497,762
1000,507,503,513,249,523,772
1000,511,495,537,252,522,774
1000,495,501,481,255,479,734
1000,496,474,481,235,494,729
1000,523,497,491,261,495,756
1000,497,492,503,251,505,756
1000,507,471,457,218,513,731
1000,509,512,508,273,491,764
1000,504,506,490,264,485,749
1000,498,502,470,239,492,731
1000,478,499,489,228,513,741
1000,511,437,495,213,543,756
1000,477,502,472,240,485,725
1000,514,471,498,238,529,767
1000,515,511,503,265,501,766
1000,542,506,504,264,502,766
1000,493,515,521,254,504,758
1000,521,500,506,253,513,766
1000,493,519,500,270,490,760
1000,495,506,516,252,503,755
1000,502,494,504,257,494,751
1000,488,473,461,232,482,714
1000,473,500,532,230,523,753
1000,504,478,508,251,519,770
1000,510,490,514,255,509,764
1000,523,495,522,248,525,773
1000,489,484,495,254,487,741
1000,491,507,481,256,485,741
1000,511,488,507,240,515,755
1000,466,488,514,224,516,740
1000,488,501,515,261,501,762
1000,513,487,509,258,500,758
1000,485,506,502,241,503,744
1000,505,507,530,247,537,784
1000,494,477,514,238,510,748
1000,505,507,497,250,505,755
1000,504,503,501,261,496,757
1000,470,506,513,228,517,745
1000,493,520,479,252,470,722
1000,529,506,477,272,482,754
1000,520,513,479,274,471,745
1000,526,517,501,282,475,757
1000,487,506,509,264,496,760
1000,527,481,472,259,496,755
1000,498,495,476,239,481,720
1000,498,474,515,249,507,756
1000,512,510,480,253,502,755
1000,484,471,554,234,537,771
1000,503,511,489,250,493,743
1000,534,519,490,275,491,766
1000,477,524,492,267,473,740
1000,511,505,525,259,501,760
1000,490,505,526,255,497,752
1000,493,523,514,265,484,749
1000,507,534,478,274,455,729
1000,497,488,511,239,516,755
1000,502,522,499,276,469,745
1000,493,499,492,259,472,731
1000,498,496,505,249,497,746
1000,520,498,491,259,490,749
1000,502,482,530,243,524,767
1000,500,492,523,252,517,769
1000,499,498,497,234,513,747
1000,509,501,488,255,485,740
1000,510,515,533,251,531,782
1000,545,483,516,267,528,795
1000,526,509,499,268,481,749
1000,493,518,524,248,503,751
1000,525,507,511,262,499,761
1000,497,483,499,230,513,743
1000,537,520,510,283,488,771
1000,493,509,486,264,474,738
1000,480,496,481,231,510,741
1000,517,501,503,261,499,760
1000,485,498,495,242,505,747
1000,508,525,490,264,494,758
1000,484,476,487,234,497,731
1000,479,539,490,260,476,736
1000,502,511,500,256,481,737
1000,495,494,485,251,493,744
1000,527,515,504,263,510,773
1000,487,512,508,246,502,748
1000,525,501,508,280,492,772
1000,518,510,495,257,497,754
1000,489,520,498,257,480,737
1000,518,503,503,254,503,757
1000,493,463,510,230,524,754
1000,507,479,520,232,524,756
1000,504,538,490,266,470,736
1000,508,488,511,248,511,759
1000,497,475,488,240,496,736
1000,522,490,494,266,491,757
1000,493,503,476,243,482,725
1000,510,525,506,265,486,751
1000,478,456,440,228,459,687
1000,479,519,542,251,507,758
1000,498,505,512,252,506,758
1000,504,539,486,259,496,755
1000,481,497,489,241,507,748
1000,502,517,519,261,507,768
1000,508,496,516,252,504,756
1000,506,510,519,256,503,759
1000,495,489,490,239,509,748
1000,526,519,475,277,474,751
1000,507,488,489,235,495,730
1000,496,500,492,249,497,746
1000,464,494,518,230,516,746
1000,477,507,497,264,467,731
1000,523,489,518,256,513,769
1000,495,506,500,242,509,751
1000,507,479,495,248,500,748
1000,486,503,489,244,502,746
1000,497,502,504,241,518,759
1000,486,518,515,243,512,755
1000,492,521,499,244,502,746
1000,492,540,498,266,476,742
1000,499,504,469,270,472,742
1000,487,508,505,252,479,731
1000,497,521,496,248,478,726
1000,513,485,490,257,498,755
1000,493,499,506,245,502,747
1000,518,495,502,246,521,767
1000,524,507,511,268,496,764
1000,485,470,507,234,504,738
1000,486,510,484,253,474,727
1000,518,496,512,258,500,758
1000,509,502,520,266,500,766
1000,509,518,510,284,473,757
1000,508,482,506,239,520,759
1000,535,493,473,276,489,765
1000,513,485,520,250,504,754
1000,500,497,486,245,492,737
1000,484,506,503,239,521,760
1000,533,501,502,294,479,773
1000,501,497,532,242,522,764
1000,486,510,529,247,500,747
1000,501,476,513,238,526,764
1000,507,497,486,250,495,745
1000,510,492,502,245,504,749
1000,524,479,484,246,523,769
1000,491,483,498,226,517,743
1000,486,504,529,260,496,756
1000,483,495,504,248,496,744
1000,491,498,505,248,492,740
1000,491,479,503,244,511,755
1000,456,485,503,224,505,729
1000,498,494,494,250,493,743
1000,492,513,517,252,491,743
1000,514,500,478,253,493,746
1000,482,507,499,248,500,748
1000,475,515,494,240,489,729
1000,494,506,480,248,486,734
1000,502,488,474,242,501,743
1000,519,494,488,241,522,763
1000,513,485,488,245,498,743
1000,500,503,483,254,498,752
1000,487,520,512,255,490,745
1000,523,486,516,273,496,769
1000,498,509,509,265,489,754
1000,516,500,538,248,523,771
1000,486,525,496,252,483,735
1000,500,487,516,236,525,761
1000,495,512,506,254,495,749
1000,536,499,490,254,512,766
1000,469,482,521,242,511,753
1000,509,489,519,239,514,753
1000,496,502,518,248,503,751
1000,497,484,527,231,532,763
1000,510,509,501,266,480,746
1000,523,499,510,274,494,768
1000,491,511,493,245,491,736
1000,528,487,486,251,515,766
1000,489,506,505,258,486,744
1000,522,485,487,260,477,737
1000,473,519,498,248,483,731
1000,529,507,491,263,496,759
1000,523,478,498,252,506,758
1000,510,506,456,246,485,731
1000,498,506,498,228,517,745
1000,472,505,514,233,518,751
1000,518,499,480,246,498,744
1000,507,497,494,262,490,752
1000,483,507,520,259,494,753
1000,523,487,488,244,498,742
1000,517,485,524,243,517,760
1000,488,496,500,242,520,762
1000,469,504,499,238,490,728
1000,510,498,518,254,509,763
1000,507,505,497,236,517,753
1000,513,506,508,254,516,770
1000,518,473,490,238,505,743
1000,510,473,491,235,513,748
1000,509,484,497,236,510,746
1000,493,514,493,249,484,733
1000,480,488,471,228,503,731
1000,487,499,482,257,479,736
1000,502,546,512,264,492,756
1000,501,526,485,263,465,728
1000,505,484,487,252,479,731
1000,520,479,522,245,518,763
1000,509,511,524,262,501,763
1000,507,512,504,266,492,758
1000,495,510,493,242,509,751
1000,488,475,495,232,506,738
1000,513,516,494,267,501,768
1000,517,504,514,261,503,764
1000,486,499,521,243,515,758
1000,514,473,469,252,489,741
1000,495,504,481,257,475,732
1000,516,530,485,287,456,743
1000,520,509,493,261,490,751
1000,500,483,522,244,514,758
1000,506,504,498,256,499,755
1000,506,465,510,231,521,752
1000,460,505,536,221,530,751
1000,510,513,500,264,497,761
1000,498,489,469,231,499,730
1000,505,499,494,243,511,754
1000,518,505,508,252,517,769
1000,466,499,486,230,491,721
1000,490,462,522,232,525,757
1000,526,486,513,250,519,769
1000,508,456,482,225,518,743
1000,485,488,493,252,489,741
1000,513,485,524,249,509,758
1000,495,496,501,249,503,752
1000,497,507,483,241,478,719
1000,492,510,506,258,504,762
1000,482,505,508,232,523,755
1000,510,495,517,252,519,771
1000,496,509,494,243,495,738
1000,494,508,497,254,494,748
1000,495,478,491,239,499,738
1000,493,502,507,238,514,752
1000,522,513,505,276,483,759
1000,479,504,491,231,512,743
1000,511,532,516,285,475,760
1000,491,506,507,253,498,751
1000,471,505,503,230,508,738
1000,520,480,484,260,472,732
1000,508,489,509,255,505,760
1000,480,528,530,261,493,754
1000,481,513,496,262,471,733
1000,485,484,486,241,492,733
1000,481,473,530,235,529,764
1000,501,517,485,265,464,729
1000,494,540,493,260,494,754
1000,509,492,495,265,478,743
1000,460,501,498,239,490,729
1000,518,485,500,236,524,760
1000,533,482,500,262,506,768
1000,489,514,523,240,514,754
1000,512,484,485,259,504,763
1000,491,478,497,230,528,758
1000,517,522,517,274,500,774
1000,499,492,499,240,501,741
1000,511,482,504,238,521,759
1000,523,509,502,275,491,766
1000,501,487,531,245,514,759
1000,532,502,508,255,514,769
1000,487,491,490,242,494,736
1000,506,503,502,258,505,763
1000,506,525,508,256,506,762
1000,512,491,515,253,496,749
1000,489,496,537,234,536,770
1000,487,503,518,246,506,752
1000,511,510,504,259,503,762
1000,475,482,494,233,498,731
1000,480,505,477,241,497,738
1000,516,534,510,262,491,753
1000,502,485,498,222,520,742
1000,494,472,505,233,507,740
1000,513,503,498,265,488,753
1000,497,497,504,251,503,754
1000,502,531,496,265,488,753
1000,506,514,524,258,503,761
1000,509,495,493,255,503,758
1000,511,481,499,239,516,755
1000,511,492,500,262,481,743
1000,483,508,526,249,498,747
1000,494,492,487,244,515,759
1000,524,508,494,263,496,759
1000,458,474,512,205,541,746
1000,483,511,473,252,469,721
1000,512,479,490,246,493,739
1000,493,478,494,237,512,749
1000,505,524,491,277,471,748
1000,482,524,511,235,534,769
1000,510,506,503,258,510,768
1000,487,477,527,238,526,764
1000,507,529,503,268,485,753
1000,510,509,530,264,502,766
1000,512,522,503,263,498,761
1000,488,481,538,241,522,763
1000,477,495,512,225,509,734
1000,493,534,518,258,494,752
1000,508,493,504,262,478,740
1000,524,487,524,251,522,773
1000,536,497,505,277,505,782
1000,491,507,495,239,511,750
1000,524,490,471,248,488,736
1000,491,510,491,250,491,741
1000,489,508,518,252,507,759
1000,508,503,520,259,503,762
1000,499,485,491,231,511,742
1000,505,512,499,268,496,764
1000,515,490,469,247,499,746
1000,498,483,491,239,493,732
1000,486,520,484,260,470,730
1000,496,494,515,243,508,751
1000,484,498,488,236,501,737
1000,508,520,501,267,488,755
1000,528,523,502,292,477,769
1000,481,514,502,243,507,750
1000,520,509,475,273,474,747
1000,495,493,505,233,525,758
1000,502,526,493,267,479,746
1000,484,487,505,230,512,742
1000,507,506,485,256,496,752
1000,517,473,521,235,520,755
1000,488,503,493,262,479,741
1000,485,514,491,256,471,727
1000,500,503,495,251,509,760
1000,494,510,504,234,514,748
1000,484,516,505,253,509,762
1000,514,474,514,246,512,758
1000,505,498,509,246,512,758
1000,478,513,492,247,500,747
1000,520,473,513,245,514,759
1000,485,488,497,236,498,734
1000,508,502,508,267,502,769
1000,492,546,482,267,464,731
1000,478,481,519,219,521,740
1000,505,495,508,252,499,751
1000,500,485,513,257,499,756
1000,510,513,475,256,492,748
1000,515,477,475,237,526,763
1000,501,537,512,268,474,742
1000,474,488,513,245,518,763
1000,496,485,490,244,503,747
1000,543,506,499,270,498,768
1000,518,512,485,250,505,755
1000,467,520,479,244,479,723
1000,500,499,486,245,499,744
1000,495,490,521,256,501,757
1000,488,500,526,242,518,760
1000,521,498,521,261,515,776
1000,490,476,510,220,521,741
1000,497,498,512,237,525,762
1000,519,465,490,240,519,759
1000,493,483,509,240,511,751
1000,498,531,521,262,508,770
1000,502,508,488,263,482,745
1000,485,488,506,228,511,739
1000,497,488,509,236,504,740
1000,508,480,492,233,529,762
1000,513,521,516,270,491,761
1000,503,517,520,271,494,765
1000,498,509,528,245,514,759
1000,484,504,494,245,492,737
1000,495,503,492,252,484,736
1000,487,482,479,237,501,738
1000,500,522,537,283,499,782
1000,500,491,484,256,474,730
1000,518,505,501,258,520,778
1000,484,483,502,238,495,733
1000,491,486,490,227,516,743
1000,495,503,511,245,517,762
1000,488,485,530,231,536,767
1000,513,488,496,251,497,748
1000,484,501,522,237,521,758
1000,535,506,557,267,526,793
1000,477,512,494,248,484,732
1000,491,510,493,242,486,728
1000,520,504,491,269,504,773
1000,532,515,490,273,496,769
1000,492,513,494,264,474,738
1000,507,488,502,243,513,756
1000,514,526,519,262,500,762
1000,517,491,465,236,497,733
1000,503,507,521,254,520,774
1000,508,484,535,260,499,759
1000,506,508,513,263,477,740
1000,495,484,516,235,502,737
1000,460,509,505,222,512,734
1000,500,540,505,270,482,752
1000,500,524,504,255,495,750
1000,493,500,486,245,495,740
1000,497,492,514,252,491,743
1000,515,533,518,272,501,773
1000,492,494,499,249,510,759
1000,486,478,477,237,477,714
1000,503,485,530,234,525,759
1000,505,500,494,241,502,743
1000,514,483,513,249,525,774
1000,490,508,507,244,497,741
1000,512,490,521,251,509,760
1000,548,518,503,268,505,773
1000,479,520,507,242,509,751
1000,490,493,519,242,501,743
1000,518,472,512,245,520,765
1000,471,480,515,240,513,753
1000,483,509,464,240,489,729
1000,525,495,532,262,516,778
1000,492,479,496,247,509,756
1000,508,484,494,258,488,746
1000,500,502,481,253,491,744
1000,503,486,509,237,509,746
1000,509,517,495,251,511,762
1000,505,505,501,252,503,755
1000,508,515,484,240,509,749
1000,491,515,483,251,489,740
1000,506,493,488,259,481,740
1000,481,495,493,244,488,732
1000,491,477,501,243,516,759
1000,479,495,510,231,509,740
1000,500,481,508,231,532,763
1000,481,511,527,244,510,754
1000,450,502,498,226,500,726
1000,502,528,494,276,475,751
1000,498,508,496,244,500,744
1000,499,515,509,261,487,748
1000,510,494,486,251,490,741
1000,516,479,502,234,512,746
1000,503,509,492,257,491,748
1000,496,515,485,246,490,736
1000,484,479,528,230,521,751
1000,486,496,511,260,501,761
1000,514,520,496,265,499,764
1000,498,507,520,250,507,757
1000,510,475,510,248,498,746
1000,479,515,492,255,485,740
1000,524,499,508,261,509,770
1000,490,498,496,258,491,749
1000,501,513,519,275,484,759
1000,479,534,495,262,471,733
1000,486,471,487,240,505,745
1000,498,495,476,243,480,723
1000,519,490,488,255,503,758
1000,526,488,506,271,497,768
1000,496,488,516,230,521,751
1000,488,528,487,252,487,739
1000,484,504,505,255,483,738
1000,489,474,484,232,511,743
1000,510,499,485,248,502,750
1000,515,518,488,274,466,740
1000,523,503,506,254,506,760
1000,511,497,515,252,510,762
1000,494,506,510,245,497,742
1000,511,522,531,268,484,752
1000,467,506,512,232,510,742
1000,475,462,492,220,506,726
1000,508,501,521,255,515,770
1000,529,494,492,267,485,752
1000,498,496,504,255,495,750
1000,517,503,495,254,502,756
1000,495,505,487,266,483,749
1000,511,509,462,267,471,738
1000,484,496,504,249,497,746
1000,479,510,504,242,505,747
1000,533,494,508,250,506,756
1000,464,491,467,231,475,706
1000,500,507,487,249,502,751
1000,502,508,508,267,490,757
1000,488,498,497,244,503,747
1000,533,516,506,282,484,766
1000,500,536,513,271,501,772
1000,502,484,508,256,499,755
1000,474,535,525,242,514,756
1000,512,509,497,278,472,750
1000,505,480,483,247,490,737
1000,472,513,499,247,491,738
1000,500,522,467,275,450,725
1000,491,489,512,251,518,769
1000,493,491,515,236,522,758
1000,495,514,491,248,501,749
1000,480,512,495,248,488,736
1000,480,528,508,263,480,743
1000,512,489,499,265,490,755
1000,487,501,515,246,495,741
1000,489,457,502,231,521,752
1000,508,465,501,234,520,754
1000,517,483,487,254,495,749
1000,513,498,523,255,523,778
1000,507,517,500,245,515,760
1000,509,481,507,235,530,765
1000,489,484,483,234,509,743
1000,481,496,492,231,509,740
1000,496,517,492,258,501,759
1000,500,504,486,252,484,736
1000,491,488,495,243,504,747
1000,458,486,520,226,513,739
1000,496,487,491,242,506,748
1000,481,491,513,236,504,740
1000,496,495,516,229,532,761
1000,502,503,499,254,493,747
1000,492,500,513,246,522,768
1000,518,498,513,263,501,764
1000,513,517,528,264,496,760
1000,498,478,519,247,514,761
1000,508,482,485,247,510,757
1000,488,484,514,242,512,754
1000,517,486,488,254,493,747
1000,503,531,464,270,455,725
1000,499,483,496,244,506,750
1000,484,482,494,233,511,744
1000,500,513,509,242,509,751
1000,480,507,514,260,491,751
1000,510,500,512,244,508,752
1000,509,523,474,263,489,752
1000,523,491,494,249,509,758
1000,485,500,497,253,494,747
1000,487,473,482,224,516,740
1000,501,513,502,248,499,747
1000,506,494,470,255,483,738
1000,493,498,515,252,495,747
1000,510,493,509,245,494,739
1000,551,484,477,270,503,773
1000,522,530,494,269,492,761
1000,497,488,473,247,492,739
1000,489,468,482,220,515,735
1000,491,486,492,229,521,750
1000,499,506,473,255,497,752
1000,485,498,517,248,505,753
1000,510,490,507,239,514,753
1000,499,489,484,245,491,736
1000,491,501,489,245,497,742
1000,522,488,512,254,516,770
1000,499,485,512,237,517,754
1000,505,477,512,215,541,756
1000,513,501,510,255,520,775
1000,525,479,506,256,504,760
1000,509,507,518,255,506,761
1000,496,504,501,252,493,745
1000,492,485,514,241,506,747
1000,502,519,526,245,530,775
1000,473,503,508,229,518,747
1000,504,516,486,252,485,737
1000,489,513,483,234,499,733
1000,467,533,518,247,501,748
1000,492,512,489,247,475,722
1000,502,510,489,258,489,747
1000,503,510,497,249,501,750
1000,528,507,506,272,489,761
1000,502,506,501,267,480,747
1000,516,479,488,244,503,747
1000,503,487,477,229,520,749
1000,514,502,470,264,475,739
1000,510,511,514,269,485,754
1000,496,481,512,238,506,744
1000,496,535,503,265,480,745
1000,524,491,489,246,522,768
1000,510,517,511,272,484,756
1000,512,512,506,257,498,755
1000,498,513,514,260,500,760
1000,491,508,503,243,495,738
1000,496,497,492,260,474,734
1000,495,498,547,246,531,777
1000,521,493,493,252,497,749
1000,505,503,484,249,505,754
1000,496,507,511,253,511,764
1000,495,499,489,252,468,720
1000,514,489,487,245,507,752
1000,511,487,509,241,513,754
1000,472,490,499,226,527,753
1000,498,495,521,249,519,768
1000,509,497,519,259,504,763
1000,493,488,490,246,495,741
1000,480,503,464,230,478,708
1000,518,510,505,273,475,748
1000,490,495,489,246,494,740
1000,492,511,506,257,481,738
1000,512,498,483,230,521,751
1000,500,497,505,254,495,749
1000,463,488,510,222,506,728
1000,484,486,491,241,502,743
1000,467,491,498,231,516,747
1000,507,501,503,252,508,760
1000,509,495,519,253,495,748
1000,517,472,481,238,518,756
1000,498,493,481,237,505,742
1000,489,501,487,231,503,734
1000,518,510,476,263,487,750
1000,499,471,489,221,515,736
1000,492,510,517,251,509,760
1000,487,504,496,245,500,745
1000,500,499,526,252,504,756
1000,532,499,497,251,509,760
1000,504,500,483,252,485,737
1000,501,530,490,271,470,741
1000,498,506,504,251,500,751
1000,506,504,488,265,475,740
1000,496,491,476,234,497,731
1000,485,504,519,253,498,751
1000,491,476,490,241,516,757
1000,485,503,486,247,492,739
1000,535,530,505,280,482,762
1000,481,515,477,262,467,729
1000,487,479,509,232,520,752
1000,481,494,520,221,521,742
1000,513,503,522,248,522,770
1000,500,503,519,276,466,742
1000,512,482,498,244,506,750
1000,517,523,512,281,484,765
1000,473,512,503,251,480,731
1000,526,479,484,247,509,756
1000,526,506,505,273,503,776
1000,501,488,520,240,524,764
1000,473,520,480,250,471,721
1000,491,498,491,241,507,748
1000,512,487,487,254,506,760
1000,490,486,513,239,520,759
1000,473,473,512,238,491,729
1000,500,482,506,248,512,760
1000,517,482,505,240,525,765
1000,532,524,523,268,518,786
1000,496,511,480,241,509,750
1000,494,500,486,242,480,722
1000,507,458,493,230,517,747
1000,495,477,496,227,529,756
1000,521,510,491,255,503,758
1000,518,490,530,250,535,785
1000,488,501,505,254,495,749
1000,503,502,504,263,484,747
1000,519,492,508,255,508,763
1000,488,517,527,263,498,761
1000,516,483,484,256,499,755
1000,487,488,514,234,520,754
1000,491,491,510,244,495,739
1000,481,488,486,225,499,724
1000,502,506,477,245,480,725
1000,507,473,502,242,507,749
1000,514,497,490,264,493,757
1000,495,483,500,235,509,744
1000,534,501,505,255,507,762
1000,503,499,499,255,502,757
1000,484,516,488,251,487,738
1000,494,489,494,230,506,736
1000,496,515,473,247,488,735
1000,513,510,510,253,503,756
1000,515,476,526,245,531,776
1000,473,480,509,227,513,740
1000,490,508,527,248,510,758
1000,524,545,528,286,494,780
1000,499,513,490,258,499,757
1000,520,486,514,259,491,750
1000,495,499,515,256,496,752
1000,516,477,506,240,513,753
1000,493,506,492,255,485,740
1000,508,516,496,259,490,749
1000,530,517,515,272,499,771
1000,501,480,491,236,512,748
1000,478,490,495,233,523,756
1000,511,503,516,257,510,767
1000,518,512,503,280,485,765
1000,494,501,509,251,503,754
1000,507,481,474,240,500,740
1000,529,518,504,266,494,760
1000,487,522,506,244,504,748
1000,487,496,522,235,511,746
1000,519,504,490,265,475,740
1000,494,504,482,239,496,735
1000,477,542,508,253,483,736
1000,506,492,497,244,519,763
1000,513,492,500,253,497,750
1000,524,489,504,260,500,760
1000,486,505,488,250,482,732
1000,492,484,484,247,474,721
1000,506,481,511,251,515,766
1000,506,524,526,261,501,762
1000,508,500,535,242,522,764
1000,494,514,514,276,482,758
1000,485,504,489,256,477,733
1000,523,484,490,256,495,751
1000,515,506,526,263,501,764
1000,491,506,476,255,474,729
1000,530,491,507,266,497,763
1000,491,487,517,239,527,766
1000,489,503,483,254,482,736
1000,511,506,485,258,478,736
1000,514,490,513,247,522,769
1000,481,517,494,236,504,740
1000,464,500,514,227,519,746
1000,487,494,499,248,491,739
1000,490,502,527,257,508,765
1000,482,473,486,221,505,726
1000,491,515,495,256,486,742
1000,507,510,503,261,483,744
1000,489,492,502,247,497,744
1000,505,483,481,239,494,733
1000,515,509,489,263,503,766
1000,520,520,511,266,500,766
1000,483,493,502,233,505,738
1000,518,503,531,254,518,772
1000,499,511,459,251,478,729
1000,489,491,514,246,504,750
1000,503,495,502,254,499,753
1000,485,488,512,230,515,745
1000,489,494,502,241,506,747
1000,474,501,507,237,498,735
1000,512,495,491,243,495,738
1000,490,492,494,250,497,747
1000,511,546,495,282,465,747
1000,500,508,510,248,498,746
1000,520,505,502,275,486,761
1000,496,526,510,271,489,760
1000,521,512,513,256,509,765
1000,483,501,485,248,485,733
1000,506,522,521,262,491,753
1000,499,515,498,264,483,747
1000,517,504,503,259,499,758
1000,479,507,462,243,479,722
1000,491,533,516,250,508,758
1000,522,483,521,255,506,761
1000,492,507,484,253,477,730
1000,484,501,511,239,518,757
1000,496,483,489,238,500,738
1000,497,508,501,256,513,769
1000,478,493,502,230,530,760
1000,475,476,480,222,487,709
1000,503,494,493,247,500,747
1000,496,515,467,263,471,734
1000,515,511,506,276,484,760
1000,501,512,507,268,486,754
1000,508,496,516,259,493,752
1000,519,526,505,273,495,768
1000,485,499,470,230,499,729
1000,501,481,499,244,508,752
1000,489,495,509,253,511,764
1000,477,491,512,232,507,739
1000,516,502,511,252,517,769
1000,505,482,511,251,501,752
1000,494,499,500,238,524,762
1000,486,501,489,242,484,726
1000,497,497,518,242,504,746
1000,522,490,497,253,498,751
1000,496,495,496,233,502,735
1000,502,507,474,261,472,733
1000,499,496,511,239,524,763
1000,497,527,527,261,499,760
1000,495,524,485,257,490,747
1000,488,484,506,258,487,745
1000,517,492,510,248,525,773
1000,490,476,495,231,512,743
1000,504,481,494,245,518,763
1000,505,513,487,252,507,759
1000,472,509,491,247,483,730
1000,523,495,497,274,484,758
1000,470,507,513,245,495,740
1000,516,484,502,244,512,756
1000,506,501,497,262,490,752
1000,498,505,493,244,506,750
1000,483,496,504,251,485,736
1000,482,543,491,256,482,738
1000,505,480,483,231,504,735
1000,515,516,529,250,506,756
1000,489,474,517,223,523,746
1000,489,500,529,247,513,760
1000,511,525,478,267,472,739
1000,467,507,484,246,471,717
1000,521,508,498,265,495,760
1000,511,523,465,259,473,732
1000,498,491,489,250,494,744
1000,497,504,500,248,487,735
1000,507,494,517,254,517,771
1000,490,518,517,245,514,759
1000,480,518,481,246,494,740
1000,497,523,498,262,474,736
1000,500,510,517,238,529,767
1000,487,470,508,230,528,758
1000,505,490,484,256,497,753
1000,480,489,511,237,498,735
1000,513,508,504,257,501,758
1000,511,498,518,246,509,755
1000,525,516,518,260,503,763
1000,497,511,498,247,504,751
1000,483,515,516,248,497,745
1000,507,511,494,280,478,758
1000,489,502,513,247,505,752
1000,497,515,502,257,489,746
1000,522,531,525,274,496,770
1000,497,519,498,245,488,733
1000,522,490,495,237,537,774
1000,491,490,496,245,494,739
1000,511,486,523,256,525,781
1000,482,507,469,244,476,720
1000,478,514,496,235,509,744
1000,491,490,508,233,523,756
1000,516,488,486,264,481,745
1000,529,495,470,260,484,744
1000,505,455,518,223,539,762
1000,496,530,474,262,478,740
1000,489,507,500,233,508,741
1000,507,518,491,267,490,757
1000,500,500,503,242,508,750
1000,530,500,515,266,504,770
1000,516,475,478,239,527,766
1000,475,482,512,228,521,749
1000,499,491,476,253,477,730
1000,550,499,516,279,497,776
1000,535,511,519,264,517,781
1000,487,494,504,236,505,741
1000,527,490,511,263,488,751
1000,497,495,502,244,503,747
1000,503,485,506,239,512,751
1000,496,523,484,256,480,736
1000,477,494,509,238,518,756
1000,464,473,515,214,534,748
1000,495,483,491,231,516,747
1000,496,510,539,257,499,756
1000,496,490,503,241,502,743
1000,476,534,500,252,482,734
1000,485,494,484,243,491,734
1000,505,500,504,254,506,760
1000,492,495,469,235,503,738
1000,507,500,523,260,520,780
1000,491,494,504,241,514,755
1000,472,524,487,240,497,737
1000,503,499,502,257,492,749
1000,487,510,498,239,502,741
1000,488,477,487,236,495,731
1000,523,478,466,259,490,749
1000,486,507,479,249,490,739
1000,478,524,512,249,512,761
1000,463,476,488,207,528,735
1000,518,508,486,273,482,755
1000,504,477,496,243,513,756
1000,498,504,501,266,475,741
1000,462,467,520,230,513,743
1000,510,518,461,271,467,738
1000,503,495,487,261,479,740
1000,518,488,494,259,504,763
1000,494,495,497,255,501,756
1000,504,485,505,249,505,754
1000,509,488,516,233,523,756
1000,492,510,501,249,495,744
1000,493,496,500,246,496,742
1000,486,494,515,233,522,755
1000,508,499,496,249,491,740
1000,486,499,500,250,489,739
1000,491,506,481,251,487,738
1000,502,486,523,245,508,753
1000,508,502,487,259,481,740
1000,507,495,497,255,507,762
1000,489,500,517,236,521,757
1000,474,465,502,221,511,732
1000,495,481,503,239,512,751
1000,507,481,519,241,533,774
1000,507,487,499,255,499,754
1000,498,483,500,219,522,741
1000,523,491,509,245,524,769
1000,519,479,495,252,506,758
1000,507,517,499,270,483,753
1000,529,508,474,267,486,753
1000,493,490,517,225,549,774
1000,505,503,492,266,478,744
1000,513,519,480,263,491,754
1000,516,483,509,255,515,770
1000,501,489,499,242,513,755
1000,498,505,491,253,483,736
1000,528,471,534,249,517,766
1000,501,523,515,273,487,760
1000,511,508,511,269,489,758
1000,521,500,487,269,485,754
1000,500,510,498,245,508,753
1000,477,493,530,235,526,761
1000,497,490,502,248,499,747
1000,502,519,502,273,485,758
1000,510,515,502,269,489,758
1000,507,474,507,234,515,749
1000,520,479,516,261,509,770
1000,504,510,479,244,485,729
1000,496,516,496,253,497,750
1000,511,488,512,246,509,755
1000,521,501,492,244,505,749
1000,524,495,487,259,513,772
1000,478,505,506,219,522,741
1000,518,488,506,249,516,765
1000,519,488,506,260,510,770
1000,525,496,500,252,512,764
1000,511,496,514,248,517,765
1000,494,498,472,249,493,742
1000,500,522,508,260,507,767
1000,517,484,487,257,499,756
1000,496,475,514,226,536,762
1000,501,473,493,219,524,743
1000,486,484,486,222,517,739
1000,484,477,492,239,498,737
1000,512,497,463,259,479,738
1000,482,523,506,247,486,733
1000,499,492,522,245,510,755
1000,490,514,477,246,500,746
1000,493,507,502,249,493,742
1000,505,491,488,256,481,737
1000,501,483,527,246,508,754
1000,510,510,502,260,510,770
1000,518,508,508,265,490,755
1000,481,522,509,246,505,751
1000,509,528,544,275,498,773
1000,531,481,509,264,492,756
1000,528,514,484,284,467,751
1000,502,490,504,246,507,753
1000,488,510,533,251,497,748
1000,498,522,474,259,490,749
1000,525,506,481,249,517,766
1000,540,511,498,265,506,771
1000,503,491,541,244,530,774
1000,507,521,492,262,491,753
1000,516,502,485,256,480,736
1000,496,494,520,251,497,748
1000,511,477,477,249,488,737
1000,504,478,485,223,511,734
1000,493,468,485,235,489,724
1000,517,499,506,257,501,758
1000,499,489,508,235,533,768
1000,534,502,480,256,508,764
1000,497,479,503,243,509,752
1000,493,492,499,243,513,756
1000,500,498,491,248,492,740
1000,527,499,486,266,477,743
1000,494,524,493,258,490,748
1000,500,525,467,266,481,747
1000,511,487,476,241,490,731
1000,505,494,524,247,526,773
1000,513,515,506,268,494,762
1000,504,488,493,227,527,754
1000,500,480,506,240,518,758
1000,501,507,476,255,487,742
1000,507,502,500,247,499,746
1000,489,508,503,246,514,760
1000,483,487,493,238,491,729
1000,505,515,503,261,499,760
1000,522,506,496,256,497,753
1000,480,505,497,247,507,754
1000,483,501,486,238,497,735
1000,499,516,485,252,481,733
1000,505,499,499,262,486,748
1000,506,467,503,229,536,765
1000,478,491,499,235,514,749
1000,523,509,500,258,503,761
1000,507,488,516,255,520,775
1000,472,493,494,229,510,739
1000,498,508,492,244,495,739
1000,497,489,500,242,493,735
1000,509,513,483,268,472,740
1000,510,484,489,258,493,751
1000,511,496,485,253,497,750
1000,496,504,514,263,496,759
1000,502,503,499,260,489,749
1000,514,520,510,258,514,772
1000,472,480,477,211,516,727
1000,453,510,510,231,494,725
1000,504,511,505,262,500,762
1000,484,466,507,227,521,748
1000,471,511,509,252,491,743
1000,480,474,506,217,519,736
1000,486,516,504,250,487,737
1000,502,516,521,267,488,755
1000,468,521,523,245,503,748
1000,481,521,516,249,504,753
1000,522,502,485,255,512,767
1000,497,478,475,237,495,732
1000,497,505,486,263,481,744
1000,500,535,463,265,457,722
1000,522,508,515,256,520,776
1000,508,497,486,250,493,743
1000,508,492,500,254,500,754
1000,491,478,502,241,502,743
1000,530,483,510,263,498,761
1000,478,479,501,235,499,734
1000,528,497,523,266,504,770
1000,501,529,523,260,502,762
1000,507,511,484,262,480,742
1000,480,518,490,246,495,741
1000,514,507,485,264,488,752
1000,518,522,506,279,499,778
1000,487,499,516,246,489,735
1000,512,488,483,255,495,750
1000,498,503,505,261,487,748
1000,500,495,553,254,535,789
1000,503,524,492,259,488,747
1000,519,513,482,263,489,752
1000,489,500,508,244,511,755
1000,485,489,494,228,515,743
1000,511,481,467,248,494,742
1000,491,493,480,241,486,727
1000,485,503,495,230,519,749
1000,481,519,495,242,501,743
1000,540,485,483,262,504,766
1000,506,514,512,264,500,764
1000,479,485,527,230,513,743
1000,512,500,484,254,489,743
1000,468,517,495,237,478,715
1000,508,494,472,241,509,750
1000,504,481,482,228,510,738
1000,517,489,491,255,486,741
1000,509,489,510,250,517,767
1000,489,498,491,240,509,749
1000,510,497,497,255,483,738
1000,516,482,512,245,514,759
1000,473,499,539,236,536,772
1000,519,501,510,257,512,769
1000,508,505,517,259,486,745
1000,513,490,520,250,518,768
1000,463,504,506,235,504,739
1000,501,480,501,249,500,749
1000,493,501,478,242,497,739
1000,496,507,517,246,512,758
1000,508,518,490,262,487,749
1000,495,468,499,239,496,735
1000,515,555,506,286,482,768
1000,496,485,513,244,513,757
1000,487,494,505,239,513,752
1000,497,512,498,244,506,750
1000,489,519,510,252,487,739
1000,511,517,506,270,492,762
1000,478,498,505,240,498,738
1000,488,472,492,225,523,748
1000,487,503,508,249,495,744
1000,510,510,497,260,488,748
1000,497,480,505,237,519,756
1000,504,471,479,231,533,764
1000,512,501,509,260,492,752
1000,508,482,510,259,498,757
1000,520,498,506,260,500,760
1000,507,496,505,264,483,747
1000,476,509,518,257,492,749
1000,487,515,492,248,483,731
1000,524,495,499,247,525,772
1000,506,503,509,262,502,764
1000,511,501,499,269,487,756
1000,460,514,509,240,493,733
1000,479,480,501,226,511,737
1000,502,510,500,246,505,751
1000,527,486,506,260,505,765
1000,538,505,508,277,504,781
1000,506,522,517,256,497,753
1000,493,498,501,244,503,747
1000,478,521,493,250,494,744
1000,515,481,489,244,519,763
1000,529,498,490,266,489,755
1000,508,486,475,253,473,726
1000,498,515,510,248,497,745
1000,486,526,510,251,508,759
1000,487,494,499,255,488,743
1000,491,485,505,247,501,748
1000,501,489,521,249,507,756
1000,507,506,510,253,505,758
1000,510,504,470,262,469,731
1000,500,509,511,269,487,756
1000,503,511,514,267,490,757
1000,477,477,497,234,506,740
1000,515,486,502,263,500,763
1000,503,495,538,247,520,767
1000,497,497,500,252,498,750
1000,493,488,527,233,533,766
1000,489,495,506,239,518,757
1000,460,492,493,232,505,737
1000,512,514,508,263,496,759
1000,507,502,516,246,518,764
1000,501,494,492,249,496,745
1000,505,490,497,256,488,744
1000,462,511,463,231,484,715
1000,529,497,505,269,499,768
1000,484,510,476,242,481,723
1000,520,516,520,265,495,760
1000,478,508,509,232,493,725
1000,513,515,470,272,478,750
1000,469,479,487,230,499,729
1000,513,503,474,264,479,743
1000,494,494,510,248,494,742
1000,510,507,501,260,489,749
1000,497,492,499,247,501,748
1000,496,501,488,256,490,746
1000,465,508,501,223,506,729
1000,528,469,495,253,501,754
1000,466,532,488,244,473,717
1000,494,476,489,238,505,743
1000,511,507,470,270,473,743
1000,514,476,495,254,488,742
1000,518,478,486,258,473,731
1000,468,527,504,241,484,725
1000,488,508,531,249,505,754
1000,498,504,476,253,492,745
1000,522,483,509,255,506,761
1000,491,511,503,261,488,749
1000,538,483,503,252,515,767
1000,510,474,496,241,507,748
1000,517,482,523,243,513,756
1000,524,516,537,275,511,786
1000,471,479,501,222,521,743
1000,513,509,507,264,474,738
1000,510,477,492,242,513,755
1000,503,517,493,254,482,736
1000,514,481,485,251,494,745
1000,519,494,504,251,527,778
1000,500,480,488,241,510,751
1000,520,478,480,245,510,755
1000,516,499,494,251,499,750
1000,513,486,511,251,517,768
1000,499,511,511,240,503,743
1000,491,496,510,272,478,750
1000,485,446,498,228,509,737
1000,487,506,505,249,494,743
1000,530,503,537,270,514,784
1000,495,489,487,250,494,744
1000,511,522,504,258,499,757
1000,501,520,494,266,490,756
1000,526,518,493,276,481,757
1000,459,493,510,236,514,750
1000,480,505,487,259,475,734
1000,506,469,527,227,563,790
1000,520,495,489,250,514,764
1000,500,500,513,257,501,758
1000,499,506,531,260,492,752
1000,490,543,531,264,501,765
1000,513,471,514,232,543,775
1000,485,529,508,260,480,740
1000,510,489,523,238,524,762
1000,473,459,521,210,529,739
1000,520,481,473,251,499,750
1000,491,502,496,242,505,747
1000,520,523,491,275,481,756
1000,497,512,512,252,518,770
1000,502,526,474,274,465,739
1000,501,511,514,259,494,753
1000,483,529,502,249,499,748
1000,497,499,506,247,494,741
1000,505,505,504,250,504,754
1000,505,519,532,260,500,760
1000,499,483,506,242,520,762
1000,481,491,522,243,509,752
1000,499,508,510,256,487,743
1000,516,513,510,252,507,759
1000,497,516,503,253,504,757
1000,497,502,520,256,499,755
1000,511,489,535,253,517,770
1000,492,478,495,234,508,742
1000,517,496,492,255,507,762
1000,501,491,522,233,529,762
1000,499,502,505,259,504,763
1000,515,500,487,257,496,753
1000,467,506,508,255,469,724
1000,469,479,487,222,503,725
1000,492,499,479,251,473,724
1000,512,483,507,246,510,756
1000,496,514,509,268,490,758
1000,492,507,516,238,506,744
1000,497,517,477,259,490,749
1000,496,505,495,251,499,750
1000,495,492,496,256,480,736
1000,486,502,529,237,515,752
1000,485,507,510,260,492,752
1000,518,512,514,264,504,768
1000,494,503,495,242,501,743
1000,507,484,496,244,511,755
1000,490,488,482,239,487,726
1000,497,473,514,237,524,761
1000,505,496,499,261,490,751
1000,497,490,513,240,521,761
1000,531,512,474,269,487,756
1000,503,490,507,253,500,753
1000,524,528,500,269,484,753
1000,499,512,505,260,498,758
1000,501,505,492,254,491,745
1000,506,515,505,269,475,744
1000,500,516,479,258,487,745
1000,517,494,491,268,496,764
1000,503,499,503,248,505,753
1000,502,506,496,258,494,752
1000,475,498,495,241,485,726
1000,452,475,519,219,507,726
1000,490,480,501,243,498,741
1000,481,497,491,249,495,744
1000,520,505,512,262,498,760
1000,524,522,499,267,497,764
1000,506,492,508,240,506,746
1000,497,498,489,249,499,748
1000,501,493,480,265,476,741
1000,532,505,482,263,491,754
1000,498,486,498,234,509,743
1000,467,495,495,237,495,732
1000,513,512,512,257,508,765
1000,491,501,528,241,500,741
1000,494,471,501,242,507,749
1000,487,495,463,240,480,720
1000,507,497,477,244,486,730
1000,501,535,493,273,478,751
1000,475,482,517,240,515,755
1000,499,505,502,245,492,737
1000,508,503,480,258,478,736
1000,480,522,499,263,475,738
1000,506,490,488,256,473,729
1000,534,514,464,281,472,753
1000,486,476,492,240,509,749
1000,503,464,478,244,498,742
1000,493,523,506,258,485,743
1000,489,524,504,250,497,747
1000,499,503,494,252,507,759
1000,516,507,492,260,485,745
1000,504,502,508,250,506,756
1000,497,475,489,230,518,748
1000,473,496,488,235,504,739
1000,477,502,484,250,463,713
1000,499,488,514,241,516,757
1000,501,512,472,267,479,746
1000,482,496,516,240,513,753
1000,516,492,472,253,488,741
1000,494,488,487,240,507,747
1000,514,529,526,278,481,759
1000,517,508,504,253,505,758
1000,526,513,514,257,509,766
1000,479,493,479,231,505,736
1000,498,509,505,260,495,755
1000,505,477,483,229,523,752
1000,469,515,474,226,515,741
1000,516,527,503,274,489,763
1000,496,488,523,235,524,759
1000,518,486,513,254,520,774
1000,508,491,494,244,518,762
1000,491,510,511,261,494,755
1000,511,487,485,242,507,749
1000,479,496,524,232,527,759
1000,496,499,507,248,499,747
1000,512,483,497,239,507,746
1000,492,477,520,244,513,757
1000,510,504,498,255,503,758
1000,495,454,487,225,518,743
1000,529,497,489,267,477,744
1000,491,482,506,231,518,749
1000,498,476,520,248,505,753
1000,506,506,515,260,509,769
1000,493,471,473,230,506,736
1000,496,489,505,235,523,758
1000,506,514,506,257,499,756
1000,513,487,486,247,510,757
1000,468,507,482,236,499,735
1000,475,503,481,243,477,720
1000,495,517,512,249,507,756
1000,495,491,524,240,525,765
1000,521,506,517,261,505,766
1000,508,484,504,249,505,754
1000,504,512,513,252,515,767
1000,504,500,476,255,486,741
1000,513,508,473,261,482,743
1000,522,497,491,265,477,742
1000,531,505,493,277,476,753
1000,486,494,490,239,486,725
1000,502,526,508,266,495,761
1000,515,520,514,274,488,762
1000,508,498,494,257,487,744
1000,489,502,514,248,505,753
1000,498,508,509,240,522,762
1000,498,519,506,259,481,740
1000,521,509,499,261,492,753
1000,534,514,490,274,491,765
1000,498,491,476,250,482,732
1000,487,519,512,253,504,757
1000,504,493,496,251,491,742
1000,513,486,494,245,515,760
1000,523,518,502,276,499,775
1000,475,483,508,238,490,728
1000,461,528,480,237,477,714
1000,511,521,500,262,486,748
1000,468,513,468,244,477,721
1000,546,489,496,254,523,777
1000,522,489,507,251,512,763
1000,511,491,523,258,518,776
1000,520,487,538,258,512,770
1000,524,479,508,253,511,764
1000,509,486,494,236,526,762
1000,500,494,518,227,535,762
1000,520,510,533,270,504,774
1000,505,506,462,240,494,734
1000,499,501,478,250,486,736
1000,511,509,533,258,516,774
1000,507,502,487,243,502,745
1000,496,490,538,241,529,770
1000,477,500,501,242,494,736
1000,500,493,522,237,528,765
1000,470,503,479,230,507,737
1000,504,514,512,264,498,762
1000,506,493,500,243,517,760
1000,515,504,483,265,493,758
1000,519,483,495,248,513,761
1000,506,489,498,252,494,746
1000,523,521,497,265,500,765
1000,489,495,508,231,520,751
1000,484,476,505,231,509,740
1000,498,490,467,219,512,731
1000,516,494,499,247,511,758
1000,517,515,495,277,477,754
1000,500,479,506,239,531,770
1000,478,486,487,233,494,727
1000,532,490,519,268,521,789
1000,506,492,497,234,521,755
1000,519,497,488,261,495,756
1000,479,477,483,231,504,735
1000,507,489,479,248,509,757
1000,482,484,482,221,524,745
1000,472,521,480,236,494,730
1000,505,510,528,269,502,771
1000,502,501,505,264,486,750
1000,505,486,498,242,509,751
1000,509,484,517,241,518,759
1000,475,494,499,223,519,742
1000,511,515,543,286,476,762
1000,518,524,537,267,508,775
1000,488,519,503,265,474,739
1000,470,486,516,223,514,737
1000,507,515,500,263,489,752
1000,493,479,492,234,506,740
1000,505,530,494,265,473,738
1000,497,492,489,239,504,743
1000,522,487,499,253,501,754
1000,503,512,481,245,490,735
1000,505,484,489,238,512,750
1000,504,513,501,248,513,761
1000,485,535,478,251,489,740
1000,515,488,499,265,486,751
1000,498,504,517,270,473,743
1000,509,486,480,253,495,748
1000,498,506,521,262,497,759
1000,485,484,506,234,506,740
1000,503,505,481,250,481,731
1000,474,500,482,230,508,738
1000,496,467,508,231,519,750
1000,506,490,494,252,497,749
1000,485,490,491,242,495,737
1000,513,480,488,244,508,752
1000,480,522,515,258,506,764
1000,515,495,487,251,501,752
1000,504,506,484,257,477,734
1000,501,501,500,257,476,733
1000,476,513,498,250,498,748
1000,486,496,492,245,491,736
1000,506,489,499,235,533,768
1000,513,523,535,262,500,762
1000,519,490,486,258,501,759
1000,486,499,501,246,497,743
1000,461,471,494,215,504,719
1000,524,517,502,275,488,763
1000,511,510,506,251,512,763
1000,546,480,493,250,522,772
1000,462,489,480,221,506,727
1000,501,513,493,264,493,757
1000,485,501,494,245,492,737
1000,522,495,497,255,494,749
1000,481,498,490,237,508,745
1000,504,527,516,269,474,743
1000,482,496,499,230,506,736
1000,506,504,486,258,501,759
1000,493,490,500,249,497,746
1000,493,514,482,251,485,736
1000,478,503,483,254,484,738
1000,502,497,495,261,481,742
1000,482,469,485,226,501,727
1000,480,505,507,250,492,742
1000,510,489,480,250,490,740
1000,509,515,526,286,477,763
1000,479,498,513,245,493,738
1000,488,473,500,242,504,746
1000,531,515,498,260,498,758
1000,516,513,493,272,474,746
1000,496,495,508,251,513,764
1000,485,489,517,237,523,760
1000,495,470,503,225,520,745
1000,494,501,496,240,498,738
1000,496,542,486,251,484,735
1000,478,515,499,248,482,730
1000,514,501,521,254,516,770
1000,513,499,496,268,481,749
1000,498,501,521,267,493,760
1000,509,540,498,270,480,750
1000,505,487,507,240,527,767
1000,501,500,482,250,498,748
1000,519,520,493,269,490,759
1000,489,512,523,263,491,754
1000,495,517,502,254,500,754
1000,492,498,502,240,518,758
1000,500,490,493,249,505,754
1000,498,529,491,252,490,742
1000,507,524,484,273,463,736
1000,504,511,504,246,508,754
1000,466,516,479,237,492,729
1000,485,500,473,263,471,734
1000,514,508,513,250,510,760
1000,492,501,469,242,486,728
1000,527,502,480,265,507,772
1000,461,497,488,217,488,705
1000,493,490,488,250,488,738
1000,516,498,504,261,497,758
1000,518,514,491,257,503,760
1000,524,507,493,260,497,757
1000,503,514,504,261,490,751
1000,508,512,495,252,496,748
1000,499,491,497,230,515,745
1000,516,511,496,260,498,758
1000,489,518,487,254,494,748
1000,468,505,498,243,481,724
1000,513,502,501,268,476,744
1000,477,493,492,235,508,743
1000,507,511,481,247,501,748
1000,536,524,475,288,473,761
1000,470,512,515,254,495,749
1000,516,500,488,254,485,739
1000,501,484,514,234,510,744
1000,503,471,519,234,514,748
1000,504,513,513,263,493,756
1000,524,507,512,260,502,762
1000,499,488,500,250,505,755
1000,491,493,491,255,473,728
1000,511,465,513,245,517,762
1000,479,497,508,248,497,745
1000,500,500,507,226,531,757
1000,502,503,521,247,516,763
1000,505,488,465,237,493,730
1000,490,457,494,214,528,742
1000,539,486,485,264,507,771
1000,502,502,488,249,492,741
1000,499,512,507,249,500,749
1000,502,491,486,233,515,748
1000,524,500,472,274,467,741
1000,524,499,483,261,516,777
1000,500,482,527,248,518,766
1000,512,500,477,274,457,731
1000,495,514,518,250,502,752
1000,509,514,507,262,492,754
1000,507,523,495,264,498,762
1000,519,505,493,259,504,763
1000,471,502,527,243,511,754
1000,525,498,528,269,498,767
1000,496,512,499,264,476,740
1000,500,513,516,250,510,760
1000,493,500,534,248,519,767
1000,480,504,490,226,510,736
1000,477,465,522,223,534,757
1000,494,473,499,230,524,754
1000,489,486,506,232,519,751
1000,498,515,474,269,455,724
1000,506,503,528,262,507,769
1000,481,488,459,237,483,720
1000,520,514,467,265,479,744
1000,479,520,510,234,513,747
1000,505,476,523,234,530,764
1000,471,516,519,239,517,756
1000,503,514,499,257,488,745
1000,490,486,495,243,513,756
1000,545,460,489,238,520,758
1000,500,485,523,243,520,763
1000,490,524,516,263,488,751
1000,473,493,521,231,530,761
1000,451,501,523,223,508,731
1000,495,505,497,260,506,766
1000,493,495,535,231,535,766
1000,515,530,495,267,485,752
1000,501,497,532,249,515,764
1000,485,512,490,232,507,739
1000,480,481,501,221,528,749
1000,492,485,499,245,494,739
1000,503,468,499,224,520,744
1000,485,487,501,244,500,744
1000,488,473,497,224,523,747
1000,496,494,496,239,504,743
1000,476,505,518,243,494,737
1000,488,516,491,263,491,754
1000,511,482,494,246,502,748
1000,505,493,483,241,501,742
1000,494,476,473,238,495,733
1000,514,504,508,267,498,765
1000,497,460,505,234,513,747
1000,503,509,474,260,474,734
1000,459,486,465,228,487,715
1000,465,484,483,226,496,722
1000,494,486,505,258,480,738
1000,515,477,487,241,497,738
1000,511,511,524,258,509,767
1000,503,501,525,255,528,783
1000,513,506,498,265,501,766
1000,501,497,493,242,483,725
1000,497,525,472,244,485,729
1000,499,511,501,255,489,744
1000,494,499,474,254,488,742
1000,491,500,501,229,527,756
1000,497,492,496,249,503,752
1000,501,493,500,241,506,747
1000,516,491,502,254,500,754
1000,515,502,479,246,508,754
1000,473,512,529,239,516,755
1000,494,524,506,257,493,750
1000,453,468,525,227,522,749
1000,514,490,500,258,505,763
1000,497,521,523,258,506,764
1000,483,493,508,231,515,746
1000,502,496,487,242,500,742
1000,534,500,497,270,489,759
1000,492,502,525,241,513,754
1000,517,511,500,267,489,756
1000,498,486,502,240,506,746
1000,519,495,497,250,496,746
1000,480,509,461,237,470,707
1000,518,487,515,253,515,768
1000,486,494,481,254,485,739
1000,482,526,490,256,486,742
1000,481,512,478,238,495,733
1000,505,515,462,262,454,716
1000,482,518,510,253,487,740
1000,503,491,500,242,517,759
1000,511,496,501,246,508,754
1000,507,515,511,266,490,756
1000,524,493,502,237,525,762
1000,506,501,499,246,510,756
1000,472,484,500,210,525,735
1000,483,503,518,257,496,753
1000,490,501,497,244,515,759
1000,470,520,488,251,481,732
1000,474,514,495,240,489,729
1000,477,503,494,235,504,739
1000,505,521,487,262,472,734
1000,500,480,463,239,497,736
1000,508,525,491,286,451,737
1000,488,482,503,234,502,736
1000,475,513,505,234,504,738
1000,520,491,499,258,496,754
1000,492,517,517,259,491,750
1000,469,471,480,225,483,708
1000,482,498,499,232,523,755
1000,487,506,512,260,489,749
1000,504,494,522,246,501,747
1000,509,504,481,259,487,746
1000,519,483,498,261,498,759
1000,512,525,515,281,481,762
1000,512,507,508,255,505,760
1000,504,484,476,250,494,744
1000,512,516,496,268,485,753
1000,489,498,504,252,501,753
1000,508,502,495,258,505,763
1000,493,492,489,255,475,730
1000,535,486,495,257,509,766
1000,511,520,485,272,474,746
1000,495,495,497,243,509,752
1000,516,510,523,265,494,759
1000,502,500,500,234,521,755
1000,538,496,481,283,478,761
1000,494,503,494,242,503,745
1000,524,482,487,248,502,750
1000,488,518,509,251,498,749
1000,503,481,501,239,510,749
1000,516,487,497,253,503,756
1000,490,504,471,237,482,719
1000,493,501,509,248,499,747
1000,494,484,494,242,514,756
1000,470,502,505,225,505,730
1000,512,503,508,259,495,754
1000,470,494,506,231,500,731
1000,476,509,464,225,491,716
1000,485,503,514,247,506,753
1000,495,482,472,239,489,728
1000,469,528,510,253,476,729
1000,505,506,496,262,501,763
1000,489,485,493,241,506,747
1000,466,504,512,235,490,725
1000,518,507,460,243,499,742
1000,495,510,473,250,486,736
1000,516,509,480,262,483,745
1000,512,491,496,233,510,743
1000,493,471,508,230,520,750
1000,534,490,494,267,482,749
1000,512,524,511,261,495,756
1000,508,508,512,257,505,762
1000,507,485,503,257,511,768
1000,488,548,499,271,462,733
1000,500,487,514,238,504,742
1000,478,486,547,242,515,757
1000,487,509,509,248,500,748
1000,475,518,496,245,493,738
1000,504,496,530,237,527,764
1000,519,500,502,260,504,764
1000,480,498,487,242,506,748
1000,496,514,488,264,486,750
1000,488,510,487,256,475,731
1000,462,498,493,232,503,735
1000,524,481,505,252,514,766
1000,484,477,456,234,492,726
1000,511,522,497,260,490,750
1000,515,538,497,276,476,752
1000,541,496,492,270,493,763
1000,487,512,514,245,515,760
1000,509,486,520,250,498,748
1000,482,510,516,243,513,756
1000,521,520,510,261,500,761
1000,452,501,516,229,504,733
1000,480,528,496,261,476,737
1000,491,529,516,260,500,760
1000,495,497,509,250,500,750
1000,496,498,490,254,490,744
1000,490,509,513,251,498,749
1000,486,497,506,253,488,741
1000,507,487,519,249,517,766
1000,516,501,469,254,487,741
1000,476,500,506,236,496,732
1000,481,514,511,242,494,736
1000,534,496,526,263,522,785
1000,487,506,503,246,487,733
1000,496,517,502,269,481,750
1000,473,487,491,224,514,738
1000,475,476,496,217,515,732
1000,478,510,492,241,491,732
1000,501,498,488,251,496,747
1000,497,461,469,232,494,726
1000,480,524,519,245,489,734
1000,511,537,483,281,465,746
1000,494,480,484,222,522,744
1000,503,505,514,253,516,769
1000,500,502,494,268,494,762
1000,494,522,480,258,476,734
1000,493,508,520,230,534,764
1000,514,506,511,241,519,760
1000,498,505,507,251,504,755
1000,491,469,535,227,532,759
1000,483,509,526,246,511,757
1000,478,500,492,239,480,719
1000,479,491,495,238,491,729
1000,491,520,490,257,483,740
1000,468,501,483,241,475,716
1000,482,501,535,243,519,762
1000,490,497,501,244,492,736
1000,497,499,489,248,493,741
1000,518,517,474,258,482,740
1000,489,499,493,250,485,735
1000,500,495,513,253,504,757
1000,517,521,478,279,471,750
1000,494,505,477,247,492,739
1000,498,483,492,246,504,750
1000,498,480,485,242,505,747
1000,489,492,492,247,499,746
1000,506,500,508,246,509,755
1000,505,509,497,253,503,756
1000,477,481,491,246,476,722
1000,508,504,510,259,503,762
1000,460,509,524,229,517,746
1000,499,506,509,254,495,749
1000,501,490,525,242,519,761
1000,493,520,477,256,482,738
1000,492,473,520,227,543,770
1000,508,489,492,249,505,754
1000,485,503,508,237,512,749
1000,522,474,508,255,512,767
1000,489,505,490,245,498,743
1000,506,502,512,264,501,765
1000,493,497,483,247,492,739
1000,499,479,511,230,528,758
1000,502,510,517,244,506,750
1000,498,479,509,246,501,747
1000,518,513,536,251,516,767
1000,501,497,504,245,516,761
1000,487,511,493,252,479,731
1000,509,512,519,258,512,770
1000,497,514,515,254,484,738
1000,540,485,480,268,490,758
1000,506,508,558,257,519,776
1000,515,513,485,271,471,742
1000,510,504,515,261,499,760
1000,521,471,520,257,510,767
1000,514,483,512,254,523,777
1000,488,495,511,231,516,747
1000,511,500,482,260,491,751
1000,490,484,508,230,525,755
1000,511,492,490,243,508,751
1000,533,481,500,261,505,766
1000,510,507,469,276,458,734
1000,489,494,490,248,486,734
1000,502,505,486,257,492,749
1000,490,514,485,249,489,738
1000,482,510,497,237,498,735
1000,506,511,501,256,492,748
1000,501,485,475,247,487,734
1000,512,500,496,251,503,754
1000,502,503,491,232,521,753
1000,506,483,514,242,511,753
1000,473,505,467,232,500,732
1000,516,516,497,256,502,758
1000,474,485,494,225,507,732
1000,470,508,505,237,490,727
1000,492,510,500,270,473,743
1000,493,501,494,259,478,737
1000,512,493,504,262,509,771
1000,532,526,485,287,468,755
1000,496,486,514,244,516,760
1000,517,510,539,280,505,785
1000,505,500,503,254,495,749
1000,476,514,510,256,491,747
1000,501,499,504,250,509,759
1000,489,501,505,243,500,743
1000,518,521,489,269,485,754
1000,523,516,493,266,499,765
1000,507,519,499,262,489,751
1000,474,524,493,258,467,725
1000,488,504,501,236,504,740
1000,483,501,477,254,488,742
1000,511,477,506,244,525,769
1000,479,523,501,244,516,760
1000,496,471,510,241,506,747
1000,522,489,506,255,497,752
1000,478,502,510,245,504,749
1000,491,490,480,236,498,734
1000,518,509,504,266,502,768
1000,484,515,521,239,515,754
1000,479,497,483,230,500,730
1000,491,517,491,240,488,728
1000,506,495,505,244,511,755
1000,497,499,482,242,496,738
1000,510,507,504,245,503,748
1000,506,516,464,258,474,732
1000,496,492,506,233,529,762
1000,467,530,521,266,483,749
1000,507,503,516,253,506,759
1000,508,500,490,235,505,740
1000,497,497,469,244,498,742
1000,502,490,491,247,492,739
1000,464,519,494,241,477,718
1000,507,502,515,248,505,753
1000,500,496,484,238,507,745
1000,505,501,500,264,498,762
1000,487,526,486,271,462,733
1000,511,503,505,268,514,782
1000,531,481,486,252,506,758
1000,510,521,476,265,472,737
1000,481,499,501,245,495,740
1000,491,484,506,226,522,748
1000,504,492,481,249,485,734
1000,511,500,508,254,514,768
1000,498,500,492,259,489,748
1000,489,501,496,235,515,750
1000,518,516,526,274,511,785
1000,505,486,486,262,490,752
1000,505,514,502,253,506,759
1000,493,496,506,242,498,740
1000,490,523,503,257,488,745
1000,501,482,490,238,507,745
1000,511,493,469,252,497,749
1000,492,501,489,246,482,728
1000,520,498,480,252,513,765
1000,499,501,491,234,510,744
1000,500,509,490,267,484,751
1000,523,493,469,252,478,730
1000,500,520,532,266,504,770
1000,500,484,516,232,530,762
1000,522,481,488,267,480,747
1000,511,491,482,244,498,742
1000,505,515,487,265,477,742
1000,485,496,505,250,494,744
1000,523,496,512,248,525,773
1000,465,511,520,244,494,738
1000,513,517,479,258,495,753
1000,477,472,494,243,497,740
1000,486,508,513,250,502,752
1000,493,504,504,233,520,753
1000,493,492,482,260,480,740
1000,490,500,492,244,501,745
1000,479,498,496,252,488,740
1000,512,504,491,261,494,755
1000,502,519,515,264,495,759
1000,516,519,479,271,482,753
1000,497,490,500,246,485,731
1000,488,510,505,242,511,753
1000,503,498,532,253,515,768
1000,527,488,487,267,485,752
1000,506,536,481,283,469,752
1000,526,493,517,259,523,782
1000,487,482,535,230,533,763
1000,507,475,487,244,497,741
1000,501,507,513,243,505,748
1000,510,501,498,258,497,755
1000,463,513,493,243,493,736
1000,513,513,506,255,503,758
1000,497,494,500,252,496,748
1000,506,504,521,250,516,766
1000,511,509,504,253,516,769
1000,478,498,509,250,481,731
1000,514,508,491,271,492,763
1000,497,513,459,245,488,733
1000,491,466,507,229,516,745
1000,508,536,486,273,490,763
1000,496,505,484,252,481,733
1000,494,518,481,260,482,742
1000,520,467,486,250,505,755
1000,502,526,493,273,481,754
1000,513,501,499,260,485,745
1000,529,500,498,266,498,764
1000,487,500,496,253,480,733
1000,503,502,498,263,489,752
1000,520,495,494,237,528,765
1000,511,507,496,275,486,761
1000,487,493,468,238,484,722
1000,473,488,481,230,500,730
1000,512,509,510,262,506,768
1000,517,499,483,243,513,756
1000,485,542,489,259,468,727
1000,530,523,509,273,509,782
1000,500,493,510,239,522,761
1000,481,506,512,235,508,743
1000,501,494,483,243,507,750
1000,517,491,510,255,504,759
1000,500,491,501,244,499,743
1000,496,490,510,250,512,762
1000,499,474,501,243,507,750
1000,497,508,474,238,482,720
1000,511,509,509,256,508,764
1000,498,488,515,238,517,755
1000,484,474,516,226,527,753
1000,482,488,491,230,498,728
1000,492,504,535,246,521,767
1000,501,466,518,235,527,762
1000,493,504,495,252,487,739
1000,490,513,480,235,508,743
1000,510,531,513,271,477,748
1000,484,488,510,223,522,745
1000,538,494,504,260,515,775
1000,508,489,523,250,506,756
1000,504,489,528,263,511,774
1000,486,485,492,235,510,745
1000,500,482,509,242,501,743
1000,468,486,491,232,502,734
1000,506,508,478,259,480,739
1000,508,506,510,247,521,768
1000,486,482,505,230,520,750
1000,508,505,505,252,508,760
1000,491,507,512,232,531,763
1000,504,493,510,229,541,770
1000,495,518,487,267,478,745
1000,494,501,507,233,521,754
1000,494,485,507,244,508,752
1000,506,499,504,250,505,755
1000,509,511,486,271,467,738
1000,510,480,510,253,488,741
1000,488,498,502,247,492,739
1000,490,513,503,259,482,741
1000,517,497,516,257,499,756
1000,496,494,508,239,517,756
1000,520,480,497,259,505,764
1000,494,494,509,245,504,749
1000,515,475,492,244,502,746
1000,525,493,499,262,503,765
1000,496,511,502,247,520,767
1000,508,496,526,257,503,760
1000,482,486,508,238,505,743
1000,506,520,503,264,499,763
1000,515,484,490,250,506,756
1000,536,517,519,273,506,779
1000,495,510,511,246,495,741
1000,510,526,479,286,448,734
1000,490,493,488,247,495,742
1000,476,497,497,229,499,728
1000,493,503,490,241,510,751
1000,494,489,510,238,512,750
1000,486,491,495,235,500,735
1000,516,494,505,252,521,773
1000,490,491,521,265,490,755
1000,518,502,509,267,493,760
1000,520,489,525,248,522,770
1000,498,498,502,238,512,750
1000,535,493,509,262,513,775
1000,518,519,524,272,503,775
1000,496,507,492,255,492,747
1000,501,472,508,231,534,765
1000,504,529,502,277,466,743
1000,482,516,476,247,481,728
1000,507,494,519,259,508,767
1000,511,491,479,250,493,743
1000,472,480,489,233,500,733
1000,483,500,515,248,504,752
1000,481,515,493,235,499,734
1000,511,461,494,247,506,753
1000,506,498,500,241,505,746
1000,510,497,502,243,499,742
1000,508,530,505,274,480,754
1000,503,500,508,255,486,741
1000,520,502,489,251,507,758
1000,491,508,534,250,495,745
1000,487,497,483,240,498,738
1000,507,489,507,253,492,745
1000,504,507,513,260,503,763
1000,501,500,499,255,494,749
1000,495,517,510,250,506,756
1000,495,495,531,246,524,770
1000,502,502,545,251,523,774
1000,479,502,512,254,483,737
1000,512,515,503,265,481,746
1000,486,485,515,242,514,756
1000,491,474,484,229,497,726
1000,507,490,483,263,487,750
1000,489,473,518,220,545,765
1000,488,473,505,226,541,767
1000,527,517,485,273,484,757
1000,544,472,515,261,523,784
1000,510,505,525,248,524,772
1000,509,501,527,248,526,774
1000,513,511,501,265,484,749
1000,509,531,486,264,480,744
1000,496,512,462,253,482,735
1000,474,505,488,247,480,727
1000,497,458,510,221,529,750
1000,495,500,505,238,519,757
1000,517,473,495,255,488,743
1000,512,530,492,275,476,751
1000,508,509,511,264,500,764
1000,499,495,496,246,501,747
1000,512,493,488,253,499,752
1000,481,489,522,224,526,750
1000,467,497,504,231,516,747
1000,478,475,506,223,512,735
1000,495,486,492,247,495,742
1000,535,504,509,271,503,774
1000,514,494,494,256,503,759
1000,511,503,495,264,478,742
1000,517,539,496,275,481,756
1000,506,488,528,255,509,764
1000,495,530,484,265,464,729
1000,500,516,513,254,503,757
1000,503,495,518,252,507,759
1000,484,514,495,259,497,756
1000,501,501,505,243,518,761
1000,511,498,496,265,486,751
1000,466,483,501,233,504,737
1000,484,502,490,247,487,734
1000,495,493,512,253,493,746
1000,498,498,479,253,504,757
1000,511,503,477,268,470,738
1000,477,523,483,262,464,726
1000,514,477,513,239,534,773
1000,504,510,500,247,520,767
1000,504,498,493,247,505,752
1000,491,518,537,248,519,767
1000,513,504,490,256,511,767
1000,497,491,503,256,488,744
1000,510,512,506,252,504,756
1000,489,505,539,245,515,760
1000,485,477,520,234,525,759
1000,515,526,480,274,476,750
1000,505,504,491,244,496,740
1000,522,486,511,259,506,765
1000,492,493,513,241,510,751
1000,490,515,495,248,505,753
1000,526,496,489,259,489,748
1000,494,484,547,231,533,764
1000,510,469,488,251,501,752
1000,491,504,489,250,490,740
1000,511,492,515,246,507,753
1000,486,481,497,233,500,733
1000,491,483,487,233,502,735
1000,496,494,492,253,490,743
1000,516,509,521,264,488,752
1000,520,500,486,262,494,756
1000,497,509,491,242,501,743
1000,541,499,511,267,491,758
1000,499,522,474,268,460,728
1000,507,502,523,252,509,761
1000,505,508,531,254,502,756
1000,490,506,507,238,494,732
1000,509,507,468,247,496,743
1000,481,518,512,253,503,756
1000,509,475,485,231,515,746
1000,529,479,492,273,496,769
1000,497,509,505,243,512,755
1000,480,484,496,235,500,735
1000,499,505,497,240,516,756
1000,514,480,493,246,522,768
1000,511,501,506,254,502,756
1000,501,494,490,254,491,745
1000,514,512,532,242,534,776
1000,466,516,540,233,520,753
1000,505,507,489,247,496,743
1000,521,498,483,273,476,749
1000,499,493,484,252,494,746
1000,528,527,514,264,507,771
1000,491,508,480,255,483,738
1000,499,496,477,254,475,729
1000,509,514,512,261,500,761
1000,499,474,503,249,496,745
1000,512,481,507,254,506,760
1000,494,493,485,229,510,739
1000,473,499,504,225,511,736
1000,496,514,478,252,493,745
1000,490,505,500,257,485,742
1000,522,485,476,271,481,752
1000,472,492,470,235,488,723
1000,532,482,486,266,489,755
1000,512,511,495,282,470,752
1000,494,510,502,252,493,745
1000,494,471,489,239,492,731
1000,490,505,500,251,493,744
1000,504,508,519,259,504,763
1000,504,533,505,282,475,757
1000,519,520,483,268,488,756
1000,479,487,492,239,500,739
1000,505,517,493,266,472,738
1000,517,500,501,262,495,757
1000,502,490,489,250,500,750
1000,485,490,500,234,500,734
1000,483,468,494,227,511,738
1000,490,470,485,228,509,737
1000,512,492,514,243,514,757
1000,496,510,487,244,474,718
1000,503,517,508,251,495,746
1000,497,493,499,244,519,763
1000,529,506,496,280,482,762
1000,499,504,489,242,510,752
1000,514,488,490,234,509,743
1000,499,487,466,232,502,734
1000,485,493,506,235,506,741
1000,506,514,465,260,471,731
1000,497,496,509,253,502,755
1000,472,547,468,255,459,714
1000,504,515,477,258,477,735
1000,500,513,490,251,505,756
1000,507,496,525,244,523,767
1000,508,505,511,238,505,743
1000,502,470,499,234,514,748
1000,493,495,491,250,491,741
1000,480,517,483,226,508,734
1000,499,491,488,250,504,754
1000,497,535,486,266,465,731
1000,494,522,521,258,495,753
1000,532,491,485,265,494,759
1000,499,492,517,239,513,752
1000,509,507,503,261,490,751
1000,489,500,500,244,498,742
1000,506,461,482,239,502,741
1000,490,484,512,239,506,745
1000,494,514,503,249,499,748
1000,505,484,511,241,528,769
1000,499,500,453,240,488,728
1000,482,521,497,257,485,742
1000,519,488,519,241,526,767
1000,513,495,510,249,525,774
1000,496,523,509,256,500,756
1000,505,482,500,235,521,756
1000,505,529,511,262,499,761
1000,522,509,499,267,499,766
1000,499,492,500,252,508,760
1000,498,514,499,252,496,748
1000,503,519,518,263,508,771
1000,496,498,513,257,487,744
1000,506,498,502,252,491,743
1000,516,497,516,246,524,770
1000,514,499,464,252,503,755
1000,523,499,479,249,492,741
1000,498,502,493,251,490,741
1000,501,495,494,233,507,740
1000,506,512,504,269,479,748
1000,514,505,509,245,509,754
1000,532,531,487,279,481,760
1000,527,496,543,263,518,781
1000,509,485,485,239,505,744
1000,512,502,509,271,492,763
1000,488,493,510,235,503,738
1000,490,509,485,242,488,730
1000,508,493,493,249,501,750
1000,512,514,514,268,502,770
1000,498,506,523,241,534,775
1000,517,510,478,270,486,756
1000,478,499,499,224,517,741
1000,530,496,511,258,519,777
1000,485,524,465,264,462,726
1000,526,514,510,268,489,757
1000,488,500,491,239,508,747
1000,497,485,516,260,485,745
1000,531,499,532,269,512,781
1000,474,488,505,227,516,743
1000,484,484,517,240,488,728
1000,488,520,504,255,487,742
1000,497,494,505,256,489,745
1000,516,525,483,265,486,751
1000,498,498,503,268,486,754
1000,518,504,504,257,507,764
1000,521,512,500,262,496,758
1000,506,530,502,264,490,754
1000,488,496,532,251,510,761
1000,499,494,502,244,502,746
1000,504,486,492,253,487,740
1000,502,507,497,248,500,748
1000,478,496,491,223,506,729
1000,516,498,478,265,486,751
1000,509,490,509,257,500,757
1000,502,497,491,260,494,754
1000,507,500,497,242,521,763
1000,495,506,510,260,497,757
1000,510,510,509,260,494,754
1000,483,498,480,236,495,731
1000,508,509,496,264,494,758
1000,483,488,493,234,500,734
1000,516,514,505,253,511,764
1000,483,527,504,257,481,738
1000,488,486,490,233,490,723
1000,466,483,512,231,507,738
1000,523,485,487,253,498,751
1000,502,491,509,239,535,774
1000,484,496,479,257,488,745
1000,492,488,506,250,506,756
1000,492,514,498,271,474,745
1000,481,525,480,254,472,726
1000,505,469,466,237,494,731
1000,514,510,516,248,514,762
1000,508,496,502,251,504,755
1000,466,518,493,243,483,726
1000,502,510,508,250,517,767
1000,487,507,492,240,503,743
1000,529,510,491,286,466,752
1000,507,496,496,245,506,751
1000,505,543,499,271,483,754
1000,468,498,469,241,475,716
1000,514,486,517,238,536,774
1000,485,469,492,223,507,730
1000,491,510,510,254,485,739
1000,503,515,496,268,489,757
1000,499,516,503,251,494,745
1000,467,502,506,230,505,735
1000,501,519,509,268,478,746
1000,507,497,503,272,496,768
1000,488,503,513,235,526,761
1000,485,535,521,265,489,754
1000,475,502,510,234,518,752
1000,515,490,488,252,488,740
1000,493,503,502,240,505,745
1000,478,471,511,234,510,744
1000,510,502,505,246,523,769
1000,498,517,466,276,452,728
1000,484,514,489,259,467,726
1000,516,493,495,252,498,750
1000,506,476,518,252,512,764
1000,495,457,467,222,526,748
1000,500,487,483,254,488,742
1000,480,509,510,246,503,749
1000,514,522,470,273,474,747
1000,476,487,499,244,491,735
1000,514,495,492,254,501,755
1000,489,489,488,240,510,750
1000,511,507,489,270,483,753
1000,530,480,508,249,516,765
1000,508,498,507,259,501,760
1000,503,502,520,265,504,769
1000,529,502,483,269,501,770
1000,522,481,512,260,520,780
1000,482,493,483,240,499,739
1000,495,491,479,236,497,733
1000,502,500,513,258,499,757
1000,518,502,476,262,486,748
1000,500,522,499,260,487,747
1000,492,521,528,256,517,773
1000,517,494,488,237,511,748
1000,512,498,526,255,520,775
1000,503,521,491,269,499,768
1000,519,507,493,257,496,753
1000,486,481,515,214,556,770
1000,485,495,487,241,483,724
1000,515,521,511,277,489,766
1000,493,526,497,246,502,748
1000,501,519,506,263,484,747
1000,492,500,491,218,533,751
1000,497,486,501,237,524,761
1000,503,481,509,246,507,753
1000,499,518,497,262,470,732
1000,515,472,504,251,507,758
1000,510,526,484,264,471,735
1000,485,477,489,232,510,742
1000,532,503,505,271,500,771
1000,468,509,499,238,503,741
1000,494,513,498,250,500,750
1000,509,490,511,248,516,764
1000,517,505,501,254,515,769
1000,507,496,484,247,501,748
1000,494,492,496,242,495,737
1000,507,492,476,251,485,736
1000,467,491,536,233,516,749
1000,494,504,491,258,494,752
1000,483,489,510,257,495,752
1000,520,485,511,255,520,775
1000,461,504,503,238,498,736
1000,481,482,488,234,485,719
1000,491,489,487,248,494,742
1000,524,501,508,267,508,775
1000,472,517,516,236,518,754
1000,496,499,487,248,475,723
1000,505,482,475,251,482,733
1000,512,495,492,244,510,754
1000,498,478,480,229,517,746
1000,503,520,541,269,509,778
1000,506,498,514,260,498,758
1000,516,511,502,267,493,760
1000,500,496,498,250,508,758
1000,524,495,524,262,513,775
1000,489,508,509,246,498,744
1000,479,503,491,252,480,732
1000,502,464,493,236,514,750
1000,501,491,493,252,498,750
1000,519,478,483,239,524,763
1000,503,497,501,246,511,757
1000,473,474,478,213,517,730
1000,491,472,511,226,523,749
1000,469,522,522,241,494,735
1000,503,485,491,240,515,755
1000,539,502,489,280,483,763
1000,494,500,511,244,502,746
1000,498,519,498,265,480,745
1000,486,508,512,266,486,752
1000,502,532,494,271,489,760
1000,497,505,488,262,489,751
1000,519,487,494,247,516,763
1000,500,505,495,255,491,746
1000,523,509,499,265,491,756
1000,501,500,481,255,486,741
1000,465,513,486,236,495,731
1000,502,493,516,250,507,757
1000,501,486,478,241,509,750
1000,492,518,493,240,507,747
1000,508,497,489,252,489,741
1000,520,498,496,257,502,759
1000,502,509,496,259,497,756
1000,513,528,500,265,490,755
1000,476,483,504,231,504,735
1000,486,510,496,239,501,740
1000,489,548,497,280,454,734
1000,490,499,497,253,484,737
1000,483,507,495,234,511,745
1000,502,503,498,248,500,748
1000,520,510,492,262,503,765
1000,471,489,466,242,475,717
1000,478,502,486,226,515,741
1000,487,478,498,234,510,744
1000,518,480,502,248,510,758
1000,498,516,489,271,479,750
1000,478,466,493,222,512,734
1000,486,482,507,224,515,739
1000,513,497,488,249,493,742
1000,507,481,511,243,514,757
1000,492,490,540,255,509,764
1000,496,485,475,227,509,736
1000,487,488,470,240,487,727
1000,516,522,486,268,477,745
1000,496,490,513,242,505,747
1000,508,504,492,257,492,749
1000,533,518,496,276,489,765
1000,520,502,479,250,489,739
1000,514,511,505,265,503,768
1000,485,502,518,258,488,746
1000,517,500,514,259,508,767
1000,499,489,480,245,494,739
1000,499,482,488,253,486,739
1000,484,498,511,235,522,757
1000,521,498,502,267,500,767
1000,513,510,492,261,482,743
1000,526,498,479,248,485,733
1000,504,466,486,237,498,735
1000,502,493,505,241,515,756
1000,478,498,494,241,504,745
1000,497,481,512,247,514,761
1000,475,506,490,236,506,742
1000,500,506,480,242,502,744
1000,507,519,493,275,481,756
1000,523,491,501,251,523,774
1000,501,502,484,252,489,741
1000,475,521,491,249,490,739
1000,497,522,500,263,492,755
1000,508,487,517,236,526,762
1000,493,480,484,247,489,736
1000,513,505,498,269,479,748
1000,486,486,529,251,494,745
1000,496,505,494,264,498,762
1000,533,500,489,262,503,765
1000,487,516,495,250,499,749
1000,495,487,516,256,494,750
1000,511,515,485,263,480,743
1000,482,513,512,238,514,752
1000,516,494,496,260,489,749
1000,487,483,495,230,496,726
1000,477,525,491,254,470,724
1000,493,492,481,235,516,751
1000,508,522,505,264,486,750
1000,529,489,499,254,510,764
1000,529,509,500,278,488,766
1000,509,524,490,276,476,752
1000,510,527,474,274,478,752
1000,489,508,480,250,483,733
1000,509,515,503,248,521,769
1000,474,517,522,238,510,748
1000,493,490,496,246,504,750
1000,471,536,499,262,473,735
1000,492,500,495,260,481,741
1000,487,481,525,226,532,758
1000,499,510,484,263,473,736
1000,494,507,512,253,491,744
1000,509,485,514,249,512,761
1000,486,506,489,246,492,738
1000,481,502,508,255,490,745
1000,507,526,512,273,489,762
1000,480,536,499,258,475,733
1000,527,512,538,271,507,778
1000,515,498,511,265,510,775
1000,515,489,508,271,497,768
1000,499,484,514,237,505,742
1000,498,496,502,236,515,751
1000,481,485,497,229,501,730
1000,504,471,519,248,500,748
1000,487,484,494,223,495,718
1000,483,507,493,246,488,734
1000,479,483,516,234,526,760
1000,481,519,489,253,484,737
1000,527,519,542,285,496,781
1000,516,487,463,248,494,742
1000,520,525,501,276,474,750
1000,469,502,509,245,493,738
1000,482,516,477,246,483,729
1000,517,512,492,268,497,765
1000,504,519,496,266,472,738
1000,538,524,489,276,490,766
1000,488,492,518,247,507,754
1000,505,496,542,241,524,765
1000,498,493,498,253,504,757
1000,490,490,485,229,499,728
1000,490,484,521,232,523,755
1000,479,474,499,217,537,754
1000,533,514,506,278,492,770
1000,506,511,494,274,481,755
1000,494,490,485,229,505,734
1000,498,520,512,261,480,741
1000,511,473,513,244,504,748
1000,486,463,497,238,512,750
1000,506,508,495,259,492,751
1000,467,497,507,230,503,733
1000,498,490,508,241,519,760
1000,507,471,504,241,518,759
1000,486,476,506,226,523,749
1000,488,494,477,252,461,713
1000,520,501,506,273,489,762
1000,533,505,518,269,507,776
1000,516,515,504,263,499,762
1000,504,500,476,249,479,728
1000,490,481,467,249,475,724
1000,489,510,502,264,479,743
1000,498,508,491,245,496,741
1000,494,472,489,236,506,742
1000,517,496,508,257,502,759
1000,504,500,465,251,474,725
1000,467,505,527,237,502,739
1000,521,501,523,255,507,762
1000,488,500,498,246,483,729
1000,506,524,527,271,498,769
1000,485,470,504,228,510,738
1000,498,504,508,264,478,742
1000,518,522,509,268,507,775
1000,510,518,485,273,480,753
1000,508,501,499,246,502,748
1000,485,496,527,232,524,756
1000,520,473,511,241,527,768
1000,483,491,510,231,512,743
1000,485,512,496,254,485,739
1000,458,499,509,240,483,723
1000,489,511,504,254,498,752
1000,484,501,510,241,515,756
1000,496,516,505,254,506,760
1000,467,516,498,252,473,725
1000,493,482,489,236,510,746
1000,475,507,503,239,500,739
1000,508,497,514,256,505,761
1000,510,492,493,250,497,747
1000,503,473,522,236,529,765
1000,481,499,454,244,462,706
1000,514,493,522,267,503,770
1000,501,505,489,250,492,742
1000,507,485,470,249,493,742
1000,524,492,513,249,525,774
1000,491,502,500,238,516,754
1000,494,524,509,252,505,757
1000,480,488,512,236,502,738
1000,499,483,512,223,523,746
1000,505,477,499,244,505,749
1000,512,490,491,264,484,748
1000,526,519,502,273,500,773
1000,542,487,500,247,519,766
1000,504,492,493,259,506,765
1000,519,492,494,270,495,765
1000,492,492,496,245,491,736
1000,502,483,491,241,491,732
1000,504,499,518,257,502,759
1000,495,506,502,251,512,763
1000,522,514,507,257,500,757
1000,483,491,502,234,521,755
1000,491,480,483,234,501,735
1000,490,493,492,229,507,736
1000,517,449,503,226,548,774
1000,508,504,481,269,471,740
1000,521,505,493,247,510,757
1000,496,492,503,252,487,739
1000,523,494,512,248,519,767
1000,507,489,512,238,513,751
1000,481,523,500,264,470,734
1000,502,487,503,246,495,741
1000,478,504,497,241,498,739
1000,504,502,500,254,489,743
1000,533,494,479,273,483,756
1000,498,480,501,247,495,742
1000,498,517,518,258,511,769
1000,489,502,503,236,504,740
1000,473,481,512,215,531,746
1000,496,506,472,252,503,755
1000,496,509,486,260,472,732
1000,491,477,487,221,501,722
1000,486,460,469,227,512,739
1000,508,508,511,253,509,762
1000,502,510,537,253,518,771
1000,492,508,486,256,490,746
1000,518,502,492,254,509,763
1000,481,503,473,230,485,715
1000,491,476,516,238,507,745
1000,493,489,486,226,514,740
1000,484,505,488,248,485,733
1000,465,519,488,247,480,727
1000,506,492,522,256,511,767
1000,489,504,497,247,492,739
1000,489,496,494,238,496,734
1000,478,500,501,242,501,743
1000,509,491,484,244,504,748
1000,481,531,509,259,488,747
1000,495,496,477,251,495,746
1000,496,495,501,247,505,752
1000,490,497,490,244,489,733
1000,511,514,512,244,519,763
1000,478,498,477,231,482,713
1000,490,501,550,250,529,779
1000,514,476,504,249,512,761
1000,497,496,491,257,469,726
1000,500,518,522,253,516,769
1000,495,514,494,260,479,739
1000,497,494,514,231,521,752
1000,510,505,511,256,515,771
1000,494,517,519,263,492,755
1000,495,489,520,246,514,760
1000,485,477,493,230,512,742
1000,506,504,484,255,494,749
1000,496,493,482,237,501,738
1000,504,531,499,268,486,754
1000,523,500,520,259,507,766
1000,508,506,478,257,480,737
1000,472,511,512,247,498,745
1000,486,509,524,243,505,748
1000,492,504,499,246,494,740
1000,498,476,480,236,506,742
1000,485,518,511,255,495,750
1000,495,503,508,264,487,751
1000,495,491,494,254,489,743
1000,493,527,488,258,478,736
1000,489,510,516,251,497,748
1000,464,529,498,242,491,733
1000,514,499,541,256,518,774
1000,472,497,494,235,489,724
1000,499,525,493,256,487,743
1000,521,478,497,238,526,764
1000,522,488,503,252,524,776
1000,488,484,487,239,488,727
1000,501,462,491,233,508,741
1000,490,480,484,235,502,737
1000,514,539,502,283,483,766
1000,503,494,481,247,499,746
1000,481,479,519,225,520,745
1000,538,489,495,261,507,768
1000,534,536,504,279,494,773
1000,519,488,516,251,510,761
1000,503,472,492,239,506,745
1000,494,453,500,223,525,748
1000,492,505,506,253,486,739
1000,505,496,480,250,503,753
1000,514,512,503,253,506,759
1000,513,479,507,246,511,757
1000,487,466,481,223,519,742
1000,489,471,520,224,533,757
1000,498,522,508,266,506,772
1000,507,518,514,257,505,762
1000,512,514,524,260,506,766
1000,541,501,519,276,507,783
1000,510,488,497,261,489,750
1000,505,496,509,256,508,764
1000,511,492,473,253,506,759
1000,519,479,502,255,513,768
1000,508,526,516,273,499,772
1000,529,491,461,251,488,739
1000,495,495,495,245,503,748
1000,538,485,504,262,510,772
1000,488,484,512,231,520,751
1000,526,539,517,277,491,768
1000,486,489,524,247,516,763
1000,513,473,495,240,526,766
1000,470,497,515,223,505,728
1000,496,504,475,233,501,734
1000,513,502,517,251,518,769
1000,515,502,498,272,493,765
1000,548,514,505,284,484,768
1000,504,518,534,254,516,770
1000,530,505,469,263,495,758
1000,478,494,510,222,530,752
1000,493,540,509,270,478,748
1000,498,532,480,255,488,743
1000,488,519,489,260,478,738
1000,512,523,513,268,503,771
1000,501,517,501,261,491,752
1000,460,502,524,232,513,745
1000,512,508,479,246,493,739
1000,493,529,489,259,484,743
1000,520,468,501,240,513,753
1000,490,502,468,249,478,727
1000,535,502,506,276,495,771
1000,488,537,516,275,462,737
1000,472,501,511,245,499,744
1000,504,479,498,236,517,753
1000,500,506,513,251,508,759
1000,457,477,483,218,510,728
1000,529,484,488,250,513,763
1000,495,485,482,245,490,735
1000,518,481,523,247,519,766
1000,511,486,466,258,488,746
1000,487,488,498,224,523,747
1000,509,506,525,261,508,769
1000,520,507,489,261,496,757
1000,528,470,503,240,519,759
1000,510,511,499,265,500,765
1000,530,471,510,251,519,770
1000,465,501,533,237,514,751
1000,494,503,514,244,505,749
1000,478,514,487,240,470,710
1000,520,501,509,253,501,754
1000,510,498,506,244,493,737
1000,548,501,493,267,499,766
1000,498,490,508,238,509,747
1000,484,489,503,234,516,750
1000,493,507,528,240,520,760
1000,509,501,507,258,505,763
1000,493,516,502,267,481,748
1000,501,487,490,248,508,756
1000,478,501,488,232,509,741
1000,494,517,515,240,518,758
1000,499,505,476,253,494,747
1000,455,501,477,239,474,713
1000,505,480,496,239,514,753
1000,499,486,514,230,530,760
1000,473,517,496,243,492,735
1000,527,512,494,263,496,759
1000,525,492,500,256,505,761
1000,502,501,497,251,498,749
1000,488,509,467,251,473,724
1000,516,465,534,246,528,774
1000,492,491,503,236,508,744
1000,498,489,500,247,508,755
1000,506,473,507,234,525,759
1000,485,500,486,239,502,741
1000,503,498,508,244,497,741
1000,477,485,503,239,500,739
1000,480,503,523,242,514,756
1000,504,480,508,256,494,750
1000,517,501,472,257,481,738
1000,502,517,488,255,497,752
1000,486,529,504,259,490,749
1000,499,510,491,250,499,749
1000,499,485,479,244,489,733
1000,474,498,505,239,489,728
1000,497,494,513,257,516,773
1000,513,486,510,244,531,775
1000,505,491,525,258,501,759
1000,497,479,491,232,516,748
1000,507,487,497,248,505,753
1000,499,497,512,254,498,752
1000,484,457,505,218,519,737
1000,468,502,460,236,481,717
1000,488,471,522,219,515,734
1000,499,484,473,243,495,738
1000,487,507,505,250,498,748
1000,484,504,509,231,496,727
1000,503,526,501,274,472,746
1000,523,493,508,272,498,770
1000,494,496,480,245,487,732
1000,483,469,500,238,504,742
1000,520,496,512,259,519,778
1000,506,491,528,249,514,763
1000,492,480,500,237,512,749
1000,504,510,494,262,492,754
1000,521,509,486,278,480,758
1000,482,503,516,247,497,744
1000,497,492,490,236,505,741
1000,481,503,496,248,493,741
1000,493,487,497,230,523,753
1000,486,508,522,244,507,751
1000,497,522,480,259,475,734
1000,498,474,509,230,522,752
1000,494,501,514,248,498,746
1000,477,518,496,247,496,743
1000,489,502,486,238,499,737
1000,499,497,536,246,518,764
1000,462,497,515,227,501,728
1000,493,480,501,242,497,739
1000,507,524,495,267,501,768
1000,484,479,498,242,469,711
1000,510,490,499,258,516,774
1000,533,519,479,289,465,754
1000,488,503,522,244,496,740
1000,478,522,499,250,499,749
1000,499,486,497,247,504,751
1000,498,503,476,264,471,735
1000,491,484,513,239,512,751
1000,504,534,524,274,488,762
1000,512,490,514,256,507,763
1000,488,506,501,232,511,743
1000,479,509,486,261,469,730
1000,501,499,497,256,484,740
1000,473,517,469,246,476,722
1000,486,476,485,229,518,747
1000,507,472,488,237,516,753
1000,486,460,519,225,514,739
1000,501,490,505,256,506,762
1000,494,516,489,264,485,749
1000,497,474,481,229,510,739
1000,483,501,514,256,499,755
1000,516,506,504,260,508,768
1000,522,504,484,274,500,774
1000,496,504,525,247,506,753
1000,521,485,489,251,502,753
1000,482,494,518,227,538,765
1000,507,479,500,259,487,746
1000,519,498,517,260,513,773
1000,503,500,496,255,498,753
1000,526,517,480,280,489,769
1000,518,478,529,249,532,781
1000,508,510,497,256,485,741
1000,476,502,493,234,490,724
1000,499,515,519,255,498,753
1000,510,492,504,251,525,776
1000,499,481,508,238,523,761
1000,522,499,501,259,499,758
1000,487,526,515,251,491,742
1000,486,484,503,249,500,749
1000,504,518,517,255,505,760
1000,492,493,484,237,503,740
1000,503,499,496,248,513,761
1000,504,505,510,253,510,763
1000,490,500,492,249,491,740
1000,509,505,503,272,502,774
1000,498,491,511,247,515,762
1000,482,491,469,238,475,713
1000,480,506,500,237,496,733
1000,516,497,518,259,500,759
1000,533,497,507,268,507,775
1000,504,507,511,248,514,762
1000,490,499,502,245,509,754
1000,501,499,493,251,490,741
1000,505,510,523,261,520,781
1000,488,515,510,261,477,738
1000,499,509,521,252,517,769
1000,509,505,479,243,507,750
1000,500,501,489,263,495,758
1000,497,524,479,256,477,733
1000,487,511,490,244,499,743
1000,512,519,514,264,478,742
1000,499,471,501,229,517,746
1000,495,516,488,264,488,752
1000,511,535,499,277,478,755
1000,502,504,501,259,502,761
1000,515,489,533,248,522,770
1000,511,514,500,259,484,743
1000,492,483,491,236,494,730
1000,509,463,494,247,487,734
1000,500,517,519,248,505,753
1000,468,504,513,242,497,739
1000,520,496,502,262,501,763
1000,507,495,481,255,495,750
1000,500,504,513,251,496,747
1000,474,510,495,252,475,727
1000,482,466,497,233,508,741
1000,476,504,509,240,501,741
1000,502,492,493,238,521,759
1000,518,519,494,268,487,755
1000,500,487,477,250,488,738
1000,503,501,515,261,491,752
1000,482,520,498,254,492,746
1000,522,511,499,261,502,763
1000,499,529,483,267,481,748
1000,493,497,530,247,517,764
1000,488,492,517,250,509,759
1000,527,522,481,261,506,767
1000,500,496,496,251,506,757
1000,478,486,505,235,500,735
1000,511,499,491,245,505,750
1000,505,516,540,266,484,750
1000,501,486,502,239,499,738
1000,507,498,481,248,506,754
1000,482,479,512,228,525,753
1000,499,476,477,221,509,730
1000,453,507,487,223,482,705
1000,546,487,476,263,505,768
1000,481,501,510,237,510,747
1000,492,469,526,237,528,765
1000,505,517,494,254,495,749
1000,476,501,489,237,502,739
1000,501,500,480,257,480,737
1000,525,517,463,288,450,738
1000,489,480,488,242,494,736
1000,510,496,482,240,498,738
1000,521,497,510,263,496,759
1000,509,509,504,242,514,756
1000,507,500,511,257,505,762
1000,483,486,509,233,504,737
1000,482,501,492,246,486,732
1000,501,485,508,237,519,756
1000,499,499,510,253,511,764
1000,491,506,511,250,490,740
1000,502,483,492,247,495,742
1000,523,495,510,257,506,763
1000,493,528,495,267,475,742
1000,485,512,516,236,510,746
1000,506,469,488,240,503,743
1000,492,495,485,255,481,736
1000,485,511,495,253,480,733
1000,488,495,532,240,519,759
1000,526,501,492,272,483,755
1000,497,508,531,243,509,752
1000,500,515,487,270,478,748
1000,494,511,505,242,496,738
1000,482,477,497,237,503,740
1000,494,509,514,247,506,753
1000,527,484,488,261,499,760
1000,499,498,519,252,512,764
1000,501,510,512,235,530,765
1000,493,483,511,236,507,743
1000,524,504,502,258,507,765
1000,486,513,507,248,505,753
1000,514,511,502,262,495,757
1000,492,492,491,236,508,744
1000,493,519,508,269,474,743
1000,541,500,480,262,496,758
1000,500,525,502,253,512,765
1000,488,516,508,264,484,748
1000,524,485,479,251,496,747
1000,483,478,510,235,506,741
1000,508,499,478,250,499,749
1000,512,507,507,247,513,760
1000,489,520,492,254,490,744
1000,497,506,499,248,496,744
1000,492,473,472,227,509,736
1000,488,505,497,251,496,747
1000,519,503,503,274,486,760
1000,511,513,495,264,489,753
1000,506,513,505,263,493,756
1000,502,488,504,234,527,761
1000,530,515,504,263,501,764
1000,489,495,520,241,516,757
1000,516,476,494,245,508,753
1000,500,479,503,245,508,753
1000,490,487,519,245,510,755
1000,512,505,507,262,488,750
1000,517,501,473,259,474,733
1000,502,520,500,271,479,750
1000,511,506,507,257,508,765
1000,506,480,510,251,506,757
1000,486,504,522,244,510,754
1000,523,504,495,276,471,747
1000,501,534,496,277,474,751
1000,490,494,510,236,510,746
1000,485,493,486,236,495,731
1000,489,510,466,247,465,712
1000,502,515,508,242,518,760
1000,511,478,474,229,512,741
1000,479,507,490,248,489,737
1000,512,517,496,276,475,751
1000,480,476,513,231,518,749
1000,495,493,518,253,508,761
1000,514,517,478,266,488,754
1000,470,499,482,231,480,711
1000,502,510,491,253,498,751
1000,498,514,491,265,481,746
1000,496,514,503,255,500,755
1000,489,499,479,238,488,726
1000,495,491,490,258,476,734
1000,481,519,511,247,500,747
1000,511,504,486,246,503,749
1000,517,507,500,263,505,768
1000,499,497,480,245,497,742
1000,509,497,513,263,489,752
1000,535,482,501,247,525,772
1000,495,491,514,242,514,756
1000,511,489,478,252,496,748
1000,525,486,501,248,513,761
1000,501,499,498,241,513,754
1000,478,473,474,242,476,718
1000,510,510,519,248,499,747
1000,522,487,524,249,530,779
1000,468,484,511,225,514,739
1000,519,487,519,244,526,770
1000,500,506,477,237,496,733
1000,499,520,482,272,460,732
1000,502,498,502,250,505,755
1000,467,500,475,239,487,726
1000,503,516,506,269,486,755
1000,501,488,501,235,510,745
1000,494,480,530,237,536,773
1000,481,509,498,243,505,748
1000,511,489,496,251,490,741
1000,476,525,509,251,500,751
1000,487,463,494,237,508,745
1000,520,517,496,276,483,759
1000,498,516,501,260,473,733
1000,525,504,471,269,476,745
1000,477,494,513,230,501,731
1000,514,482,479,247,511,758
1000,498,494,501,244,515,759
1000,486,502,505,240,498,738
1000,484,524,506,255,485,740
1000,485,536,492,264,456,720
1000,507,491,483,267,483,750
1000,500,516,503,264,475,739
1000,500,514,515,264,490,754
1000,516,477,497,241,514,755
1000,530,492,511,258,519,777
1000,507,515,482,269,477,746
1000,490,485,500,235,508,743
1000,486,475,485,234,509,743
1000,478,505,502,244,507,751
1000,517,486,515,250,514,764
1000,464,479,508,223,528,751
1000,499,497,521,253,514,767
1000,509,460,484,244,490,734
1000,530,480,469,239,505,744
1000,502,495,490,252,501,753
1000,489,499,475,232,495,727
1000,502,494,502,244,491,735
1000,506,524,499,263,486,749
1000,470,483,495,221,502,723
1000,517,476,521,234,546,780
1000,513,495,486,248,508,756
1000,505,512,496,256,494,750
1000,497,524,498,262,486,748
1000,501,488,496,252,497,749
1000,546,509,474,268,496,764
1000,560,491,471,269,491,760
1000,509,467,517,230,526,756
1000,503,494,541,251,531,782
1000,500,501,514,249,503,752
1000,476,512,501,240,486,726
1000,503,484,506,256,493,749
1000,481,485,524,242,515,757
1000,513,507,476,256,492,748
1000,514,524,509,267,488,755
1000,487,496,486,244,490,734
1000,506,516,510,265,504,769
1000,467,530,521,259,481,740
1000,493,492,475,240,507,747
1000,478,499,489,235,500,735
1000,490,503,478,253,487,740
1000,484,478,498,236,503,739
1000,522,479,506,254,516,770
1000,505,516,540,260,513,773
1000,531,491,501,262,502,764
1000,496,479,496,245,493,738
1000,475,503,498,250,489,739
1000,473,483,483,233,484,717
1000,511,481,495,243,507,750
1000,469,486,504,219,518,737
1000,487,483,499,240,506,746
1000,484,495,503,244,500,744
1000,500,468,483,244,503,747
1000,498,536,490,267,483,750
1000,500,496,508,235,526,761
1000,482,500,524,241,511,752
1000,474,511,480,238,500,738
1000,529,515,523,268,511,779
1000,511,513,502,270,480,750
1000,547,496,516,267,517,784
1000,504,502,498,255,496,751
1000,500,492,533,246,518,764
1000,494,500,521,248,514,762
1000,504,474,479,236,518,754
1000,495,494,479,245,500,745
1000,502,499,519,246,499,745
1000,496,500,508,256,492,748
1000,497,524,517,265,480,745
1000,504,518,504,265,503,768
1000,514,520,493,266,494,760
1000,484,509,486,242,505,747
1000,498,509,489,268,467,735
1000,519,494,503,260,499,759
1000,466,497,513,234,512,746
1000,495,514,502,263,491,754
1000,493,509,538,251,507,758
1000,492,501,488,241,508,749
1000,511,520,502,277,472,749
1000,489,495,499,247,491,738
1000,488,512,494,270,458,728
1000,469,492,497,234,507,741
1000,491,491,489,242,495,737
1000,476,505,488,243,480,723
1000,519,484,501,268,492,760
1000,503,494,503,254,497,751
1000,479,505,496,240,493,733
1000,511,559,511,279,474,753
1000,508,518,489,262,494,756
1000,484,499,486,233,511,744
1000,515,476,483,249,497,746
1000,508,510,516,275,489,764
1000,495,525,497,260,482,742
1000,513,498,510,249,519,768
1000,491,489,527,246,515,761
1000,505,480,506,229,529,758
1000,505,510,489,257,487,744
1000,527,527,492,264,480,744
1000,480,497,463,238,487,725
1000,523,501,501,252,515,767
1000,504,480,488,237,500,737
1000,493,512,509,253,491,744
1000,492,489,488,237,514,751
1000,478,475,504,235,498,733
1000,511,490,481,260,489,749
1000,510,523,504,273,491,764
1000,516,503,505,251,510,761
1000,493,510,484,243,509,752
1000,528,489,468,262,500,762
1000,472,474,489,220,514,734
1000,479,516,501,231,506,737
1000,467,505,506,231,512,743
1000,488,498,509,240,515,755
1000,483,486,508,239,524,763
1000,462,507,495,237,496,733
1000,473,481,500,224,525,749
1000,502,485,514,248,497,745
1000,488,526,483,245,499,744
1000,518,509,481,259,496,755
1000,517,498,454,261,474,735
1000,478,509,487,260,465,725
1000,511,500,527,258,510,768
1000,503,507,491,260,486,746
1000,461,502,508,240,494,734
1000,466,470,525,214,526,740
1000,492,476,457,228,494,722
1000,506,526,508,268,477,745
1000,504,517,480,260,488,748
1000,530,470,519,247,529,776
1000,491,480,496,236,509,745
1000,473,488,481,224,491,715
1000,520,504,494,253,493,746
1000,511,483,488,249,490,739
1000,492,513,514,253,500,753
1000,523,502,512,270,495,765
1000,499,493,503,248,498,746
1000,507,495,479,260,488,748
1000,496,518,479,262,493,755
1000,497,504,505,254,479,733
1000,508,486,535,244,529,773
1000,515,525,502,270,481,751
1000,497,478,518,250,512,762
1000,510,472,514,233,521,754
1000,506,485,483,246,499,745
1000,490,466,528,240,522,762
1000,536,525,503,293,473,766
1000,477,494,506,230,516,746
1000,489,505,500,249,507,756
1000,493,515,517,256,486,742
1000,513,521,492,273,484,757
1000,520,518,515,263,508,771
1000,498,475,476,236,492,728
1000,492,485,528,240,528,768
1000,525,534,499,281,478,759
1000,509,499,476,251,489,740
1000,527,492,498,267,488,755
1000,508,522,487,257,482,739
1000,479,486,496,223,515,738
1000,487,501,538,253,513,766
1000,496,495,493,255,493,748
1000,476,506,508,242,498,740
1000,528,478,513,246,515,761
1000,491,494,477,227,499,726
1000,489,506,498,242,507,749
1000,522,508,506,276,484,760
1000,512,542,517,282,486,768
1000,517,500,520,249,500,749
1000,505,505,476,263,463,726
1000,526,493,506,268,488,756
1000,511,481,492,259,498,757
1000,472,481,515,231,514,745
1000,536,503,508,262,515,777
1000,481,526,527,257,499,756
1000,482,492,470,232,482,714
1000,487,516,512,247,497,744
1000,482,505,490,248,481,729
1000,481,513,471,251,471,722
1000,477,515,476,264,468,732
1000,495,499,492,249,506,755
1000,506,479,481,246,502,748
1000,515,531,502,258,497,755
1000,491,505,497,237,502,739
1000,484,524,470,250,470,720
1000,511,489,499,256,504,760
1000,474,502,477,242,490,732
1000,510,488,504,243,507,750
1000,489,470,481,235,498,733
1000,502,495,513,236,525,761
1000,495,455,510,214,531,745
1000,546,506,490,278,487,765
1000,496,511,504,246,508,754
1000,496,514,523,256,503,759
1000,475,487,505,220,513,733
1000,467,500,507,237,503,740
1000,461,504,497,238,479,717
1000,493,498,487,253,492,745
1000,507,511,477,261,473,734
1000,522,489,483,265,490,755
1000,496,509,489,243,495,738
1000,513,490,486,257,502,759
1000,466,506,515,240,505,745
1000,500,520,507,262,491,753
1000,516,507,497,248,521,769
1000,479,521,483,267,474,741
1000,503,485,502,237,521,758
1000,523,497,497,255,516,771
1000,486,481,509,230,512,742
1000,501,495,496,249,506,755
1000,480,486,512,231,511,742
1000,530,511,508,275,511,786
1000,496,540,487,271,470,741
1000,496,484,487,251,480,731
1000,495,527,500,270,477,747
1000,521,511,475,260,492,752
1000,508,495,477,249,481,730
1000,483,494,493,246,493,739
1000,505,483,487,233,517,750
1000,518,525,510,264,511,775
1000,521,505,493,263,485,748
1000,521,480,483,261,502,763
1000,490,497,503,246,520,766
1000,524,474,499,249,512,761
1000,537,504,493,261,496,757
1000,499,497,491,242,489,731
1000,524,525,476,288,458,746
1000,464,501,501,232,498,730
1000,508,491,489,242,506,748
1000,506,485,483,249,497,746
1000,503,508,540,255,508,763
1000,469,461,508,211,525,736
1000,531,527,483,282,482,764
1000,472,517,488,243,493,736
1000,492,512,492,238,501,739
1000,488,491,503,242,515,757
1000,515,507,481,276,468,744
1000,510,504,517,258,512,770
1000,511,507,521,260,504,764
1000,484,508,482,248,476,724
1000,503,505,507,268,480,748
1000,509,511,512,243,525,768
1000,498,495,494,258,481,739
1000,525,489,496,253,522,775
1000,520,503,476,260,491,751
1000,501,503,499,247,495,742
1000,505,500,523,256,498,754
1000,497,525,495,250,500,750
1000,499,503,473,250,500,750
1000,450,505,501,239,490,729
1000,486,520,501,260,470,730
1000,497,516,474,258,476,734
1000,494,506,528,258,511,769
1000,513,509,493,278,478,756
1000,463,466,515,221,513,734
1000,495,499,475,255,490,745
1000,488,495,483,230,509,739
1000,498,518,509,240,532,772
1000,505,508,497,241,522,763
1000,502,520,507,261,496,757
1000,492,515,508,242,491,733
1000,511,488,486,248,497,745
1000,514,502,504,245,515,760
1000,517,496,518,269,498,767
1000,482,492,479,246,471,717
1000,500,491,500,259,486,745
1000,483,508,498,247,492,739
1000,526,496,522,256,521,777
1000,508,500,518,247,515,762
1000,522,520,474,264,489,753
1000,506,500,515,251,529,780
1000,522,543,488,284,482,766
1000,517,492,512,247,499,746
1000,506,488,486,242,508,750
1000,506,483,496,250,490,740
1000,486,484,513,237,499,736
1000,525,497,539,252,533,785
1000,488,495,530,238,523,761
1000,520,491,517,250,518,768
1000,512,499,501,252,515,767
1000,509,487,495,249,506,755
1000,505,512,544,239,543,782
1000,458,532,493,247,488,735
1000,515,475,489,248,513,761
1000,487,463,489,213,502,715
1000,498,510,492,247,498,745
1000,492,483,496,243,494,737
1000,473,517,492,248,484,732
1000,519,492,479,262,487,749
1000,512,482,511,249,510,759
1000,523,499,481,246,504,750
1000,502,512,516,257,503,760
1000,510,492,507,272,483,755
1000,502,493,530,255,509,764
1000,504,511,478,257,484,741
1000,496,509,513,259,490,749
1000,501,493,502,261,482,743
1000,514,488,513,248,508,756
1000,505,469,493,243,507,750
1000,484,525,489,256,486,742
1000,467,540,469,250,480,730
1000,513,480,513,239,531,770
1000,521,489,479,262,482,744
1000,480,484,464,223,496,719
1000,491,481,491,236,498,734
1000,539,501,507,268,505,773
1000,523,520,496,291,462,753
1000,499,493,520,255,507,762
1000,525,475,514,252,513,765
1000,496,477,501,241,512,753
1000,499,506,476,263,480,743
1000,501,500,524,253,517,770
1000,499,508,508,247,512,759
1000,532,507,501,285,489,774
1000,503,484,498,260,500,760
1000,508,519,485,268,477,745
1000,494,506,505,250,493,743
1000,520,493,509,238,528,766
1000,510,500,495,257,483,740
1000,509,557,467,290,462,752
1000,500,494,495,237,510,747
1000,511,491,493,255,506,761
1000,490,493,521,234,532,766
1000,514,482,479,244,497,741
1000,490,509,471,256,482,738
1000,513,496,489,260,489,749
1000,509,503,490,264,474,738
1000,489,508,494,249,481,730
1000,504,512,508,253,509,762
1000,527,490,484,255,512,767
1000,482,508,504,250,493,743
1000,470,525,476,246,475,721
1000,522,517,508,281,477,758
1000,490,473,516,219,526,745
1000,475,496,494,233,508,741
1000,519,482,497,243,508,751
1000,493,523,480,253,485,738
1000,527,475,494,249,521,770
1000,500,501,521,263,491,754
1000,480,490,500,233,502,735
1000,505,469,462,240,499,739
1000,472,487,484,239,478,717
1000,532,507,488,271,480,751
1000,495,513,497,245,495,740
1000,514,528,522,279,485,764
1000,510,522,498,279,471,750
1000,525,511,461,275,475,750
1000,512,503,487,246,522,768
1000,486,501,508,247,498,745
1000,515,517,484,269,467,736
1000,479,516,494,256,485,741
1000,515,499,466,251,507,758
1000,523,482,496,254,505,759
1000,510,518,483,254,502,756
1000,476,512,504,238,496,734
1000,509,516,509,270,492,762
1000,489,505,493,246,500,746
1000,484,502,492,242,492,734
1000,501,481,505,231,518,749
1000,485,482,505,237,508,745
1000,500,496,495,239,510,749
1000,514,524,522,261,515,776
1000,501,496,519,256,499,755
1000,510,488,502,236,526,762
1000,501,510,491,257,495,752
1000,500,483,489,254,496,750
1000,486,515,492,266,463,729
1000,478,521,481,261,458,719
1000,519,504,522,256,528,784
1000,511,480,506,249,510,759
1000,499,502,516,244,502,746
1000,528,503,509,259,513,772
1000,484,473,493,237,501,738
1000,512,482,497,241,508,749
1000,503,534,515,264,505,769
1000,503,509,489,265,486,751
1000,497,469,486,243,493,736
1000,467,535,486,245,479,724
1000,493,519,498,257,483,740
1000,484,514,503,255,495,750
1000,499,531,490,279,453,732
1000,520,515,514,273,507,780
1000,497,509,495,260,485,745
1000,502,510,505,241,518,759
1000,491,510,511,246,506,752
1000,493,505,523,240,519,759
1000,499,511,512,257,506,763
1000,505,508,515,263,491,754
1000,501,517,510,254,495,749
1000,496,502,495,247,499,746
1000,524,482,472,253,505,758
1000,494,506,480,259,473,732
1000,476,531,495,258,479,737
1000,483,479,503,230,503,733
1000,511,504,505,268,485,753
1000,488,475,494,218,512,730
1000,502,536,476,271,457,728
1000,502,507,507,247,504,751
1000,495,535,500,264,477,741
1000,478,449,478,224,505,729
1000,518,501,488,272,488,760
1000,502,510,507,255,502,757
1000,519,491,504,260,495,755
1000,497,513,505,251,493,744
1000,516,516,501,268,479,747
1000,497,486,526,251,520,771
1000,479,509,470,241,480,721
1000,489,486,515,231,531,762
1000,508,495,485,250,506,756
1000,461,513,465,229,478,707
1000,518,497,496,267,492,759
1000,485,509,487,239,496,735
1000,525,513,479,280,485,765
1000,476,498,510,236,504,740
1000,491,490,501,240,497,737
1000,467,507,513,241,493,734
1000,477,505,498,240,496,736
1000,517,471,518,248,507,755
1000,485,487,504,240,502,742
1000,517,510,519,258,501,759
1000,469,489,517,243,498,741
1000,514,496,522,257,526,783
1000,497,473,494,233,505,738
1000,499,475,523,241,508,749
1000,499,501,501,248,507,755
1000,500,490,496,227,529,756
1000,508,476,477,244,504,748
1000,490,484,494,239,509,748
1000,504,497,490,241,496,737
1000,496,504,498,248,494,742
1000,530,496,517,263,502,765
1000,506,479,500,236,525,761
1000,502,482,509,230,531,761
1000,524,484,530,263,523,786
1000,505,501,515,243,507,750
1000,476,497,500,226,513,739
1000,501,482,501,245,517,762
1000,490,500,505,236,513,749
1000,494,503,537,238,517,755
1000,504,510,493,261,496,757
1000,509,501,485,243,507,750
1000,509,500,517,256,498,754
1000,501,489,487,230,514,744
1000,460,494,484,221,503,724
1000,497,495,486,243,497,740
1000,494,491,524,242,527,769
1000,526,491,503,263,513,776
1000,492,492,510,247,496,743
1000,492,489,518,234,523,757
1000,498,506,508,247,497,744
1000,492,494,503,240,510,750
1000,472,497,506,239,513,752
1000,482,486,490,255,488,743
1000,463,518,515,235,508,743
1000,479,482,507,236,504,740
1000,494,519,493,264,469,733
1000,483,498,493,228,518,746
1000,517,524,497,282,471,753
1000,484,507,484,252,485,737
1000,499,512,501,256,488,744
1000,511,506,521,260,514,774
1000,504,478,495,239,524,763
1000,478,509,527,248,497,745
1000,511,501,501,259,487,746
1000,491,471,486,240,504,744
1000,476,489,495,231,511,742
1000,518,517,525,265,511,776
1000,486,496,524,236,506,742
1000,498,504,510,232,520,752
1000,498,480,496,252,491,743
1000,504,524,499,267,479,746
1000,506,499,501,258,488,746
1000,503,498,488,247,491,738
1000,486,479,531,231,516,747
1000,488,499,511,240,498,738
1000,493,500,511,258,480,738
1000,519,523,486,277,492,769
1000,499,519,494,248,489,737
1000,513,498,511,242,526,768
1000,496,486,497,243,523,766
1000,486,490,492,242,504,746
1000,491,513,528,254,517,771
1000,492,500,501,244,503,747
1000,499,535,470,261,467,728
1000,491,500,470,239,485,724
1000,483,487,500,238,495,733
1000,486,505,472,249,482,731
1000,495,496,487,246,489,735
1000,483,490,512,224,516,740
1000,505,529,516,276,490,766
1000,509,489,509,248,507,755
1000,473,520,509,254,489,743
1000,512,517,485,263,497,760
1000,481,481,496,230,513,743
1000,501,511,498,241,493,734
1000,491,497,535,225,533,758
1000,506,500,482,258,493,751
1000,487,477,506,227,517,744
1000,512,487,510,239,528,767
1000,492,504,483,251,496,747
1000,509,507,531,263,506,769
1000,494,506,478,253,486,739
1000,518,499,501,257,509,766
1000,492,481,487,235,507,742
1000,506,523,492,264,476,740
1000,464,487,495,222,500,722
1000,513,492,484,249,494,743
1000,513,493,490,254,500,754
1000,506,506,491,244,508,752
1000,484,472,489,226,517,743
1000,484,489,496,238,513,751
1000,517,504,519,264,498,762
1000,491,515,511,260,490,750
1000,517,467,510,260,498,758
1000,513,507,494,256,507,763
1000,512,510,511,262,495,757
1000,496,495,479,243,508,751
1000,488,499,493,248,489,737
1000,510,534,514,275,481,756
1000,484,517,484,256,478,734
1000,495,524,508,265,489,754
1000,490,511,498,245,496,741
1000,477,497,510,223,526,749
1000,494,491,503,231,517,748
1000,495,508,511,268,481,749
1000,482,513,476,249,485,734
1000,511,505,476,268,480,748
1000,508,522,489,256,494,750
1000,488,493,472,242,481,723
1000,518,507,479,260,476,736
1000,488,520,490,258,483,741
1000,530,500,461,275,476,751
1000,488,490,518,239,524,763
1000,511,469,481,225,512,737
1000,513,488,550,257,527,784
1000,513,500,491,248,494,742
1000,492,520,471,262,473,735
1000,501,507,511,257,501,758
1000,543,502,511,267,496,763
1000,509,511,473,260,475,735
1000,490,520,516,260,482,742
1000,526,500,506,252,514,766
1000,515,494,511,239,519,758
1000,529,515,505,288,482,770
1000,487,488,496,229,520,749
1000,512,511,484,271,487,758
1000,478,497,513,246,488,734
1000,505,526,481,271,486,757
1000,485,489,523,228,523,751
1000,498,485,506,231,540,771
1000,502,500,496,237,508,745
1000,485,531,499,259,476,735
1000,511,531,490,271,486,757
1000,522,506,452,256,485,741
1000,472,523,488,235,499,734
1000,512,490,496,260,488,748
1000,516,513,488,268,474,742
1000,504,493,497,243,487,730
1000,490,486,494,233,513,746
1000,521,504,489,267,499,766
1000,512,515,520,268,495,763
1000,509,514,507,264,511,775
1000,536,512,525,272,512,784
1000,488,517,500,255,488,743
1000,522,498,504,266,487,753
1000,508,516,518,258,506,764
1000,475,496,508,233,514,747
1000,504,489,517,241,528,769
1000,505,503,517,259,492,751
1000,478,504,505,225,516,741
1000,495,512,511,259,502,761
1000,488,480,499,248,501,749
1000,477,486,534,234,519,753
1000,521,488,521,250,526,776
1000,472,513,511,252,479,731
1000,475,499,495,239,496,735
1000,474,501,516,238,513,751
1000,502,508,474,240,496,736
1000,515,495,492,253,507,760
1000,452,524,474,247,451,698
1000,508,489,508,239,511,750
1000,462,495,501,230,508,738
1000,487,520,516,248,491,739
1000,474,488,518,238,518,756
1000,514,514,502,255,502,757
1000,491,501,515,246,516,762
1000,496,518,491,255,493,748
1000,502,509,517,253,511,764
1000,503,491,463,254,480,734
1000,523,488,482,254,492,746
1000,539,506,492,275,491,766
1000,501,493,504,250,495,745
1000,483,500,474,241,475,716
1000,506,498,511,257,508,765
1000,486,478,484,233,515,748
1000,513,537,496,276,480,756
1000,480,496,491,239,485,724
1000,494,499,515,236,525,761
1000,513,483,501,255,497,752
1000,485,499,485,236,500,736
1000,510,494,516,236,516,752
1000,533,516,530,287,498,785
1000,509,504,488,241,498,739
1000,489,488,495,241,506,747
1000,488,504,491,241,503,744
1000,503,502,476,259,491,750
1000,475,493,499,236,502,738
1000,494,490,508,269,486,755
1000,484,531,502,237,490,727
1000,491,500,505,240,502,742
1000,497,493,501,236,512,748
1000,507,495,509,243,515,758
1000,516,535,482,270,493,763
1000,510,500,483,252,497,749
1000,520,511,519,254,505,759
1000,493,518,493,246,504,750
1000,511,521,503,272,502,774
1000,491,489,482,239,500,739
1000,506,470,510,237,506,743
1000,503,512,513,259,487,746
1000,496,516,498,260,477,737
1000,493,508,516,252,501,753
1000,484,510,498,257,491,748
1000,510,484,469,239,490,729
1000,483,503,480,249,489,738
1000,495,499,489,258,486,744
1000,500,489,479,246,485,731
1000,475,489,512,229,516,745
1000,487,507,494,262,479,741
1000,477,516,525,249,504,753
1000,485,494,498,238,500,738
1000,527,487,502,268,483,751
1000,496,491,499,246,490,736
1000,505,481,494,243,499,742
1000,483,478,509,223,521,744
1000,493,501,474,247,490,737
1000,499,519,501,260,496,756
1000,502,505,508,253,497,750
1000,498,507,482,256,479,735
1000,468,474,499,214,520,734
1000,498,508,508,245,525,770
1000,496,489,515,240,532,772
1000,495,498,499,241,518,759
1000,480,496,495,253,495,748
1000,492,514,485,257,483,740
1000,495,513,492,245,505,750
1000,512,494,486,254,494,748
1000,510,524,486,263,481,744
1000,513,534,513,269,485,754
1000,495,510,492,242,505,747
1000,523,504,503,255,503,758
1000,508,514,475,259,491,750
1000,499,477,504,233,509,742
1000,488,467,514,227,537,764
1000,506,521,489,255,487,742
1000,485,482,491,235,504,739
1000,489,489,522,231,529,760
1000,491,550,512,265,488,753
1000,505,520,464,254,474,728
1000,493,488,501,224,520,744
1000,516,496,526,264,504,768
1000,501,502,486,248,494,742
1000,508,481,480,242,499,741
1000,483,528,504,259,472,731
1000,521,486,475,262,492,754
1000,506,484,488,246,498,744
1000,502,509,491,270,474,744
1000,498,472,490,227,518,745
1000,523,497,533,268,508,776
1000,506,491,522,245,500,745
1000,492,502,496,255,494,749
1000,494,499,485,253,482,735
1000,495,493,490,242,498,740
1000,517,515,506,268,488,756
1000,487,475,487,229,498,727
1000,501,513,494,243,524,767
1000,506,484,509,252,498,750
1000,485,536,511,258,500,758
1000,490,480,499,241,515,756
1000,501,493,513,246,519,765
1000,497,517,485,259,471,730
1000,487,523,510,246,500,746
1000,497,495,481,259,480,739
1000,501,509,517,262,506,768
1000,510,506,501,258,490,748
1000,513,499,495,263,497,760
1000,514,478,533,251,522,773
1000,511,516,519,272,494,766
1000,492,498,534,249,515,764
1000,495,477,503,239,513,752
1000,519,475,498,247,489,736
1000,505,493,514,252,518,770
1000,492,489,499,232,520,752
1000,508,512,495,268,469,737
1000,508,501,502,254,507,761
1000,513,485,520,239,538,777
1000,541,511,495,274,488,762
1000,519,492,478,262,479,741
1000,528,509,499,271,490,761
1000,508,502,508,261,503,764
1000,529,510,497,279,499,778
1000,502,490,500,255,494,749
1000,495,517,496,249,487,736
1000,488,500,481,237,496,733
1000,502,469,497,241,493,734
1000,509,488,493,247,498,745
1000,462,502,520,235,507,742
1000,507,499,506,244,513,757
1000,483,494,501,231,518,749
1000,510,494,480,256,481,737
1000,510,493,470,262,480,742
1000,511,523,506,269,493,762
1000,503,524,483,265,469,734
1000,505,500,448,257,468,725
1000,478,511,499,246,512,758
1000,477,480,504,213,519,732
1000,503,500,511,253,498,751
1000,472,500,501,254,478,732
1000,525,513,490,277,480,757
1000,515,516,506,257,498,755
1000,497,524,490,261,479,740
1000,487,490,479,246,487,733
1000,524,502,519,276,483,759
1000,532,501,490,256,493,749
1000,502,491,501,242,511,753
1000,506,487,500,245,499,744
1000,493,506,513,254,505,759
1000,489,498,496,240,499,739
1000,481,506,527,243,520,763
1000,501,492,502,251,513,764
1000,517,508,487,262,487,749
1000,479,531,501,240,500,740
1000,521,517,509,271,483,754
1000,500,528,510,263,491,754
1000,480,517,479,245,477,722
1000,509,490,510,254,489,743
1000,483,489,492,222,513,735
1000,480,494,499,234,510,744
1000,492,509,518,247,507,754
1000,524,484,489,262,480,742
1000,479,498,499,236,496,732
1000,518,493,480,244,508,752
1000,506,460,496,232,519,751
1000,491,479,463,255,458,713
1000,480,507,496,240,485,725
1000,493,511,479,261,473,734
1000,484,511,510,248,502,750
1000,498,490,485,233,506,739
1000,521,525,491,264,493,757
1000,472,510,528,258,486,744
1000,480,503,503,242,510,752
1000,526,515,505,281,483,764
1000,530,504,490,287,464,751
1000,475,538,506,248,494,742
1000,515,493,524,253,523,776
1000,473,476,489,222,513,735
1000,477,476,483,221,502,723
1000,503,482,481,248,483,731
1000,500,488,518,240,527,767
1000,535,484,500,265,518,783
1000,507,506,496,259,491,750
1000,468,475,498,214,518,732
1000,505,462,505,226,549,775
1000,506,486,481,244,493,737
1000,498,497,499,249,509,758
1000,531,477,527,248,534,782
1000,492,484,484,230,502,732
1000,486,487,496,241,483,724
1000,494,506,489,237,495,732
1000,520,504,517,272,504,776
1000,506,509,512,243,513,756
1000,475,499,500,240,499,739
1000,513,497,507,250,500,750
1000,494,489,482,244,484,728
1000,482,469,514,217,536,753
1000,496,506,503,250,503,753
1000,499,469,514,226,531,757
1000,497,500,497,238,509,747
1000,503,507,512,250,499,749
1000,520,528,509,272,492,764
1000,468,469,524,219,525,744
1000,506,502,512,254,522,776
1000,513,502,494,279,480,759
1000,513,477,504,239,520,759
1000,522,502,504,250,510,760
1000,502,511,508,253,502,755
1000,491,497,503,247,497,744
1000,456,468,489,210,522,732
1000,486,486,495,234,503,737
1000,492,489,501,236,510,746
1000,497,512,482,244,493,737
1000,526,507,500,269,502,771
1000,501,486,510,241,516,757
1000,497,510,509,230,523,753
1000,520,482,501,260,504,764
1000,508,480,496,240,515,755
1000,512,529,498,276,482,758
1000,490,498,493,254,481,735
1000,485,450,484,210,519,729
1000,497,512,514,255,485,740
1000,500,494,516,259,492,751
1000,513,479,544,232,553,785
1000,545,487,497,271,490,761
1000,496,489,528,250,508,758
1000,509,486,489,252,505,757
1000,480,501,518,247,512,759
1000,499,517,501,239,518,757
1000,495,503,478,259,484,743
1000,509,518,475,260,490,750
1000,480,460,497,226,511,737
1000,508,488,501,232,523,755
1000,478,504,486,241,494,735
1000,497,509,505,245,503,748
1000,496,495,508,246,515,761
1000,465,542,556,248,515,763
1000,491,510,515,256,501,757
1000,501,516,516,265,495,760
1000,487,493,511,250,504,754
1000,529,516,536,277,519,796
1000,500,495,513,248,519,767
1000,508,495,493,248,503,751
1000,515,514,480,277,461,738
1000,491,519,524,266,501,767
1000,507,485,518,241,523,764
1000,524,502,498,251,510,761
1000,506,516,483,275,468,743
1000,494,510,505,249,486,735
1000,519,485,474,249,496,745
1000,503,466,493,209,532,741
1000,500,501,477,255,479,734
1000,505,502,494,267,479,746
1000,545,478,501,271,488,759
1000,519,529,500,276,478,754
1000,493,465,506,222,524,746
1000,496,531,479,263,473,736
1000,526,509,485,278,495,773
1000,498,488,494,243,503,746
1000,514,516,466,262,477,739
1000,510,509,486,249,505,754
1000,491,476,495,230,513,743
1000,523,484,480,251,514,765
1000,522,492,494,255,522,777
1000,519,539,489,293,460,753
1000,488,485,502,225,512,737
1000,499,506,489,239,506,745
1000,493,512,501,242,502,744
1000,496,511,471,253,475,728
1000,528,533,505,273,491,764
1000,499,498,478,258,468,726
1000,488,507,493,253,484,737
1000,499,518,492,264,476,740
1000,481,505,520,236,516,752
1000,527,513,515,278,502,780
1000,525,511,508,274,493,767
1000,476,493,481,245,479,724
1000,506,495,502,247,521,768
1000,495,482,506,245,512,757
1000,530,487,497,262,497,759
1000,503,520,515,260,490,750
1000,518,498,506,262,491,753
1000,503,466,506,249,492,741
1000,495,518,496,248,497,745
1000,517,490,494,251,516,767
1000,497,497,515,249,512,761
1000,516,508,497,283,479,762
1000,475,484,498,230,503,733
1000,508,512,498,256,485,741
1000,498,517,506,247,492,739
1000,525,474,462,248,504,752
1000,484,510,531,252,509,761
1000,535,499,500,277,481,758
1000,499,497,490,231,514,745
1000,515,493,540,263,516,779
1000,516,524,506,274,489,763
1000,498,507,507,257,494,751
1000,508,521,515,270,483,753
1000,486,541,507,265,470,735
1000,489,517,508,265,480,745
1000,507,509,495,257,492,749
1000,492,518,517,261,502,763
1000,505,531,502,272,483,755
1000,459,472,518,218,523,741
1000,512,525,487,268,492,760
1000,487,495,491,243,506,749
1000,509,526,503,278,476,754
1000,503,513,501,255,487,742
1000,515,497,493,268,490,758
1000,526,514,512,271,487,758
1000,508,501,492,250,491,741
1000,521,478,507,259,508,767
1000,495,510,479,252,493,745
1000,504,492,525,243,526,769
1000,491,483,511,236,521,757
1000,504,513,499,252,498,750
1000,482,499,487,237,492,729
1000,483,513,511,242,508,750
1000,511,498,527,244,529,773
1000,490,503,520,236,522,758
1000,507,474,489,245,506,751
1000,515,516,487,271,488,759
1000,519,503,474,257,500,757
1000,518,501,506,250,512,762
1000,454,479,508,206,529,735
1000,481,508,507,240,506,746
1000,502,514,495,256,494,750
1000,486,494,508,254,494,748
1000,490,521,494,264,482,746
1000,483,493,533,229,538,767
1000,523,520,498,264,514,778
1000,491,510,492,253,488,741
1000,494,501,500,249,505,754
1000,505,501,504,272,480,752
1000,471,495,500,232,495,727
1000,482,469,536,219,548,767
1000,501,482,499,256,506,762
1000,496,481,506,249,505,754
1000,521,486,508,257,503,760
1000,483,511,500,247,483,730
1000,482,519,489,258,480,738
1000,502,517,533,253,519,772
1000,520,496,506,256,513,769
1000,501,549,486,263,487,750
1000,492,509,499,232,522,754
1000,480,497,509,239,512,751
1000,502,508,477,275,474,749
1000,520,496,480,260,489,749
1000,513,486,496,257,495,752
1000,502,520,531,252,528,780
1000,495,507,474,267,466,733
1000,526,500,498,270,497,767
1000,499,488,493,230,516,746
1000,507,506,502,256,494,750
1000,504,523,493,265,477,742
1000,498,504,530,245,530,775
1000,506,536,492,268,483,751
1000,468,489,495,244,484,728
1000,518,512,495,263,496,759
1000,499,500,508,244,523,767
1000,528,502,495,251,524,775
1000,483,502,504,241,500,741
1000,487,487,489,238,494,732
1000,502,517,504,262,486,748
1000,508,518,505,262,480,742
1000,518,477,480,247,491,738
1000,511,489,505,256,509,765
1000,487,477,508,233,492,725
1000,499,474,481,247,480,727
1000,513,496,484,247,493,740
1000,494,529,529,254,507,761
1000,495,468,484,214,538,752
1000,508,481,484,254,496,750
1000,490,517,506,255,497,752
1000,484,494,490,240,504,744
1000,492,517,492,259,482,741
1000,500,502,488,239,507,746
1000,490,498,512,227,536,763
1000,518,470,491,248,502,750
1000,467,525,507,233,515,748
1000,500,488,482,244,484,728
1000,496,472,494,233,497,730
1000,485,492,507,235,513,748
1000,465,483,500,223,508,731
1000,488,506,487,243,495,738
1000,508,520,476,265,479,744
1000,501,486,512,237,527,764
1000,506,511,511,262,502,764
1000,504,514,475,269,474,743
1000,496,483,522,248,509,757
1000,523,517,506,279,487,766
1000,482,485,479,237,505,742
1000,491,534,486,253,487,740
1000,507,496,513,260,502,762
1000,495,482,506,253,493,746
1000,508,475,497,247,508,755
1000,499,485,474,256,492,748
1000,498,502,519,245,515,760
1000,496,506,500,249,492,741
1000,482,483,487,233,493,726
1000,501,504,475,255,478,733
1000,537,502,515,279,488,767
1000,509,483,514,245,496,741
1000,513,486,509,246,504,750
1000,477,467,497,217,518,735
1000,508,497,483,259,488,747
1000,487,482,491,224,519,743
1000,495,499,500,240,506,746
1000,500,500,501,245,509,754
1000,524,510,497,272,488,760
1000,505,484,507,246,519,765
1000,501,514,482,254,487,741
1000,499,496,530,252,504,756
1000,492,508,506,252,498,750
1000,534,494,512,267,512,779
1000,488,484,496,223,528,751
1000,508,497,498,263,485,748
1000,493,495,497,242,499,741
1000,492,514,510,253,492,745
1000,494,475,501,240,498,738
1000,493,501,496,257,481,738
1000,464,482,507,220,516,736
1000,483,482,515,240,528,768
1000,513,520,490,280,476,756
1000,500,481,470,237,510,747
1000,505,494,484,272,463,735
1000,503,495,464,242,499,741
1000,480,487,488,229,504,733
1000,505,471,504,236,522,758
1000,520,506,490,268,490,758
1000,483,483,483,233,503,736
1000,497,521,483,273,472,745
1000,521,473,491,245,513,758
1000,489,491,509,229,529,758
1000,510,518,498,269,480,749
1000,526,506,505,264,499,763
1000,470,497,496,220,504,724
1000,522,456,500,248,502,750
1000,514,508,507,254,505,759
1000,490,488,471,236,488,724
1000,497,473,499,249,496,745
1000,510,503,466,262,472,734
1000,494,483,482,236,509,745
1000,519,519,523,267,501,768
1000,482,513,498,246,493,739
1000,496,510,524,258,495,753
1000,487,480,527,219,538,757
1000,504,462,498,216,533,749
1000,517,510,503,268,492,760
1000,508,491,519,256,506,762
1000,476,484,499,232,499,731
1000,489,499,521,238,515,753
1000,514,523,477,263,478,741
1000,487,498,511,239,505,744
1000,497,468,490,248,509,757
1000,485,492,505,238,514,752
1000,493,496,483,242,493,735
1000,505,502,487,245,508,753
1000,479,519,494,249,477,726
1000,490,533,512,233,520,753
1000,506,523,499,266,479,745
1000,506,491,508,251,509,760
1000,494,488,489,232,515,747
1000,521,497,514,263,515,778
1000,487,509,511,251,489,740
1000,513,490,464,246,488,734
1000,524,535,481,279,471,750
1000,515,483,516,250,521,771
1000,499,490,489,229,511,740
1000,479,510,491,237,496,733
1000,459,517,497,245,477,722
1000,502,498,493,247,501,748
1000,476,511,499,254,488,742
1000,467,532,491,248,477,725
1000,514,509,503,249,522,771
1000,501,498,485,253,491,744
1000,506,494,507,243,511,754
1000,477,504,510,242,479,721
1000,520,493,489,249,512,761
1000,505,499,505,248,513,761
1000,499,492,512,255,510,765
1000,483,521,471,250,490,740
1000,485,511,530,249,515,764
1000,516,490,492,268,494,762
1000,516,492,482,257,481,738
1000,496,484,495,229,526,755
1000,525,492,491,259,508,767
1000,520,495,497,267,505,772
1000,517,489,480,246,508,754
1000,503,539,486,273,470,743
1000,501,490,522,246,522,768
1000,485,502,533,242,517,759
1000,484,492,520,240,514,754
1000,499,478,525,245,519,764
1000,515,495,524,252,504,756
1000,474,497,470,255,483,738
1000,510,510,496,254,518,772
1000,497,502,484,245,496,741
1000,470,508,502,236,491,727
1000,506,484,531,254,527,781
1000,516,504,526,260,522,782
1000,500,497,501,256,499,755
1000,521,507,536,268,513,781
1000,507,504,507,259,499,758
1000,505,538,473,272,469,741
1000,515,470,476,240,515,755
1000,492,497,503,230,507,737
1000,527,483,529,244,520,764
1000,531,478,509,251,526,777
1000,506,506,473,258,484,742
1000,513,536,509,266,502,768
1000,519,513,469,284,454,738
1000,493,472,481,241,486,727
1000,479,508,503,245,495,740
1000,533,483,484,249,501,750
1000,517,519,479,267,478,745
1000,505,497,503,258,488,746
1000,530,510,501,279,493,772
1000,500,512,476,261,470,731
1000,525,475,459,251,497,748
1000,512,496,478,258,482,740
1000,522,500,507,260,500,760
1000,467,525,518,244,500,744
1000,477,498,494,235,505,740
1000,505,489,502,240,521,761
1000,500,495,511,247,513,760
1000,508,515,500,272,483,755
1000,460,488,471,216,506,722
1000,522,508,517,253,519,772
1000,503,482,505,245,520,765
1000,503,456,487,239,511,750
1000,505,490,504,231,531,762
1000,528,500,505,271,483,754
1000,497,498,523,249,512,761
1000,499,460,514,216,552,768
1000,509,493,482,259,491,750
1000,508,501,485,270,481,751
1000,460,500,519,234,519,753
1000,489,516,477,250,485,735
1000,512,500,513,256,511,767
1000,477,493,487,233,490,723
1000,487,524,485,253,482,735
1000,512,467,480,242,505,747
1000,508,502,505,252,512,764
1000,472,487,494,230,500,730
1000,519,526,510,261,503,764
1000,514,514,506,253,516,769
1000,533,502,516,258,510,768
1000,501,468,480,235,498,733
1000,508,480,481,245,502,747
1000,507,498,514,266,481,747
1000,485,507,505,257,490,747
1000,507,514,509,259,498,757
1000,522,503,498,268,482,750
1000,489,500,512,233,528,761
1000,524,486,514,257,510,767
1000,519,511,448,258,461,719
1000,493,480,506,235,530,765
1000,467,478,518,204,534,738
1000,509,495,497,253,507,760
1000,484,506,502,240,509,749
1000,500,518,542,280,488,768
1000,492,497,484,250,508,758
1000,509,492,485,236,524,760
1000,514,512,495,252,497,749
1000,511,483,503,245,523,768
1000,489,496,513,239,507,746
1000,490,493,500,244,499,743
1000,491,508,481,246,500,746
1000,486,503,503,250,509,759
1000,506,502,470,246,493,739
1000,501,469,488,244,504,748
1000,472,509,511,244,500,744
1000,496,486,467,253,486,739
1000,513,521,505,260,509,769
1000,496,495,497,229,511,740
1000,515,498,497,249,497,746
1000,489,481,526,253,499,752
1000,494,525,511,251,494,745
1000,501,505,502,252,519,771
1000,496,509,523,256,515,771
1000,490,494,499,234,518,752
1000,518,499,510,276,508,784
1000,532,507,514,266,502,768
1000,498,552,519,270,496,766
1000,496,495,491,228,519,747
1000,491,512,477,257,476,733
1000,503,517,503,271,470,741
1000,477,518,489,257,472,729
1000,500,497,518,258,503,761
1000,504,497,513,252,504,756
1000,484,509,500,236,509,745
1000,500,516,507,261,493,754
1000,489,494,499,230,525,755
1000,491,500,509,248,504,752
1000,496,529,497,265,479,744
1000,500,482,518,253,500,753
1000,511,471,526,241,526,767
1000,534,504,472,275,487,762
1000,481,497,530,234,520,754
1000,506,494,497,245,497,742
1000,483,499,497,244,491,735
1000,468,495,504,224,507,731
1000,498,472,503,230,510,740
1000,484,540,479,267,473,740
1000,500,484,537,255,508,763
1000,481,496,504,228,513,741
1000,514,513,500,266,495,761
1000,484,523,498,258,472,730
1000,490,498,528,248,494,742
1000,544,507,496,263,497,760
1000,508,497,523,262,490,752
1000,525,503,508,266,511,777
1000,516,504,523,261,501,762
1000,479,520,541,247,522,769
1000,477,511,489,259,473,732
1000,489,510,502,232,514,746
1000,492,501,515,241,508,749
1000,488,502,496,238,516,754
1000,515,496,501,249,500,749
1000,514,489,504,250,497,747
1000,502,495,494,256,488,744
1000,492,552,486,272,455,727
1000,508,482,501,238,503,741
1000,506,505,479,252,486,738
1000,506,475,532,252,510,762
1000,500,492,494,248,519,767
1000,506,516,488,262,485,747
1000,516,506,483,251,498,749
1000,503,501,518,262,509,771
1000,515,524,494,261,497,758
1000,495,488,499,238,513,751
1000,501,512,520,246,524,770
1000,487,504,509,256,494,750
1000,483,499,496,250,493,743
1000,474,514,492,238,496,734
1000,497,523,538,257,506,763
1000,490,505,483,252,490,742
1000,490,531,506,253,499,752
1000,495,494,508,231,521,752
1000,522,505,529,253,529,782
1000,519,508,501,264,498,762
1000,505,488,507,229,539,768
1000,510,496,512,252,502,754
1000,517,489,497,248,512,760
1000,513,458,487,219,541,760
1000,509,510,484,246,500,746
1000,476,456,513,213,531,744
1000,491,511,530,246,508,754
1000,515,473,512,248,504,752
1000,508,488,500,240,510,750
1000,526,493,513,258,505,763
1000,487,488,508,240,494,734
1000,492,520,486,249,491,740
1000,502,483,511,253,500,753
1000,494,489,510,238,519,757
1000,471,500,491,236,498,734
1000,499,505,518,237,532,769
1000,504,536,498,249,492,741
1000,489,517,550,243,527,770
1000,494,501,487,250,486,736
1000,492,487,510,254,496,750
1000,510,501,489,263,486,749
1000,487,517,505,246,514,760
1000,457,512,503,226,515,741
1000,511,496,480,258,494,752
1000,505,515,509,264,495,759
1000,490,500,475,254,493,747
1000,489,490,512,242,513,755
1000,500,471,505,224,527,751
1000,497,513,499,260,486,746
1000,526,513,506,266,486,752
1000,510,504,504,244,531,775
1000,495,499,531,260,503,763
1000,472,516,529,253,494,747
1000,475,537,496,241,506,747
1000,502,514,480,268,481,749
1000,503,503,500,261,486,747
1000,507,494,510,240,512,752
1000,491,511,505,245,504,749
1000,494,528,488,265,476,741
1000,479,507,504,247,494,741
1000,495,493,516,232,531,763
1000,496,494,497,257,478,735
1000,496,487,514,237,516,753
1000,497,489,510,228,531,759
1000,507,488,514,250,520,770
1000,493,521,468,258,485,743
1000,498,499,497,253,489,742
1000,503,488,481,245,505,750
1000,505,491,507,254,503,757
1000,512,480,499,247,507,754
1000,508,496,517,255,512,767
1000,512,504,505,249,515,764
1000,521,504,509,265,488,753
1000,512,512,511,262,505,767
1000,497,500,492,252,486,738
1000,479,517,526,249,499,748
1000,503,478,493,231,523,754
1000,517,491,495,250,509,759
1000,489,471,531,222,531,753
1000,507,485,495,225,523,748
1000,498,491,475,242,490,732
1000,482,514,482,239,493,732
1000,490,525,481,272,461,733
1000,509,526,511,255,499,754
1000,504,490,523,236,531,767
1000,522,488,487,247,507,754
1000,494,488,485,234,505,739
1000,477,486,511,235,509,744
1000,476,508,491,240,504,744
1000,474,506,508,231,516,747
1000,522,503,518,254,510,764
1000,495,499,486,247,501,748
1000,517,491,500,255,494,749
1000,516,493,502,244,512,756
1000,510,518,508,236,536,772
1000,500,490,515,239,518,757
1000,498,515,504,261,489,750
1000,499,497,511,251,503,754
1000,503,501,545,254,521,775
1000,501,494,483,242,493,735
1000,501,525,519,260,518,778
1000,492,487,497,247,495,742
1000,538,506,533,264,523,787
1000,502,485,486,248,503,751
1000,477,519,519,233,531,764
1000,501,509,529,251,520,771
1000,491,465,513,227,543,770
1000,539,501,508,276,502,778
1000,508,504,530,257,497,754
1000,516,513,489,268,488,756
1000,512,507,514,264,500,764
1000,510,501,516,264,502,766
1000,487,513,493,235,505,740
1000,512,476,491,262,493,755
1000,482,511,510,244,497,741
1000,500,498,491,247,485,732
1000,495,498,506,250,509,759
1000,537,498,494,262,496,758
1000,506,504,498,256,482,738
1000,489,503,493,235,511,746
1000,502,513,480,261,475,736
1000,530,496,483,274,478,752
1000,512,486,508,259,509,768
1000,516,503,502,253,515,768
1000,504,503,528,247,524,771
1000,517,508,506,264,494,758
1000,532,497,539,267,511,778
1000,500,494,485,250,486,736
1000,505,541,504,281,477,758
1000,496,497,501,265,486,751
1000,479,501,497,245,489,734
1000,504,458,506,223,542,765
1000,506,518,486,253,498,751
1000,501,513,477,261,472,733
1000,495,487,499,237,492,729
1000,512,513,496,260,508,768
1000,507,522,512,283,462,745
1000,483,523,507,253,478,731
1000,514,481,494,250,509,759
1000,488,500,482,229,498,727
1000,492,482,509,236,515,751
1000,513,479,494,239,526,765
1000,489,500,488,242,492,734
1000,485,521,517,254,492,746
1000,508,494,500,238,528,766
1000,479,483,481,226,509,735
1000,501,498,481,241,487,728
1000,477,501,507,233,512,745
1000,534,519,495,266,511,777
1000,518,483,522,253,519,772
1000,506,506,503,274,477,751
1000,493,532,489,258,480,738
1000,502,514,527,256,503,759
1000,530,456,494,254,516,770
1000,511,491,515,251,522,773
1000,478,504,513,253,489,742
1000,481,496,509,240,502,742
1000,486,520,491,252,474,726
1000,482,457,492,214,532,746
1000,514,489,497,256,503,759
1000,487,507,518,246,495,741
1000,514,500,510,253,503,756
1000,501,505,492,257,483,740
1000,504,506,507,246,515,761
1000,498,510,503,273,466,739
1000,507,509,508,257,502,759
1000,489,507,485,238,506,744
1000,491,473,505,239,512,751
1000,498,494,476,245,485,730
1000,494,491,511,250,513,763
1000,519,534,505,267,506,773
1000,500,491,495,246,504,750
1000,489,526,517,258,511,769
1000,506,494,514,250,505,755
1000,517,533,515,284,489,773
1000,480,495,495,246,489,735
1000,482,505,521,232,524,756
1000,501,504,499,256,498,754
1000,485,512,494,244,494,738
1000,478,487,487,232,502,734
1000,524,511,482,276,480,756
1000,510,494,475,248,490,738
1000,483,486,477,220,490,710
1000,501,481,481,238,498,736
1000,512,498,520,245,528,773
1000,505,513,481,258,472,730
1000,485,511,472,239,492,731
1000,494,518,482,249,476,725
1000,494,477,508,237,500,737
1000,514,493,499,258,512,770
1000,507,495,523,253,522,775
1000,511,491,497,260,504,764
1000,493,501,480,256,478,734
1000,480,487,469,223,497,720
1000,481,485,490,244,497,741
1000,516,466,495,239,513,752
1000,506,518,509,271,491,762
1000,516,519,471,254,492,746
1000,461,518,497,229,498,727
1000,510,500,473,254,475,729
1000,504,485,515,227,534,761
1000,520,491,485,263,482,745
1000,462,495,491,227,507,734
1000,485,508,505,228,530,758
1000,489,503,496,234,519,753
1000,505,513,502,254,510,764
1000,514,495,491,270,480,750
1000,510,489,489,235,518,753
1000,493,511,484,252,486,738
1000,537,500,498,276,497,773
1000,504,516,514,254,509,763
1000,498,495,506,239,510,749
1000,481,504,519,240,494,734
1000,508,491,503,239,520,759
1000,514,493,512,261,511,772
1000,484,498,497,230,499,729
1000,485,504,485,250,477,727
1000,514,515,479,261,501,762
1000,483,511,514,245,499,744
1000,506,482,478,251,501,752
1000,497,493,505,247,506,753
1000,508,503,474,257,487,744
1000,513,473,474,241,505,746
1000,464,502,495,234,501,735
1000,512,489,499,251,498,749
1000,490,532,501,258,497,755
1000,509,495,491,251,507,758
1000,502,510,519,262,487,749
1000,526,477,495,243,515,758
1000,500,501,491,250,496,746
1000,517,475,495,238,505,743
1000,507,521,517,255,497,752
1000,483,497,504,246,512,758
1000,515,495,510,246,528,774
1000,486,512,505,246,502,748
1000,511,485,502,249,505,754
1000,511,524,508,262,484,746
1000,506,495,488,254,495,749
1000,505,505,507,259,497,756
1000,484,516,486,251,490,741
1000,489,514,516,269,470,739
1000,486,520,508,241,501,742
1000,501,505,481,268,476,744
1000,493,517,505,256,501,757
1000,493,498,497,249,494,743
1000,474,509,522,239,514,753
1000,492,507,489,242,498,740
1000,489,474,490,227,510,737
1000,512,495,492,246,498,744
1000,512,492,491,245,510,755
1000,484,518,523,252,488,740
1000,456,490,512,228,495,723
1000,471,497,507,237,508,745
1000,501,491,494,237,512,749
1000,515,506,485,256,494,750
1000,497,488,483,240,501,741
1000,522,491,515,254,499,753
1000,539,499,502,278,490,768
1000,473,479,503,225,515,740
1000,486,489,489,240,513,753
1000,503,453,488,229,532,761
1000,494,536,509,268,482,750
1000,522,515,501,259,506,765
1000,508,498,490,245,513,758
1000,515,489,514,250,511,761
1000,500,492,514,236,524,760
1000,481,512,515,247,508,755
1000,507,507,483,259,497,756
1000,476,508,504,259,489,748
1000,528,511,493,260,506,766
1000,490,487,527,241,531,772
1000,511,481,501,237,521,758
1000,495,544,492,268,482,750
1000,522,481,481,257,499,756
1000,512,508,505,262,506,768
1000,505,500,526,250,523,773
1000,492,452,483,220,524,744
1000,517,493,518,244,513,757
1000,499,499,490,239,495,734
1000,475,510,507,240,509,749
1000,516,483,521,247,520,767
1000,491,508,490,251,497,748
1000,519,499,531,263,504,767
1000,498,501,470,244,487,731
1000,509,493,506,238,503,741
1000,495,477,505,224,522,746
1000,485,504,527,227,519,746
1000,483,486,523,226,525,751
1000,497,488,491,233,530,763
1000,482,510,483,246,477,723
1000,472,525,514,238,507,745
1000,496,499,499,239,505,744
1000,513,501,498,272,464,736
1000,506,492,467,241,493,734
1000,498,500,506,245,497,742
1000,480,498,473,234,496,730
1000,498,518,503,255,489,744
1000,492,496,530,251,494,745
1000,530,488,503,261,514,775
1000,519,512,504,260,501,761
1000,481,485,494,246,499,745
1000,501,513,485,245,504,749
1000,528,501,491,272,505,777
1000,474,498,470,235,488,723
1000,492,495,496,227,498,725
1000,492,488,487,250,501,751
1000,506,508,500,244,504,748
1000,505,521,479,260,470,730
1000,484,491,500,238,497,735
1000,492,496,490,247,500,747
1000,517,500,496,251,500,751
1000,482,471,504,219,524,743
1000,525,511,484,263,487,750
1000,511,501,486,260,485,745
1000,523,513,492,273,489,762
1000,500,485,529,260,512,772
1000,524,507,492,267,491,758
1000,504,506,506,268,492,760
1000,497,463,517,226,530,756
1000,486,506,470,253,489,742
1000,493,510,516,251,501,752
1000,496,527,492,255,487,742
1000,473,490,480,225,493,718
1000,512,508,499,265,499,764
1000,484,488,512,231,519,750
1000,493,469,499,227,522,749
1000,496,465,522,229,528,757
1000,492,481,509,227,530,757
1000,498,470,494,226,524,750
1000,517,500,520,256,513,769
1000,493,484,483,232,518,750
1000,497,521,531,254,508,762
1000,509,488,494,240,500,740
1000,503,486,521,242,528,770
1000,503,478,486,233,506,739
1000,468,498,510,213,526,739
1000,488,477,497,224,512,736
1000,496,484,483,251,482,733
1000,512,514,511,259,505,764
1000,507,482,494,238,527,765
1000,506,511,488,252,495,747
1000,503,501,485,254,479,733
1000,483,498,524,244,510,754
1000,482,507,485,238,491,729
1000,500,505,491,246,496,742
1000,482,475,518,227,534,761
1000,522,486,532,254,516,770
1000,531,480,510,256,507,763
1000,528,490,509,257,511,768
1000,472,505,491,240,490,730
1000,512,507,499,257,500,757
1000,496,504,482,245,510,755
1000,508,472,494,235,507,742
1000,512,504,466,255,486,741
1000,492,482,516,230,510,740
1000,499,490,471,256,483,739
1000,487,518,500,234,514,748
1000,518,525,505,263,497,760
1000,501,494,484,250,499,749
1000,532,517,517,278,493,771
1000,475,499,526,259,493,752
1000,506,476,490,248,513,761
1000,496,484,513,237,523,760
1000,515,490,514,266,495,761
1000,470,493,477,223,501,724
1000,495,510,488,258,487,745
1000,507,509,506,267,488,755
1000,536,481,521,264,525,789
1000,500,518,491,249,490,739
1000,519,505,482,262,487,749
1000,498,486,490,239,511,750
1000,471,511,506,234,509,743
1000,523,502,534,259,523,782
1000,500,517,495,260,484,744
1000,497,494,495,239,514,753
1000,476,515,521,236,515,751
1000,511,500,491,250,504,754
1000,464,528,519,240,509,749
1000,488,483,502,232,511,743
1000,519,510,521,272,491,763
1000,516,493,512,261,510,771
1000,478,494,477,238,496,734
1000,498,491,516,242,507,749
1000,490,503,496,247,497,744
1000,512,496,503,264,497,761
1000,500,506,491,241,512,753
1000,519,519,490,270,499,769
1000,504,515,507,273,485,758
1000,487,502,492,244,506,750
1000,483,533,469,265,469,734
1000,488,490,524,237,510,747
1000,495,506,494,245,499,744
1000,503,515,493,270,476,746
1000,507,516,531,263,507,770
1000,479,503,493,242,509,751
1000,493,530,488,248,507,755
1000,505,495,501,252,519,771
1000,501,474,489,228,513,741
1000,506,503,505,259,482,741
1000,497,498,499,245,506,751
1000,525,490,507,259,506,765
1000,499,481,471,242,502,744
1000,523,486,510,273,500,773
1000,506,502,511,263,489,752
1000,510,543,493,272,483,755
1000,488,509,493,265,475,740
1000,500,487,517,246,516,762
1000,485,514,523,264,470,734
1000,491,481,512,235,513,748
1000,510,474,509,238,532,770
1000,520,500,489,253,503,756
1000,495,506,500,258,499,757
1000,542,505,512,281,504,785
1000,515,505,521,268,505,773
1000,521,492,486,259,502,761
1000,509,501,498,248,513,761
1000,510,506,487,250,499,749
1000,465,496,510,238,490,728
1000,474,513,530,248,510,758
1000,500,495,452,246,469,715
1000,475,516,507,251,489,740
1000,536,517,522,275,504,779
1000,492,478,494,239,499,738
1000,497,510,525,259,505,764
1000,503,499,514,251,503,754
1000,507,488,523,241,525,766
1000,496,504,505,254,505,759
1000,492,506,502,250,494,744
1000,489,499,492,236,504,740
1000,502,490,508,252,488,740
1000,493,500,487,240,491,731
1000,487,489,504,246,502,748
1000,520,519,498,279,482,761
1000,512,471,491,238,518,756
1000,493,483,493,243,507,750
1000,499,491,516,255,508,763
1000,507,513,494,244,509,753
1000,482,494,494,231,519,750
1000,466,520,503,229,494,723
1000,491,491,497,245,502,747
1000,524,498,513,263,507,770
1000,537,505,495,283,471,754
1000,501,490,493,252,488,740
1000,462,493,535,249,505,754
1000,498,501,496,254,485,739
1000,498,515,529,262,494,756
1000,514,478,509,258,505,763
1000,479,517,485,233,503,736
1000,513,495,509,242,519,761
1000,483,507,473,242,490,732
1000,513,498,510,258,511,769
1000,505,506,513,247,507,754
1000,496,495,518,251,509,760
1000,486,472,501,237,504,741
1000,478,507,504,235,501,736
1000,511,527,511,270,488,758
1000,500,491,477,243,499,742
1000,524,512,508,271,495,766
1000,506,513,495,265,480,745
1000,495,510,505,251,496,747
1000,514,489,519,245,515,760
1000,500,514,501,263,492,755
1000,525,467,498,244,526,770
1000,500,508,485,250,501,751
1000,476,510,495,236,512,748
1000,494,484,509,245,510,755
1000,537,512,499,266,506,772
1000,497,501,492,251,493,744
1000,471,495,504,225,510,735
1000,500,497,468,252,478,730
1000,500,496,493,250,501,751
1000,508,490,469,249,498,747
1000,500,501,485,241,508,749
1000,527,483,496,268,484,752
1000,516,489,497,252,506,758
1000,486,479,493,243,491,734
1000,507,506,498,272,476,748
1000,514,483,507,259,494,753
1000,525,473,506,249,516,765
1000,497,518,509,259,468,727
1000,515,480,502,251,512,763
1000,496,497,494,243,512,755
1000,501,501,524,250,527,777
1000,500,505,472,255,490,745
1000,498,526,504,264,499,763
1000,513,504,503,268,485,753
1000,466,500,483,247,488,735
1000,503,509,505,247,504,751
1000,496,503,520,245,512,757
1000,479,504,486,233,496,729
1000,510,486,470,237,488,725
1000,499,494,493,252,483,735
1000,506,516,487,249,503,752
1000,501,514,524,253,512,765
1000,480,490,522,236,523,759
1000,528,497,524,258,527,785
1000,500,514,492,271,469,740
1000,496,510,519,255,499,754
1000,506,493,484,250,489,739
1000,516,488,514,264,493,757
1000,491,495,499,228,496,724
1000,522,494,515,259,505,764
1000,500,484,521,221,529,750
1000,511,495,504,257,486,743
1000,499,467,494,235,507,742
1000,482,490,504,237,518,755
1000,478,474,491,229,517,746
1000,512,499,481,256,485,741
1000,526,478,502,255,511,766
1000,524,500,497,265,508,773
1000,511,488,486,237,505,742
1000,529,514,514,263,500,763
1000,512,490,492,257,495,752
1000,514,500,511,257,510,767
1000,497,515,504,257,490,747
1000,492,461,484,216,528,744
1000,488,483,513,236,500,736
1000,501,506,490,260,482,742
1000,483,498,505,246,499,745
1000,514,482,501,245,507,752
1000,468,521,503,249,488,737
1000,507,520,499,258,499,757
1000,518,511,538,264,524,788
1000,542,519,513,288,488,776
1000,466,493,524,228,508,736
1000,505,495,498,238,504,742
1000,487,478,504,215,527,742
1000,491,495,498,244,503,747
1000,513,515,494,254,492,746
1000,508,534,483,280,470,750
1000,491,505,498,233,524,757
1000,518,501,494,257,498,755
1000,517,489,492,256,500,756
1000,509,533,527,259,504,763
1000,514,498,491,260,488,748
1000,504,496,505,259,490,749
1000,504,484,501,249,506,755
1000,509,488,504,236,524,760
1000,501,502,474,260,460,720
1000,508,515,497,256,495,751
1000,500,502,495,253,492,745
1000,521,479,492,246,508,754
1000,473,494,484,231,491,722
1000,497,502,455,251,474,725
1000,474,498,501,237,508,745
1000,523,470,510,251,507,758
1000,517,520,505,265,503,768
1000,521,501,504,260,499,759
1000,458,509,497,230,512,742
1000,494,477,490,217,522,739
1000,497,506,473,250,485,735
1000,470,513,524,242,510,752
1000,488,475,499,230,521,751
1000,504,505,502,258,497,755
1000,481,513,479,252,488,740
1000,518,498,498,258,492,750
1000,530,506,548,247,540,787
1000,510,498,512,252,503,755
1000,483,499,517,244,521,765
1000,514,504,488,264,504,768
1000,502,492,506,248,509,757
1000,498,484,530,245,517,762
1000,507,500,526,256,517,773
1000,501,496,497,250,482,732
1000,505,496,486,256,495,751
1000,504,479,497,248,511,759
1000,514,508,497,255,500,755
1000,497,500,507,242,511,753
1000,509,508,505,260,505,765
1000,487,507,510,238,512,750
1000,489,518,493,246,492,738
1000,518,505,487,252,496,748
1000,495,492,509,240,509,749
1000,499,508,511,240,518,758
1000,487,476,482,221,510,731
1000,519,483,520,257,511,768
1000,517,492,516,260,509,769
1000,493,495,526,246,525,771
1000,511,497,489,250,498,748
1000,528,489,491,255,498,753
1000,486,504,504,247,499,746
1000,504,486,484,244,499,743
1000,491,484,488,239,496,735
1000,499,492,502,250,485,735
1000,504,524,501,277,478,755
1000,491,493,477,253,495,748
1000,480,474,480,222,503,725
1000,495,520,511,252,491,743
1000,503,493,503,256,493,749
1000,487,478,499,245,513,758
1000,483,499,509,245,501,746
1000,463,498,519,225,513,738
1000,493,499,512,255,509,764
1000,496,503,525,249,513,762
1000,492,508,522,245,512,757
1000,493,492,510,245,500,745
1000,494,498,490,253,473,726
1000,506,508,479,260,493,753
1000,512,504,509,240,510,750
1000,524,485,485,255,499,754
1000,509,508,512,260,495,755
1000,507,470,512,236,523,759
1000,510,514,502,260,498,758
1000,501,523,499,275,472,747
1000,542,492,489,266,505,771
1000,526,493,517,259,515,774
1000,517,491,483,257,505,762
1000,493,475,493,238,508,746
1000,506,506,525,262,498,760
1000,504,505,516,259,499,758
1000,512,510,503,277,473,750
1000,511,523,484,275,468,743
1000,523,474,509,250,517,767
1000,495,483,485,236,518,754
1000,533,501,482,255,507,762
1000,482,483,502,242,492,734
1000,505,477,486,240,501,741
1000,460,470,521,213,527,740
1000,519,493,511,243,534,777
1000,514,502,495,266,489,755
1000,471,491,495,243,494,737
1000,447,507,537,217,530,747
1000,529,502,492,277,483,760
1000,486,499,497,251,498,749
1000,503,484,490,263,490,753
1000,493,519,518,253,503,756
1000,477,510,497,241,502,743
1000,490,515,514,244,508,752
1000,489,500,459,246,479,725
1000,511,481,472,245,500,745
1000,513,502,500,250,502,752
1000,534,513,506,280,484,764
1000,511,496,489,236,510,746
1000,497,482,496,224,532,756
1000,492,503,488,244,503,747
1000,515,513,476,280,478,758
1000,477,512,488,240,496,736
1000,486,518,489,249,481,730
1000,510,484,497,243,506,749
1000,475,489,502,215,539,754
1000,492,535,497,264,468,732
1000,539,481,500,257,508,765
1000,491,497,487,252,479,731
1000,495,484,476,242,498,740
1000,501,482,500,251,487,738
1000,514,500,497,250,491,741
1000,478,483,469,229,479,708
1000,507,465,503,241,518,759
1000,503,506,503,250,503,753
1000,497,488,496,242,504,746
1000,526,476,490,237,523,760
1000,487,485,507,231,511,742
1000,521,521,500,287,473,760
1000,503,498,494,241,504,745
1000,492,507,496,255,484,739
1000,509,498,488,250,492,742
1000,525,513,501,278,493,771
1000,503,525,500,278,477,755
1000,480,505,508,230,517,747
1000,498,496,498,247,496,743
1000,535,506,494,271,486,757
1000,489,494,492,237,503,740
1000,486,471,523,233,506,739
1000,481,483,510,246,512,758
1000,499,479,519,233,529,762
1000,507,502,505,258,498,756
1000,503,507,508,260,495,755
1000,505,501,540,258,511,769
1000,507,497,504,253,511,764
1000,525,517,501,284,469,753
1000,504,509,487,252,495,747
1000,502,483,506,242,517,759
1000,490,515,512,255,503,758
1000,480,482,513,230,512,742
1000,489,487,535,233,526,759
1000,493,515,519,252,492,744
1000,497,515,492,259,492,751
1000,479,505,503,245,499,744
1000,497,489,489,248,499,747
1000,484,481,501,236,516,752
1000,498,495,496,248,497,745
1000,512,467,505,239,514,753
1000,490,495,527,245,500,745
1000,477,503,524,243,511,754
1000,488,523,483,255,467,722
1000,503,491,485,258,482,740
1000,503,519,516,254,512,766
1000,539,503,501,281,488,769
1000,488,505,529,250,506,756
1000,512,520,514,277,486,763
1000,492,502,515,257,484,741
1000,511,488,502,255,510,765
1000,516,483,493,248,509,757
1000,494,491,494,237,504,741
1000,494,513,495,259,484,743
1000,496,495,497,241,488,729
1000,482,533,537,263,492,755
1000,498,489,494,242,509,751
1000,529,481,490,254,525,779
1000,491,500,466,248,469,717
1000,512,500,510,250,506,756
1000,492,502,492,254,465,719
1000,501,506,503,251,508,759
1000,506,497,509,257,498,755
1000,498,526,513,262,482,744
1000,516,500,492,258,509,767
1000,512,495,527,244,538,782
1000,478,510,515,241,513,754
1000,491,502,508,254,510,764
1000,488,482,503,241,498,739
1000,511,501,510,251,513,764
1000,514,524,520,263,499,762
1000,529,508,525,277,501,778
1000,495,501,516,238,526,764
1000,510,498,487,241,512,753
1000,494,490,521,230,535,765
1000,478,488,477,225,493,718
1000,542,496,508,274,505,779
1000,497,505,478,248,485,733
1000,490,494,502,240,497,737
1000,526,510,505,259,507,766
1000,503,492,487,240,515,755
1000,519,513,492,278,470,748
1000,483,485,497,234,503,737
1000,468,504,496,242,498,740
1000,505,491,521,264,490,754
1000,497,498,512,258,496,754
1000,516,517,513,278,480,758
1000,509,499,487,247,511,758
1000,515,487,476,253,486,739
1000,487,521,512,240,514,754
1000,493,488,491,244,495,739
1000,494,479,523,232,530,762
1000,495,510,531,260,496,756
1000,486,489,509,231,509,740
1000,517,504,461,263,476,739
1000,507,511,508,265,497,762
1000,504,483,536,250,520,770
1000,498,502,502,252,499,751
1000,535,499,519,266,518,784
1000,464,494,502,233,499,732
1000,506,495,526,244,521,765
1000,481,501,490,247,497,744
1000,518,508,499,269,498,767
1000,512,511,514,256,504,760
1000,503,497,473,261,466,727
1000,507,530,489,269,497,766
1000,515,522,517,266,494,760
1000,489,518,490,249,486,735
1000,495,488,490,248,495,743
1000,517,509,501,250,535,785
1000,493,487,524,243,507,750
1000,522,465,481,246,516,762
1000,491,511,524,247,518,765
1000,462,515,534,234,520,754
1000,532,493,509,244,526,770
1000,492,500,503,246,502,748
1000,517,503,471,259,482,741
1000,495,492,493,235,517,752
1000,505,496,486,244,505,749
1000,467,494,511,244,486,730
1000,481,506,526,248,515,763
1000,497,479,493,236,510,746
1000,501,510,506,243,514,757
1000,499,506,484,243,493,736
1000,503,478,507,241,524,765
1000,494,486,533,247,521,768
1000,495,504,508,248,504,752
1000,483,520,504,250,491,741
1000,480,501,502,240,500,740
1000,493,502,525,254,514,768
1000,490,485,484,253,480,733
1000,499,507,491,255,501,756
1000,507,489,492,242,507,749
1000,511,497,511,252,503,755
1000,504,494,487,227,520,747
1000,487,518,495,246,484,730
1000,496,489,535,258,500,758
1000,501,489,533,237,530,767
1000,524,485,497,251,507,758
1000,502,493,494,238,506,744
1000,534,483,515,265,513,778
1000,498,494,511,254,482,736
1000,496,493,500,243,501,744
1000,509,498,500,258,493,751
1000,502,497,500,244,520,764
1000,493,471,512,243,511,754
1000,492,493,522,245,510,755
1000,507,506,525,253,503,756
1000,464,491,499,215,515,730
1000,500,520,502,273,467,740
1000,499,499,490,245,490,735
1000,527,518,522,277,495,772
1000,489,508,465,246,480,726
1000,517,501,539,243,553,796
1000,519,498,493,269,487,756
1000,498,537,493,276,471,747
1000,494,512,479,250,476,726
1000,512,497,509,251,504,755
1000,509,502,525,243,521,764
1000,509,511,525,259,504,763
1000,516,505,514,265,500,765
1000,529,498,486,271,481,752
1000,495,497,476,241,490,731
1000,517,516,477,269,482,751
1000,533,524,519,273,503,776
1000,504,492,506,245,509,754
1000,512,466,478,228,517,745
1000,507,499,502,250,517,767
1000,482,492,511,235,509,744
1000,490,519,514,258,490,748
1000,522,502,490,267,490,757
1000,480,506,522,241,503,744
1000,485,525,529,256,503,759
1000,538,499,496,260,517,777
1000,518,514,505,274,500,774
1000,496,465,504,227,526,753
1000,524,509,503,259,510,769
1000,510,468,484,231,527,758
1000,491,489,508,235,509,744
1000,498,483,489,236,510,746
1000,500,492,488,256,494,750
1000,498,496,496,247,493,740
1000,511,516,517,267,501,768
1000,495,516,510,268,505,773
1000,493,539,511,259,493,752
1000,504,498,490,239,497,736
1000,495,514,477,248,490,738
1000,489,475,509,229,516,745
1000,482,480,498,242,494,736
1000,478,495,510,232,509,741
1000,546,510,487,266,497,763
1000,490,540,504,270,482,752
1000,494,519,506,270,472,742
1000,521,514,530,269,508,777
1000,506,492,509,246,509,755
1000,517,532,501,269,497,766
1000,489,512,494,259,481,740
1000,521,514,514,265,522,787
1000,506,483,487,246,507,753
1000,498,480,505,244,504,748
1000,457,467,502,200,516,716
1000,501,507,509,258,497,755
1000,508,505,471,246,497,743
1000,538,521,511,278,483,761
1000,489,490,507,229,519,748
1000,511,459,503,242,501,743
1000,510,494,503,251,506,757
1000,494,489,507,238,495,733
1000,473,512,464,233,490,723
1000,499,502,526,247,532,779
1000,497,522,495,264,484,748
1000,484,481,495,237,501,738
1000,530,515,508,272,503,775
1000,490,488,513,247,503,750
1000,485,510,492,250,496,746
1000,495,479,505,230,527,757
1000,499,484,509,238,517,755
1000,494,510,493,262,489,751
1000,510,499,510,247,518,765
1000,483,473,503,236,517,753
1000,497,468,496,226,519,745
1000,497,515,523,256,513,769
1000,483,494,478,225,493,718
1000,510,499,486,258,488,746
1000,512,521,515,282,469,751
1000,522,497,501,263,509,772
1000,497,472,500,225,520,745
1000,517,499,493,242,510,752
1000,502,481,495,238,511,749
1000,491,512,506,251,474,725
1000,495,510,523,256,526,782
1000,485,489,495,251,483,734
1000,514,496,517,254,511,765
1000,512,517,494,265,482,747
1000,507,493,496,255,510,765
1000,506,505,506,256,495,751
1000,501,493,490,251,484,735
1000,512,496,494,255,494,749
1000,484,502,517,246,500,746
1000,519,502,556,260,525,785
1000,488,495,514,248,509,757
1000,509,536,474,276,457,733
1000,505,524,494,263,492,755
1000,523,487,543,250,529,779
1000,502,477,526,244,537,781
1000,496,490,519,227,526,753
1000,490,513,503,244,497,741
1000,515,504,493,258,496,754
1000,483,480,522,229,527,756
1000,532,500,480,282,491,773
1000,499,511,492,258,481,739
1000,485,475,486,240,502,742
1000,491,503,476,252,478,730
1000,528,483,493,270,484,754
1000,509,502,506,256,496,752
1000,503,478,470,257,482,739
1000,494,509,520,253,512,765
1000,500,533,496,262,482,744
1000,516,510,493,242,520,762
1000,527,480,477,249,508,757
1000,501,501,516,252,499,751
1000,530,539,503,279,485,764
1000,487,493,481,238,492,730
1000,495,495,488,250,480,730
1000,492,490,503,247,493,740
1000,477,520,517,237,525,762
1000,507,497,489,230,511,741
1000,493,520,487,273,461,734
1000,515,530,511,281,479,760
1000,493,512,505,243,499,742
1000,515,492,497,248,502,750
1000,472,505,509,231,510,741
1000,501,514,486,255,490,745
1000,514,503,504,254,502,756
1000,518,492,475,250,499,749
1000,495,503,504,249,510,759
1000,496,475,502,235,509,744
1000,505,510,499,266,493,759
1000,509,507,500,270,494,764
1000,494,502,515,256,490,746
1000,510,528,516,278,487,765
1000,488,476,489,245,491,736
1000,494,491,495,242,506,748
1000,505,500,476,251,501,752
1000,513,499,500,262,489,751
1000,468,503,523,225,517,742
1000,461,507,509,249,477,726
1000,498,508,517,253,496,749
1000,474,503,529,231,501,732
1000,504,522,485,267,485,752
1000,499,470,493,236,532,768
1000,503,510,501,268,492,760
1000,485,514,500,251,488,739
1000,480,517,511,246,499,745
1000,491,498,494,237,492,729
1000,486,507,513,245,516,761
1000,499,490,520,265,495,760
1000,493,489,532,248,507,755
1000,487,486,508,231,517,748
1000,500,501,507,236,507,743
1000,503,503,492,256,489,745
1000,492,514,487,255,484,739
1000,516,506,485,256,489,745
1000,494,499,510,242,506,748
1000,494,498,482,239,493,732
1000,509,520,498,273,476,749
1000,502,502,508,256,488,744
1000,527,488,506,265,509,774
1000,485,510,494,243,500,743
1000,507,487,481,258,496,754
1000,496,474,519,221,528,749
1000,490,529,496,260,486,746
1000,471,495,493,234,503,737
1000,511,508,508,253,517,770
1000,498,500,504,243,497,740
1000,519,483,501,257,501,758
1000,474,510,472,241,480,721
1000,489,477,494,227,507,734
1000,495,507,499,243,498,741
1000,493,490,496,243,502,745
1000,518,468,508,250,517,767
1000,527,488,477,260,497,757
1000,486,509,521,248,503,751
1000,508,493,499,246,504,750
1000,542,497,496,266,505,771
1000,503,519,499,266,494,760
1000,514,498,507,242,520,762
1000,504,505,467,261,474,735
1000,475,510,462,252,447,699
1000,487,505,488,245,495,740
1000,497,498,519,257,509,766
1000,484,517,501,251,497,748
1000,520,524,484,262,484,746
1000,514,481,480,257,491,748
1000,514,499,481,259,488,747
1000,477,512,517,250,491,741
1000,499,507,528,249,517,766
1000,472,499,515,228,515,743
1000,504,489,499,243,501,744
1000,494,495,483,247,489,736
1000,484,476,506,227,524,751
1000,496,479,481,218,523,741
1000,513,492,511,258,495,753
1000,501,515,503,271,473,744
1000,496,512,502,259,490,749
1000,501,476,485,245,504,749
1000,521,509,481,260,488,748
1000,531,490,482,261,481,742
1000,487,525,504,272,475,747
1000,517,480,476,238,508,746
1000,493,522,476,249,493,742
1000,468,529,496,248,485,733
1000,504,488,502,254,492,746
1000,493,517,489,260,488,748
1000,500,530,508,281,473,754
1000,472,494,499,235,511,746
1000,518,480,503,252,521,773
1000,491,479,495,226,523,749
1000,529,494,512,272,499,771
1000,499,471,498,236,513,749
1000,512,515,497,266,498,764
1000,499,472,504,242,511,753
1000,509,528,482,259,500,759
1000,465,489,515,238,508,746
1000,510,507,532,256,508,764
1000,499,511,497,249,498,747
1000,508,502,483,252,489,741
1000,489,484,518,246,512,758
1000,503,467,485,238,501,739
1000,503,496,493,258,488,746
1000,467,514,514,240,502,742
1000,511,507,502,264,500,764
1000,474,514,509,241,505,746
1000,493,504,515,255,494,749
1000,491,500,518,256,490,746
1000,496,492,488,249,499,748
1000,480,499,481,226,495,721
1000,483,515,512,243,494,737
1000,499,502,484,240,504,744
1000,511,526,502,262,514,776
1000,509,505,481,250,493,743
1000,517,520,482,277,469,746
1000,523,469,488,257,494,751
1000,511,516,509,265,496,761
1000,498,516,516,265,481,746
1000,496,505,508,235,516,751
1000,498,507,518,256,501,757
1000,495,518,540,249,514,763
1000,483,496,503,246,498,744
1000,511,484,489,240,503,743
1000,483,519,482,248,477,725
1000,488,528,516,267,472,739
1000,513,477,506,254,490,744
1000,492,493,536,238,528,766
1000,494,490,517,250,500,750
1000,477,479,503,229,505,734
1000,500,498,504,267,491,758
1000,482,476,474,233,498,731
1000,503,485,492,256,494,750
1000,500,524,497,251,496,747
1000,507,516,501,261,499,760
1000,508,520,526,266,492,758
1000,484,498,478,245,487,732
1000,524,540,481,286,455,741
1000,492,501,502,252,480,732
1000,489,504,517,250,505,755
1000,490,506,484,258,485,743
1000,515,499,519,273,488,761
1000,504,488,481,241,505,746
1000,525,513,495,264,502,766
1000,498,497,519,240,522,762
1000,501,500,508,257,496,753
1000,504,495,508,257,492,749
1000,504,507,497,261,480,741
1000,499,470,502,232,501,733
1000,523,493,485,265,487,752
1000,504,504,526,250,515,765
1000,492,503,501,247,498,745
1000,509,529,517,272,509,781
1000,497,497,518,252,495,747
1000,502,494,512,248,501,749
1000,495,515,497,248,498,746
1000,480,507,505,245,493,738
1000,492,501,512,258,500,758
1000,510,525,484,260,470,730
1000,473,483,499,231,504,735
1000,505,509,495,262,482,744
1000,515,506,484,258,514,772
1000,489,519,494,233,513,746
1000,488,504,531,235,530,765
1000,505,493,500,249,515,764
1000,521,504,529,264,510,774
1000,531,513,491,275,485,760
1000,509,531,502,282,462,744
1000,539,489,521,256,534,790
1000,495,518,515,258,503,761
1000,495,524,505,261,482,743
1000,494,518,461,252,474,726
1000,497,515,486,273,478,751
1000,499,497,522,249,520,769
1000,528,496,499,267,495,762
1000,509,484,461,239,501,740
1000,507,498,492,252,513,765
1000,487,510,513,252,505,757
1000,507,510,487,268,475,743
1000,512,497,475,246,514,760
1000,485,524,498,253,490,743
1000,462,480,474,226,503,729
1000,517,488,496,264,507,771
1000,525,483,515,256,503,759
1000,491,502,490,246,496,742
1000,506,488,512,247,519,766
1000,517,475,496,242,519,761
1000,477,508,515,249,491,740
1000,473,508,492,238,501,739
1000,486,492,493,238,495,733
1000,500,466,522,245,524,769
1000,515,471,507,238,517,755
1000,493,520,515,263,494,757
1000,506,531,523,269,502,771
1000,513,501,506,271,491,762
1000,520,494,511,265,498,763
1000,532,513,515,281,494,775
1000,495,458,514,226,512,738
1000,513,498,505,265,477,742
1000,502,513,494,255,489,744
1000,515,517,490,267,481,748
1000,506,520,500,263,491,754
1000,499,490,510,233,511,744
1000,502,514,515,262,498,760
1000,530,478,492,264,498,762
1000,481,463,521,218,528,746
1000,499,501,502,243,495,738
1000,480,498,514,232,526,758
1000,489,478,527,230,517,747
1000,490,503,500,239,498,737
1000,538,484,502,263,519,782
1000,512,484,496,237,517,754
1000,506,490,494,236,509,745
1000,479,500,528,231,510,741
1000,507,504,476,258,482,740
1000,508,486,492,245,504,749
1000,503,525,499,265,499,764
1000,470,508,498,231,507,738
1000,499,517,499,250,518,768
1000,504,514,478,260,467,727
1000,502,512,491,250,490,740
1000,523,480,499,251,506,757
1000,497,487,498,257,495,752
1000,514,486,473,241,501,742
1000,495,510,492,258,473,731
1000,488,501,502,242,508,750
1000,515,509,492,261,484,745
1000,505,483,495,250,484,734
1000,497,520,495,272,475,747
1000,493,533,514,259,501,760
1000,502,507,515,244,516,760
1000,498,524,478,266,476,742
1000,494,502,477,243,508,751
1000,488,478,520,231,526,757
1000,500,524,497,260,502,762
1000,487,480,500,240,506,746
1000,526,521,525,272,497,769
1000,510,498,514,253,513,766
1000,525,461,497,246,517,763
1000,479,491,486,241,482,723
1000,491,494,521,255,500,755
1000,491,501,510,244,498,742
1000,471,514,494,233,507,740
1000,513,511,507,257,505,762
1000,467,518,515,241,497,738
1000,487,485,511,231,507,738
1000,499,504,507,246,502,748
1000,533,503,488,270,486,756
1000,486,518,493,259,489,748
1000,482,492,487,235,492,727
1000,469,506,529,235,509,744
1000,506,514,515,258,504,762
1000,477,467,481,215,504,719
1000,491,495,492,239,501,740
1000,497,494,490,234,505,739
1000,488,523,530,243,519,762
1000,507,486,477,232,505,737
1000,500,534,505,272,478,750
1000,490,495,466,260,460,720
1000,516,506,513,252,529,781
1000,484,476,491,218,520,738
1000,518,500,479,253,502,755
1000,499,506,515,257,506,763
1000,472,484,488,231,495,726
1000,496,495,522,234,526,760
1000,499,478,506,242,509,751
1000,514,513,501,271,483,754
1000,503,494,475,246,481,727
1000,501,515,520,249,496,745
1000,497,496,489,244,510,754
1000,484,511,517,249,503,752
1000,471,505,520,222,521,743
1000,509,501,513,256,507,763
1000,484,487,498,232,519,751
1000,492,490,505,243,488,731
1000,485,496,509,242,505,747
1000,511,490,496,251,488,739
1000,497,510,466,253,480,733
1000,492,492,493,239,491,730
1000,521,513,498,274,482,756
1000,525,535,511,276,488,764
1000,517,476,492,245,516,761
1000,493,500,507,258,494,752
1000,501,528,482,275,469,744
1000,499,487,499,235,517,752
1000,451,511,502,247,473,720
1000,509,513,502,247,512,759
1000,493,512,523,265,492,757
1000,516,502,519,267,493,760
1000,517,512,504,270,482,752
1000,504,474,510,238,507,745
1000,501,499,523,262,487,749
1000,510,510,499,261,498,759
1000,523,448,485,235,521,756
1000,490,517,493,255,479,734
1000,516,479,515,238,537,775
1000,479,509,477,230,508,738
1000,490,487,507,227,517,744
1000,508,515,517,268,492,760
1000,499,511,508,245,497,742
1000,507,481,484,222,521,743
1000,528,493,474,259,500,759
1000,479,493,473,241,478,719
1000,493,514,522,259,504,763
1000,482,469,530,223,520,743
1000,522,512,480,255,492,747
1000,506,477,488,222,525,747
1000,497,489,503,241,505,746
1000,505,511,496,252,505,757
1000,494,482,511,234,519,753
1000,478,526,479,253,473,726
1000,507,502,470,253,484,737
1000,456,494,515,236,505,741
1000,487,496,506,240,516,756
1000,484,458,489,222,526,748
1000,496,487,493,228,510,738
1000,470,524,503,255,489,744
1000,502,528,505,275,484,759
1000,531,502,496,268,501,769
1000,496,504,510,255,496,751
1000,494,526,500,270,475,745
1000,496,488,511,238,501,739
1000,511,513,499,254,504,758
1000,461,520,515,238,506,744
1000,468,510,477,236,474,710
1000,503,506,472,252,463,715
1000,479,464,472,214,509,723
1000,542,483,499,270,494,764
1000,498,485,514,247,498,745
1000,485,497,518,243,509,752
1000,514,508,493,249,500,749
1000,497,484,498,259,485,744
1000,533,480,507,245,535,780
1000,498,460,504,221,543,764
1000,479,530,462,245,472,717
1000,495,511,512,248,501,749
1000,489,489,508,243,493,736
1000,540,516,527,274,514,788
1000,498,499,498,255,483,738
1000,537,511,494,269,496,765
1000,492,502,476,241,493,734
1000,490,506,486,254,485,739
1000,495,515,474,261,478,739
1000,499,506,498,249,488,737
1000,503,529,534,267,487,754
1000,524,509,499,268,497,765
1000,486,484,502,247,493,740
1000,526,519,497,266,494,760
1000,480,479,469,230,491,721
1000,511,487,533,260,496,756
1000,482,513,521,257,506,763
1000,480,513,515,261,479,740
1000,493,493,489,248,491,739
1000,493,483,480,246,473,719
1000,495,494,485,251,480,731
1000,496,496,518,251,501,752
1000,490,509,493,251,497,748
1000,500,507,530,250,507,757
1000,482,496,498,240,502,742
1000,499,537,492,274,460,734
1000,486,511,523,264,484,748
1000,494,502,489,252,493,745
1000,508,533,508,282,484,766
1000,513,483,497,248,497,745
1000,488,513,516,246,511,757
1000,503,537,494,267,470,737
1000,493,489,512,248,499,747
1000,515,490,517,248,506,754
1000,479,494,512,253,491,744
1000,491,513,508,269,489,758
1000,493,535,507,258,494,752
1000,482,492,517,246,512,758
1000,532,487,531,258,528,786
1000,523,496,482,266,478,744
1000,510,489,507,242,514,756
1000,525,489,496,260,497,757
1000,487,511,490,257,484,741
1000,493,489,475,237,490,727
1000,515,493,478,254,503,757
1000,503,489,498,246,509,755
1000,525,521,502,269,504,773
1000,490,485,496,234,496,730
1000,506,466,469,244,498,742
1000,528,511,510,276,492,768
1000,481,509,501,242,500,742
1000,492,505,485,250,485,735
1000,501,504,505,252,496,748
1000,509,512,522,266,497,763
1000,477,491,501,240,511,751
1000,512,493,514,255,499,754
1000,491,489,508,243,506,749
1000,514,501,489,258,497,755
1000,523,513,510,267,512,779
1000,508,499,491,249,498,747
1000,474,507,508,255,487,742
1000,496,490,495,248,490,738
1000,520,533,509,270,492,762
1000,507,484,494,263,488,751
1000,485,477,502,225,520,745
1000,522,498,511,265,488,753
1000,526,479,481,268,500,768
1000,512,470,491,249,500,749
1000,488,497,499,244,510,754
1000,512,502,494,260,496,756
1000,496,471,494,237,499,736
1000,479,510,502,250,496,746
1000,488,472,484,209,526,735
1000,525,506,544,284,495,779
1000,510,497,502,260,478,738
1000,505,486,499,240,504,744
1000,522,525,507,268,505,773
1000,513,504,516,266,496,762
1000,523,517,522,255,525,780
1000,488,532,503,270,470,740
1000,498,484,505,244,504,748
1000,493,518,480,254,491,745
1000,487,473,518,235,521,756
1000,510,515,522,254,520,774
1000,560,515,485,288,485,773
1000,493,527,476,262,469,731
1000,531,514,506,266,504,770
1000,481,491,498,236,499,735
1000,515,533,502,286,480,766
1000,503,471,512,238,526,764
1000,521,502,521,255,511,766
1000,524,493,511,271,490,761
1000,468,482,494,225,516,741
1000,492,484,470,235,490,725
1000,485,516,507,251,487,738
1000,493,529,518,261,494,755
1000,500,517,482,256,475,731
1000,499,481,503,219,536,755
1000,469,530,505,261,468,729
1000,501,487,487,231,496,727
1000,498,512,508,264,490,754
1000,485,513,494,244,501,745
1000,517,505,495,267,483,750
1000,521,521,505,272,489,761
1000,480,506,489,226,511,737
1000,497,525,502,258,487,745
1000,494,509,510,252,515,767
1000,486,492,494,245,479,724
1000,500,472,475,231,500,731
1000,495,496,512,229,527,756
1000,527,501,496,277,474,751
1000,496,497,500,227,523,750
1000,524,501,488,260,480,740
1000,483,509,494,263,480,743
1000,476,506,506,232,504,736
1000,492,517,518,257,490,747
1000,510,498,492,249,488,737
1000,507,501,507,242,510,752
1000,507,502,493,268,498,766
1000,507,506,477,251,485,736
1000,501,485,516,232,528,760
1000,514,488,520,255,512,767
1000,508,476,493,251,490,741
1000,508,506,498,260,493,753
1000,538,497,537,268,528,796
1000,501,491,494,246,500,746
1000,513,503,504,253,505,758
1000,488,509,501,252,482,734
1000,511,492,514,263,503,766
1000,523,497,515,275,491,766
1000,494,503,532,237,526,763
1000,496,521,486,264,473,737
1000,505,480,513,265,497,762
1000,498,492,518,242,507,749
1000,506,501,512,252,509,761
1000,517,517,504,262,492,754
1000,475,487,492,222,504,726
1000,474,487,511,223,527,750
1000,512,485,468,232,517,749
1000,493,516,527,239,518,757
1000,535,522,505,283,488,771
1000,525,487,497,259,492,751
1000,474,481,549,231,512,743
1000,529,503,492,269,490,759
1000,507,485,484,246,492,738
1000,498,524,509,257,500,757
1000,509,498,505,258,497,755
1000,497,513,516,250,505,755
1000,475,483,502,221,517,738
1000,526,484,484,252,498,750
1000,485,503,478,265,454,719
1000,520,505,505,255,499,754
1000,496,503,499,248,502,750
1000,499,498,495,245,496,741
1000,503,513,512,268,492,760
1000,511,495,516,241,513,754
1000,522,507,484,253,503,756
1000,513,501,487,268,500,768
1000,498,503,485,267,472,739
1000,504,501,462,257,472,729
1000,528,506,499,271,494,765
1000,477,511,489,248,480,728
1000,503,473,490,234,512,746
1000,486,510,491,264,461,725
1000,499,499,491,254,490,744
1000,498,533,492,256,483,739
1000,497,500,492,244,501,745
1000,535,530,489,289,468,757
1000,501,520,487,269,468,737
1000,490,479,496,240,491,731
1000,475,499,496,226,518,744
1000,513,507,495,261,483,744
1000,491,448,488,210,540,750
1000,489,502,497,233,516,749
1000,492,508,481,242,495,737
1000,487,495,500,252,495,747
1000,514,483,517,246,522,768
1000,512,517,501,273,477,750
1000,519,468,494,240,514,754
1000,478,500,519,247,506,753
1000,464,511,505,234,519,753
1000,511,529,516,273,489,762
1000,514,508,476,268,493,761
1000,497,477,495,246,500,746
1000,492,510,498,248,505,753
1000,475,481,482,236,496,732
1000,489,506,515,259,498,757
1000,505,514,497,269,486,755
1000,484,491,501,236,505,741
1000,516,479,483,256,492,748
1000,478,503,492,241,511,752
1000,500,511,492,243,500,743
1000,506,510,513,264,489,753
1000,530,528,494,289,481,770
1000,482,481,493,231,493,724
1000,493,469,491,228,522,750
1000,492,518,508,249,515,764
1000,486,494,525,248,510,758
1000,498,485,470,247,482,729
1000,502,495,489,264,485,749
1000,499,499,499,244,498,742
1000,486,487,502,247,516,763
1000,491,515,469,245,494,739
1000,490,494,516,232,515,747
1000,516,509,511,256,507,763
1000,512,519,525,266,506,772
1000,500,507,498,245,518,763
1000,479,500,493,230,496,726
1000,500,494,490,243,503,746
1000,483,518,488,267,463,730
1000,482,493,503,240,507,747
1000,517,517,498,268,485,753
1000,503,491,509,245,506,751
1000,504,489,508,250,509,759
1000,489,480,509,232,505,737
1000,479,492,509,234,494,728
1000,515,497,512,256,494,750
1000,479,515,515,244,512,756
1000,510,519,494,270,491,761
1000,506,515,515,250,512,762
1000,502,540,508,280,474,754
1000,496,464,522,222,542,764
1000,497,481,499,231,514,745
1000,506,505,507,247,516,763
1000,484,496,490,223,514,737
1000,493,472,542,216,545,761
1000,485,515,492,256,476,732
1000,499,509,514,234,535,769
1000,479,517,483,251,475,726
1000,530,520,502,276,480,756
1000,472,515,518,248,491,739
1000,503,510,478,271,466,737
1000,494,498,495,230,509,739
1000,472,492,481,222,505,727
1000,496,522,512,263,480,743
1000,498,487,495,245,515,760
1000,488,507,497,234,502,736
1000,529,478,450,255,499,754
1000,488,541,519,275,471,746
1000,469,466,536,205,542,747
1000,511,497,475,258,491,749
1000,513,488,526,240,527,767
1000,504,502,512,241,528,769
1000,490,513,518,249,507,756
1000,482,512,496,250,506,756
1000,493,523,501,258,495,753
1000,490,476,493,228,513,741
1000,487,486,506,234,516,750
1000,493,494,482,256,489,745
1000,485,505,497,265,478,743
1000,517,484,469,242,506,748
1000,509,504,512,261,503,764
1000,500,504,527,246,504,750
1000,483,495,505,230,513,743
1000,509,484,504,249,511,760
1000,504,506,501,264,498,762
1000,490,491,487,245,487,732
1000,490,524,516,248,510,758
1000,485,483,516,227,507,734
1000,516,527,501,271,489,760
1000,493,471,474,244,487,731
1000,511,446,511,218,552,770
1000,520,510,490,277,466,743
1000,517,518,498,256,501,757
1000,513,487,528,240,523,763
1000,517,495,480,273,481,754
1000,495,503,516,248,509,757
1000,492,487,542,237,541,778
1000,514,515,513,260,508,768
1000,522,495,482,258,485,743
1000,492,500,505,237,508,745
1000,530,508,490,281,476,757
1000,504,499,498,232,523,755
1000,488,490,469,246,474,720
1000,504,477,504,245,517,762
1000,519,510,473,274,479,753
1000,504,510,511,258,511,769
1000,513,479,477,244,503,747
1000,509,520,495,256,507,763
1000,503,480,500,240,504,744
1000,497,505,500,255,496,751
1000,493,499,520,241,525,766
1000,539,501,477,273,493,766
1000,500,499,503,259,488,747
1000,474,512,505,243,513,756
1000,506,465,492,244,505,749
1000,508,519,493,268,478,746
1000,511,513,478,258,485,743
1000,511,512,482,275,470,745
1000,516,469,499,245,499,744
1000,502,490,509,253,496,749
1000,502,528,504,268,490,758
1000,494,496,518,246,515,761
1000,527,491,489,259,497,756
1000,505,503,497,256,491,747
1000,494,504,520,245,520,765
1000,514,522,529,275,504,779
1000,482,489,493,230,498,728
1000,511,494,506,252,507,759
1000,511,446,512,247,514,761
1000,514,493,496,256,500,756
1000,502,501,553,256,514,770
1000,492,508,485,249,494,743
1000,508,502,497,235,526,761
1000,506,493,518,255,509,764
1000,502,525,506,278,486,764
1000,511,509,507,261,496,757
1000,518,484,520,264,497,761
1000,487,505,502,262,488,750
1000,488,511,513,247,507,754
1000,508,514,498,254,492,746
1000,495,502,511,255,496,751
1000,491,484,508,230,517,747
1000,480,505,501,257,472,729
1000,506,525,477,276,465,741
1000,503,520,515,254,506,760
1000,488,511,472,244,485,729
1000,477,518,490,241,489,730
1000,510,500,512,269,492,761
1000,498,508,494,252,501,753
1000,500,498,462,243,486,729
1000,507,528,511,264,504,768
1000,463,483,474,227,489,716
1000,492,485,481,229,516,745
1000,494,479,505,242,518,760
1000,497,479,499,240,502,742
1000,519,510,499,269,486,755
1000,492,510,509,249,512,761
1000,529,481,524,261,507,768
1000,495,504,496,245,499,744
1000,490,493,507,230,524,754
1000,506,518,500,246,510,756
1000,492,499,512,248,496,744
1000,517,490,454,256,480,736
1000,471,488,484,220,498,718
1000,489,527,515,261,495,756
1000,513,501,481,248,489,737
1000,526,502,493,252,515,767
1000,491,487,492,238,511,749
1000,524,505,508,268,494,762
1000,467,509,534,224,534,758
1000,505,476,514,251,515,766
1000,482,508,500,241,503,744
1000,481,513,511,253,515,768
1000,496,496,506,249,514,763
1000,465,510,525,256,494,750
1000,477,490,479,225,504,729
1000,487,512,515,251,503,754
1000,517,515,501,273,491,764
1000,495,512,528,254,505,759
1000,497,504,496,243,519,762
1000,520,527,486,256,505,761
1000,487,482,502,234,524,758
1000,490,485,482,231,521,752
1000,483,508,522,251,505,756
1000,516,517,493,276,484,760
1000,493,459,483,228,517,745
1000,510,519,496,257,503,760
1000,478,511,506,234,509,743
1000,515,483,521,253,508,761
1000,492,503,520,239,502,741
1000,494,497,488,256,469,725
1000,467,553,505,250,489,739
1000,533,504,518,287,483,770
1000,500,499,481,242,498,740
1000,512,491,490,254,498,752
1000,507,503,516,253,511,764
1000,478,504,496,238,494,732
1000,530,504,504,267,506,773
1000,459,513,489,233,496,729
1000,493,462,489,228,520,748
1000,492,488,520,227,532,759
1000,479,528,519,249,509,758
1000,506,543,500,283,460,743
1000,532,491,494,258,509,767
1000,506,503,503,259,492,751
1000,491,508,486,248,480,728
1000,501,504,468,254,495,749
1000,476,488,528,235,507,742
1000,485,528,507,242,498,740
1000,498,495,502,255,508,763
1000,483,498,498,246,497,743
1000,439,498,494,216,504,720
1000,493,496,504,238,505,743
1000,471,476,501,220,507,727
1000,519,484,482,244,503,747
1000,509,499,527,256,520,776
1000,499,489,483,237,505,742
1000,509,516,495,255,504,759
1000,498,505,476,247,502,749
1000,504,481,500,244,500,744
1000,477,500,493,231,506,737
1000,499,508,499,270,476,746
1000,508,502,497,265,494,759
1000,470,519,470,257,458,715
1000,506,508,494,263,487,750
1000,518,496,514,270,496,766
1000,488,493,479,237,504,741
1000,491,473,503,235,513,748
1000,493,481,513,235,511,746
1000,530,509,495,275,494,769
1000,519,512,495,266,502,768
1000,509,507,503,258,498,756
1000,519,516,500,265,487,752
1000,528,498,510,271,496,767
1000,507,491,493,242,519,761
1000,493,515,501,245,506,751
1000,493,496,508,232,520,752
1000,473,482,511,230,517,747
1000,519,512,498,270,486,756
1000,493,506,461,243,489,732
1000,507,509,521,256,496,752
1000,523,479,475,263,479,742
1000,505,493,505,249,501,750
1000,494,520,510,256,497,753
1000,496,500,477,242,484,726
1000,488,483,514,229,498,727
1000,498,529,501,257,489,746
1000,513,482,492,232,514,746
1000,514,503,523,256,508,764
1000,507,490,522,247,517,764
1000,506,511,480,268,471,739
1000,513,502,520,257,512,769
1000,519,486,518,252,516,768
1000,516,505,486,255,493,748
1000,511,488,491,240,498,738
1000,501,516,492,262,496,758
1000,496,506,499,252,507,759
1000,493,496,504,237,520,757
1000,529,474,507,239,518,757
1000,523,516,515,262,501,763
1000,504,499,534,248,526,774
1000,504,503,522,258,490,748
1000,521,476,494,247,512,759
1000,491,511,514,247,509,756
1000,499,504,509,252,489,741
1000,489,511,507,253,488,741
1000,507,503,478,260,482,742
1000,486,496,512,247,494,741
1000,484,482,505,226,529,755
1000,479,514,509,244,509,753
1000,493,470,484,232,513,745
1000,517,487,494,251,493,744
1000,502,505,505,259,487,746
1000,519,470,500,240,527,767
1000,515,502,478,258,487,745
1000,512,505,499,250,507,757
1000,482,497,491,246,500,746
1000,496,502,493,238,513,751
1000,465,490,498,226,511,737
1000,502,481,494,247,496,743
1000,483,510,510,232,512,744
1000,496,498,494,226,516,742
1000,486,480,500,217,522,739
1000,498,517,486,263,474,737
1000,504,503,491,257,476,733
1000,494,482,513,242,503,745
1000,513,530,500,276,476,752
1000,477,499,496,236,507,743
1000,485,481,524,227,526,753
1000,490,537,494,277,467,744
1000,498,525,508,265,503,768
1000,511,524,490,275,477,752
1000,481,497,512,242,504,746
1000,487,536,486,270,465,735
1000,502,511,474,260,475,735
1000,491,504,492,240,493,733
1000,526,497,518,264,513,777
1000,496,502,498,256,498,754
1000,501,497,489,254,493,747
1000,477,497,520,238,518,756
1000,524,489,487,256,502,758
1000,507,506,516,252,510,762
1000,501,502,486,254,494,748
1000,512,486,527,250,516,766
1000,464,514,473,229,496,725
1000,486,519,527,250,498,748
1000,502,511,510,264,488,752
1000,533,495,501,259,502,761
1000,495,500,478,248,480,728
1000,481,504,506,246,492,738
1000,519,522,504,283,481,764
1000,506,526,499,268,482,750
1000,509,499,511,248,512,760
1000,482,481,534,230,527,757
1000,499,508,482,246,500,746
1000,530,493,509,255,502,757
1000,519,521,507,261,507,768
1000,469,486,489,245,482,727
1000,542,501,491,267,502,769
1000,510,523,488,263,484,747
1000,478,495,484,230,497,727
1000,492,482,531,234,515,749
1000,511,498,511,262,501,763
1000,491,490,510,243,503,746
1000,502,492,509,228,520,748
1000,486,489,509,246,499,745
1000,502,518,501,256,485,741
1000,493,510,512,242,507,749
1000,527,478,510,258,508,766
1000,504,504,511,242,517,759
1000,506,494,500,257,494,751
1000,497,489,498,248,492,740
1000,494,491,498,242,493,735
1000,511,492,483,247,490,737
1000,506,509,504,261,491,752
1000,488,508,491,251,494,745
1000,470,510,465,236,488,724
1000,530,496,513,267,513,780
1000,497,488,477,242,500,742
1000,509,498,490,238,510,748
1000,504,498,503,255,494,749
1000,523,505,528,261,519,780
1000,480,484,496,211,536,747
1000,496,505,497,262,472,734
1000,504,506,493,258,504,762
1000,479,506,506,239,513,752
1000,503,507,477,243,488,731
1000,502,497,522,252,499,751
1000,513,528,485,269,467,736
1000,506,517,491,258,488,746
1000,519,479,472,252,494,746
1000,512,513,539,262,504,766
1000,508,480,479,249,503,752
1000,490,510,516,251,507,758
1000,488,494,509,250,498,748
1000,489,492,501,243,502,745
1000,486,485,506,218,523,741
1000,514,518,539,261,514,775
1000,523,487,519,259,503,762
1000,500,531,505,278,462,740
1000,473,507,457,246,468,714
1000,498,493,510,247,510,757
1000,515,518,500,255,511,766
1000,508,504,496,258,500,758
1000,499,517,507,262,487,749
1000,485,514,518,247,501,748
1000,493,492,505,248,509,757
1000,537,481,483,252,507,759
1000,525,507,483,265,486,751
1000,506,466,507,234,523,757
1000,505,479,523,232,528,760
1000,490,500,487,246,496,742
1000,460,517,512,253,479,732
1000,482,499,506,240,502,742
1000,520,498,507,272,498,770
1000,512,477,491,245,505,750
1000,489,488,482,250,479,729
1000,492,524,515,253,503,756
1000,520,519,528,275,507,782
1000,488,492,499,245,497,742
1000,511,499,509,238,516,754
1000,497,510,499,238,501,739
1000,477,498,491,239,496,735
1000,507,486,513,238,524,762
1000,530,491,514,260,517,777
1000,476,527,526,244,497,741
1000,526,518,523,270,511,781
1000,492,518,480,266,482,748
1000,505,502,500,257,507,764
1000,484,503,502,254,492,746
1000,506,499,502,243,511,754
1000,482,503,514,241,512,753
1000,509,516,496,260,485,745
1000,480,519,522,248,494,742
1000,499,495,523,234,537,771
1000,519,499,515,253,512,765
1000,493,513,496,259,476,735
1000,505,486,506,263,503,766
1000,506,517,468,256,488,744
1000,509,496,487,251,499,750
1000,508,504,496,248,497,745
1000,493,487,514,245,503,748
1000,495,502,514,250,502,752
1000,518,504,479,252,488,740
1000,490,479,498,231,507,738
1000,503,503,507,260,513,773
1000,506,507,511,253,507,760
1000,519,464,513,254,512,766
1000,456,498,472,228,489,717
1000,515,520,507,276,486,762
1000,521,491,494,256,499,755
1000,500,526,495,265,488,753
1000,513,479,502,246,509,755
1000,491,485,487,245,489,734
1000,525,509,482,271,492,763
1000,497,493,525,234,535,769
1000,487,501,510,239,506,745
1000,502,474,505,237,514,751
1000,478,483,512,211,525,736
1000,493,529,491,265,475,740
1000,501,497,490,253,480,733
1000,500,506,498,241,512,753
1000,489,505,473,255,492,747
1000,502,492,475,241,479,720
1000,491,492,505,250,494,744
1000,511,497,506,262,502,764
1000,490,476,513,230,521,751
1000,492,497,485,231,504,735
1000,496,501,510,233,517,750
1000,503,502,465,245,493,738
1000,501,509,505,251,513,764
1000,520,485,483,240,520,760
1000,536,505,525,280,496,776
1000,512,505,536,248,533,781
1000,501,514,463,252,484,736
1000,507,504,504,247,526,773
1000,509,532,516,290,463,753
1000,481,518,493,251,483,734
1000,491,499,522,243,509,752
1000,509,494,473,239,494,733
1000,484,497,508,236,508,744
1000,499,513,511,258,497,755
1000,478,510,507,246,496,742
1000,515,505,491,263,496,759
1000,520,477,505,263,492,755
1000,495,493,501,246,492,738
1000,495,487,515,242,505,747
1000,486,494,493,241,501,742
1000,523,530,483,272,477,749
1000,523,505,506,267,493,760
1000,506,512,504,267,491,758
1000,496,493,474,248,494,742
1000,486,479,474,249,481,730
1000,499,488,500,238,504,742
1000,513,501,487,269,484,753
1000,503,494,519,248,522,770
1000,489,485,505,236,508,744
1000,511,465,497,237,522,759
1000,483,492,528,246,503,749
1000,500,488,506,249,502,751
1000,491,499,494,241,497,738
1000,491,490,520,239,518,757
1000,501,504,476,257,484,741
1000,491,479,490,231,511,742
1000,505,499,521,253,496,749
1000,520,485,468,263,475,738
1000,495,513,507,248,515,763
1000,510,498,506,244,520,764
1000,524,478,508,256,516,772
1000,517,506,512,264,495,759
1000,498,470,505,233,519,752
1000,484,503,537,252,506,758
1000,476,501,502,249,477,726
1000,483,497,534,250,495,745
1000,477,501,498,233,520,753
1000,487,513,496,240,501,741
1000,490,485,512,248,497,745
1000,493,506,478,231,495,726
1000,491,499,494,245,499,744
1000,492,494,491,246,493,739
1000,486,493,503,241,502,743
1000,528,524,488,263,499,762
1000,498,516,507,260,496,756
1000,512,512,477,245,500,745
1000,490,475,489,228,508,736
1000,506,509,521,254,494,748
1000,512,499,481,264,491,755
1000,478,480,499,226,520,746
1000,489,521,503,264,496,760
1000,509,493,496,247,519,766
1000,475,497,520,232,515,747
1000,528,496,476,273,476,749
1000,489,488,490,234,511,745
1000,458,469,492,214,508,722
1000,487,509,505,242,486,728
1000,490,505,481,258,474,732
1000,513,514,517,268,501,769
1000,498,487,484,245,499,744
1000,488,501,525,237,512,749
1000,509,491,491,252,506,758
1000,479,509,501,248,492,740
1000,518,514,478,259,498,757
1000,483,498,518,235,514,749
1000,500,470,509,240,514,754
1000,483,523,496,263,483,746
1000,513,493,494,242,521,763
1000,491,503,505,246,503,749
1000,507,479,514,239,528,767
1000,516,495,507,254,525,779
1000,499,494,490,238,514,752
1000,463,510,519,238,492,730
1000,486,512,512,259,486,745
1000,482,499,523,238,516,754
1000,495,485,511,239,512,751
1000,503,496,509,240,525,765
1000,495,527,495,265,500,765
1000,524,456,506,244,511,755
1000,507,509,507,265,503,768
1000,521,517,496,275,475,750
1000,510,505,467,260,482,742
1000,510,472,501,258,503,761
1000,498,485,496,248,505,753
1000,492,517,520,256,505,761
1000,528,469,485,252,485,737
1000,514,483,485,258,502,760
1000,507,478,504,239,528,767
1000,515,506,477,263,486,749
1000,512,472,503,245,520,765
1000,495,495,504,252,500,752
1000,485,518,513,252,504,756
1000,521,490,510,268,506,774
1000,478,487,501,228,512,740
1000,517,546,524,283,489,772
1000,486,498,493,246,490,736
1000,489,496,499,260,482,742
1000,488,512,475,255,468,723
1000,519,498,498,254,506,760
1000,540,491,496,265,509,774
1000,532,504,478,268,493,761
1000,483,513,516,249,510,759
1000,514,467,505,257,491,748
1000,482,501,472,243,488,731
1000,511,508,489,260,494,754
1000,526,493,480,251,507,758
1000,515,505,511,257,505,762
1000,491,468,494,222,515,737
1000,517,523,493,272,491,763
1000,515,503,478,249,487,736
1000,507,493,501,246,514,760
1000,485,507,498,239,496,735
1000,499,537,520,286,476,762
1000,490,503,473,248,492,740
1000,527,500,517,266,497,763
1000,492,481,521,233,528,761
1000,475,518,517,249,500,749
1000,511,511,472,278,459,737
1000,489,480,485,208,527,735
1000,487,511,486,246,501,747
1000,505,503,512,248,503,751
1000,514,517,528,273,495,768
1000,518,521,504,286,474,760
1000,514,508,487,270,481,751
1000,510,497,505,255,505,760
1000,495,531,469,253,484,737
1000,515,497,494,255,498,753
1000,486,489,519,248,517,765
1000,512,512,493,261,493,754
1000,501,509,496,262,479,741
1000,511,493,522,248,527,775
1000,514,520,485,266,487,753
1000,500,501,550,246,522,768
1000,510,487,476,259,490,749
1000,483,497,514,249,487,736
1000,517,501,499,244,520,764
1000,511,494,501,253,491,744
1000,484,532,490,252,478,730
1000,492,497,506,233,520,753
1000,529,515,473,265,482,747
1000,517,501,508,253,507,760
1000,488,512,486,256,485,741
1000,497,488,481,236,508,744
1000,507,489,499,240,514,754
1000,504,519,510,253,512,765
1000,494,517,504,259,492,751
1000,504,494,500,247,514,761
1000,526,476,523,266,513,779
1000,498,514,499,247,501,748
1000,510,488,504,247,517,764
1000,499,486,491,254,494,748
1000,492,505,499,257,489,746
1000,500,502,494,245,505,750
1000,502,505,484,243,509,752
1000,477,509,493,242,506,748
1000,497,509,500,255,499,754
1000,510,502,501,257,489,746
1000,463,493,505,233,495,728
1000,508,487,501,264,495,759
1000,504,466,517,245,512,757
1000,491,476,502,234,520,754
1000,511,500,490,266,483,749
1000,502,493,507,256,502,758
1000,521,486,474,238,500,738
1000,525,491,507,236,535,771
1000,487,514,501,246,499,745
1000,499,511,519,259,497,756
1000,481,512,491,255,471,726
1000,514,499,518,254,508,762
1000,516,524,490,265,496,761
1000,493,509,501,247,521,768
1000,493,477,503,249,501,750
1000,493,487,478,244,492,736
1000,494,514,503,259,475,734
1000,484,485,502,232,512,744
1000,490,499,501,248,487,735
1000,490,480,518,228,529,757
1000,480,518,484,243,490,733
1000,494,514,487,253,497,750
1000,491,521,520,253,502,755
1000,521,520,486,277,481,758
1000,497,483,492,236,497,733
1000,477,504,508,244,513,757
1000,465,496,500,232,513,745
1000,498,503,512,253,497,750
1000,490,509,502,248,498,746
1000,542,516,484,276,486,762
1000,494,499,503,244,486,730
1000,501,523,509,270,496,766
1000,512,510,481,265,482,747
1000,494,521,488,254,494,748
1000,492,506,522,257,496,753
1000,494,522,478,266,480,746
1000,511,492,500,254,518,772
1000,499,507,509,254,507,761
1000,512,498,498,245,504,749
1000,507,497,514,251,507,758
1000,468,494,524,225,521,746
1000,513,495,520,259,511,770
1000,496,491,518,251,505,756
1000,520,510,510,268,500,768
1000,521,523,500,278,492,770
1000,521,514,485,280,486,766
1000,492,510,530,251,518,769
1000,512,487,479,260,477,737
1000,507,470,508,236,524,760
1000,493,501,506,236,514,750
1000,495,521,507,250,503,753
1000,516,495,500,250,521,771
1000,496,498,489,255,479,734
1000,506,476,495,229,516,745
1000,501,498,491,253,487,740
1000,509,485,498,240,517,757
1000,481,520,515,245,504,749
1000,485,500,524,238,517,755
1000,479,508,494,234,493,727
1000,517,507,504,259,497,756
1000,488,480,495,247,493,740
1000,507,509,491,270,468,738
1000,502,496,492,245,499,744
1000,489,481,480,235,505,740
1000,525,479,513,252,511,763
1000,450,508,472,223,482,705
1000,492,493,484,249,471,720
1000,510,506,522,257,511,768
1000,525,492,508,268,497,765
1000,493,494,494,241,513,754
1000,500,499,488,255,489,744
1000,519,510,508,267,480,747
1000,489,513,509,260,502,762
1000,508,484,500,252,502,754
1000,495,493,514,248,501,749
1000,486,494,511,241,503,744
1000,488,526,476,253,481,734
1000,479,510,496,252,479,731
1000,510,512,514,254,503,757
1000,501,494,486,250,492,742
1000,503,500,512,253,499,752
1000,527,500,481,265,503,768
1000,513,514,471,265,466,731
1000,500,511,508,252,515,767
1000,477,474,503,229,526,755
1000,510,513,520,265,498,763
1000,518,503,508,274,481,755
1000,498,518,500,265,483,748
1000,511,509,486,251,499,750
1000,513,474,500,246,511,757
1000,484,529,505,260,501,761
1000,498,479,489,244,502,746
1000,486,508,502,242,488,730
1000,495,510,508,248,503,751
1000,510,483,492,240,514,754
1000,486,487,513,244,512,756
1000,486,489,481,246,476,722
1000,475,534,510,250,485,735
1000,497,502,474,253,493,746
1000,492,502,519,240,518,758
1000,502,478,511,237,522,759
1000,475,495,478,252,482,734
1000,512,452,494,243,521,764
1000,480,517,552,231,534,765
1000,531,478,519,251,530,781
1000,483,509,490,245,492,737
1000,498,519,516,256,498,754
1000,491,494,500,257,489,746
1000,482,491,508,244,490,734
1000,498,471,491,237,493,730
1000,514,494,481,268,476,744
1000,503,507,516,247,519,766
1000,512,528,502,262,485,747
1000,499,511,491,268,459,727
1000,513,500,488,254,485,739
1000,504,507,483,261,463,724
1000,477,507,500,236,491,727
1000,519,504,504,251,526,777
1000,478,524,512,252,487,739
1000,495,486,478,237,486,723
1000,468,457,492,218,499,717
1000,475,504,512,230,501,731
1000,479,521,500,266,477,743
1000,502,491,493,259,492,751
1000,492,520,487,260,481,741
1000,521,512,489,267,508,775
1000,501,510,513,248,508,756
1000,467,503,497,254,487,741
1000,480,494,489,247,481,728
1000,509,501,505,268,476,744
1000,492,485,512,246,484,730
1000,485,517,492,257,485,742
1000,510,517,504,267,496,763
1000,507,485,487,252,485,737
1000,534,482,501,249,518,767
1000,482,516,496,234,515,749
1000,501,496,511,247,510,757
1000,497,481,496,239,520,759
1000,489,518,516,256,501,757
1000,504,484,506,236,513,749
1000,487,507,502,246,502,748
1000,483,506,519,249,507,756
1000,491,486,505,228,524,752
1000,502,490,485,260,487,747
1000,505,491,505,229,533,762
1000,499,507,544,241,526,767
1000,521,525,484,266,477,743
1000,493,513,488,265,485,750
1000,470,521,528,224,524,748
1000,463,495,488,239,479,718
1000,501,489,515,231,519,750
1000,502,498,506,254,491,745
1000,493,466,521,227,525,752
1000,471,497,515,244,488,732
1000,479,509,485,237,502,739
1000,509,490,510,253,505,758
1000,477,490,511,247,506,753
1000,506,500,503,257,504,761
1000,492,504,506,249,517,766
1000,535,542,518,277,495,772
1000,493,493,474,228,502,730
1000,491,503,509,256,495,751
1000,516,483,496,252,517,769
1000,485,507,513,243,513,756
1000,469,504,519,245,504,749
1000,533,463,506,233,542,775
1000,516,479,493,247,515,762
1000,498,487,500,244,507,751
1000,486,482,461,230,486,716
1000,487,503,501,248,497,745
1000,518,525,506,256,503,759
1000,493,503,516,250,519,769
1000,488,485,486,234,505,739
1000,495,460,488,228,507,735
1000,498,519,498,267,485,752
1000,495,491,495,239,506,745
1000,503,495,492,253,512,765
1000,500,524,512,260,503,763
1000,507,483,481,252,477,729
1000,476,515,486,241,491,732
1000,503,497,488,245,499,744
1000,486,498,505,251,496,747
1000,511,497,501,239,518,757
1000,491,468,500,232,523,755
1000,513,481,487,241,508,749
1000,502,512,493,248,497,745
1000,479,478,509,230,513,743
1000,505,523,507,261,498,759
1000,492,498,493,228,512,740
1000,485,502,523,242,509,751
1000,492,508,487,233,507,740
1000,490,504,482,248,484,732
1000,529,501,473,251,492,743
1000,501,528,514,279,473,752
1000,470,486,495,229,494,723
1000,526,539,505,276,501,777
1000,474,519,478,248,475,723
1000,489,509,492,247,503,750
1000,500,474,507,239,514,753
1000,473,500,491,223,512,735
1000,503,523,505,260,491,751
1000,476,489,464,232,496,728
1000,504,497,501,263,475,738
1000,487,477,499,226,526,752
1000,480,499,518,232,522,754
1000,496,513,474,251,478,729
1000,520,478,527,262,517,779
1000,531,511,522,272,505,777
1000,492,516,521,263,496,759
1000,490,492,499,239,522,761
1000,482,532,511,258,490,748
1000,514,508,505,256,499,755
1000,535,491,487,275,488,763
1000,502,513,503,262,483,745
1000,495,515,503,269,475,744
1000,499,489,515,251,507,758
1000,488,497,520,243,496,739
1000,527,506,498,269,502,771
1000,483,474,501,217,529,746
1000,519,481,479,251,503,754
1000,519,492,503,249,515,764
1000,478,468,504,234,492,726
1000,504,489,500,243,511,754
1000,517,469,496,250,506,756
1000,483,482,500,235,508,743
1000,496,482,511,236,506,742
1000,511,509,496,262,502,764
1000,497,474,500,240,502,742
1000,457,541,485,244,482,726
1000,480,494,477,240,479,719
1000,499,499,492,242,506,748
1000,498,498,486,245,499,744
1000,517,520,506,274,477,751
1000,503,486,497,244,508,752
1000,520,494,554,259,523,782
1000,498,498,506,239,526,765
1000,492,493,493,234,504,738
1000,485,458,524,220,533,753
1000,523,478,493,251,512,763
1000,501,495,505,245,511,756
1000,515,493,499,263,490,753
1000,500,501,503,244,514,758
1000,520,485,481,260,494,754
1000,507,484,490,244,492,736
1000,508,524,475,266,473,739
1000,514,528,512,275,491,766
1000,478,503,486,242,489,731
1000,499,526,474,276,475,751
1000,482,490,532,224,541,765
1000,516,515,510,247,513,760
1000,501,487,504,259,491,750
1000,496,487,471,243,483,726
1000,489,489,471,235,490,725
1000,504,510,471,262,473,735
1000,486,515,486,240,495,735
1000,482,502,506,242,499,741
1000,479,503,550,236,531,767
1000,497,496,539,237,526,763
1000,474,497,497,244,500,744
1000,478,511,509,243,513,756
1000,515,511,510,260,495,755
1000,477,485,513,246,492,738
1000,503,524,471,271,477,748
1000,493,477,462,241,468,709
1000,524,507,505,275,487,762
1000,512,503,472,246,493,739
1000,481,492,477,237,490,727
1000,492,485,513,234,510,744
1000,489,506,491,255,489,744
1000,516,501,500,253,517,770
1000,505,515,512,257,497,754
1000,552,490,497,267,503,770
1000,498,484,517,229,514,743
1000,500,494,508,242,511,753
1000,499,525,478,275,459,734
1000,503,528,502,265,483,748
1000,527,509,497,266,517,783
1000,527,498,489,263,486,749
1000,515,499,480,254,506,760
1000,493,489,484,221,514,735
1000,498,525,489,259,476,735
1000,497,493,479,242,489,731
1000,511,509,507,269,485,754
1000,506,492,508,246,506,752
1000,504,480,482,244,497,741
1000,514,509,517,260,496,756
1000,490,520,501,256,484,740
1000,510,511,513,282,471,753
1000,501,485,531,245,523,768
1000,525,495,496,274,485,759
1000,504,472,499,246,504,750
1000,496,505,488,255,483,738
1000,480,504,513,237,510,747
1000,494,517,496,250,504,754
1000,481,512,486,248,479,727
1000,490,475,498,239,508,747
1000,512,517,481,257,495,752
1000,495,489,475,241,500,741
1000,508,494,507,252,523,775
1000,505,489,488,251,514,765
1000,487,503,492,251,484,735
1000,478,526,495,249,490,739
1000,500,504,513,260,492,752
1000,496,513,514,262,491,753
1000,520,506,500,256,512,768
1000,490,512,514,260,501,761
1000,486,505,479,239,497,736
1000,508,506,501,262,488,750
1000,504,513,490,262,487,749
1000,501,503,490,255,488,743
1000,513,533,506,278,478,756
1000,511,500,497,253,499,752
1000,490,488,500,239,510,749
1000,502,486,470,259,482,741
1000,543,522,491,279,505,784
1000,488,501,493,262,487,749
1000,484,508,490,252,494,746
1000,525,476,509,248,521,769
1000,505,511,497,254,487,741
1000,509,507,523,252,509,761
1000,491,511,497,242,514,756
1000,489,476,468,231,499,730
1000,498,501,501,262,491,753
1000,507,522,524,265,497,762
1000,503,507,485,259,479,738
1000,502,510,505,268,486,754
1000,491,496,490,243,506,749
1000,468,496,495,232,506,738
1000,507,474,499,234,518,752
1000,479,525,509,251,494,745
1000,494,513,494,252,500,752
1000,501,491,494,251,512,763
1000,503,475,509,233,526,759
1000,516,489,498,255,504,759
1000,484,514,521,240,519,759
1000,469,498,487,237,491,728
1000,483,488,489,243,482,725
1000,521,513,543,281,503,784
1000,504,526,481,262,483,745
1000,493,509,503,266,492,758
1000,493,521,483,238,504,742
1000,494,480,479,235,500,735
1000,476,522,498,241,500,741
1000,499,501,521,253,519,772
1000,508,523,514,272,494,766
1000,497,510,480,258,476,734
1000,481,495,500,249,482,731
1000,530,510,527,278,502,780
1000,518,534,485,261,488,749
1000,514,517,488,287,467,754
1000,483,500,491,235,497,732
1000,516,494,480,262,493,755
1000,492,518,511,267,491,758
1000,489,505,521,241,509,750
1000,512,486,509,255,504,759
1000,490,503,480,255,481,736
1000,498,506,498,250,490,740
1000,480,501,472,230,499,729
1000,491,484,519,255,511,766
1000,508,487,514,251,505,756
1000,507,525,484,272,467,739
1000,474,499,498,237,487,724
1000,490,507,507,247,506,753
1000,498,505,524,256,501,757
1000,517,509,498,270,466,736
1000,502,541,470,260,489,749
1000,493,492,479,238,489,727
1000,500,482,507,237,514,751
1000,496,524,499,252,508,760
1000,492,500,483,250,498,748
1000,470,475,503,216,518,734
1000,485,503,494,257,494,751
1000,486,495,528,236,518,754
1000,479,491,500,239,492,731
1000,473,490,479,238,484,722
1000,486,519,480,239,493,732
1000,521,475,528,246,537,783
1000,490,518,498,256,493,749
1000,487,474,504,246,499,745
1000,530,498,507,263,505,768
1000,513,472,495,240,502,742
1000,529,500,535,274,514,788
1000,500,508,503,261,481,742
1000,482,462,496,219,515,734
1000,493,486,500,250,484,734
1000,522,487,524,260,515,775
1000,512,479,496,250,498,748
1000,473,523,486,258,479,737
1000,510,468,480,236,526,762
1000,495,507,519,262,500,762
1000,496,483,498,238,506,744
1000,498,519,489,271,467,738
1000,507,521,487,267,478,745
1000,488,505,512,248,499,747
1000,505,507,518,250,507,757
1000,492,499,496,239,485,724
1000,500,496,522,250,513,763
1000,510,520,505,269,489,758
1000,470,509,498,239,497,736
1000,469,509,477,245,480,725
1000,484,514,480,252,486,738
1000,508,486,500,232,522,754
1000,483,486,529,235,515,750
1000,493,491,498,248,508,756
1000,506,523,500,255,503,758
1000,519,474,497,244,499,743
1000,499,493,463,246,476,722
1000,532,490,485,263,499,762
1000,493,520,521,250,506,756
1000,494,491,496,250,494,744
1000,515,504,501,257,504,761
1000,497,513,500,246,492,738
1000,499,501,484,242,488,730
1000,481,506,514,236,519,755
1000,478,488,495,236,490,726
1000,501,497,491,244,504,748
1000,491,465,503,235,518,753
1000,514,489,505,265,484,749
1000,529,487,521,255,517,772
1000,537,498,490,257,517,774
1000,518,500,490,259,482,741
1000,523,498,512,259,506,765
1000,512,494,517,250,507,757
1000,495,477,511,232,518,750
1000,485,494,532,225,526,751
1000,495,512,504,266,490,756
1000,497,516,522,266,500,766
1000,477,503,503,246,508,754
1000,529,514,506,268,490,758
1000,514,492,486,249,491,740
1000,489,474,516,233,523,756
1000,463,486,492,223,503,726
1000,488,485,524,235,520,755
1000,496,490,508,236,512,748
1000,526,498,483,268,483,751
1000,514,496,488,253,490,743
1000,494,503,505,246,492,738
1000,475,490,497,246,482,728
1000,509,524,498,261,478,739
1000,542,497,474,287,472,759
1000,512,526,513,278,493,771
1000,480,515,508,248,502,750
1000,498,506,516,250,509,759
1000,501,510,516,259,499,758
1000,514,511,492,265,491,756
1000,497,516,497,270,478,748
1000,496,505,495,245,481,726
1000,530,511,467,268,491,759
1000,541,536,524,292,495,787
1000,515,513,519,266,498,764
1000,509,507,500,257,494,751
1000,494,518,503,259,493,752
1000,505,498,486,255,490,745
1000,473,517,506,227,504,731
1000,539,512,467,273,486,759
1000,529,524,496,277,488,765
1000,499,502,504,242,520,762
1000,506,517,505,269,493,762
1000,469,482,492,232,504,736
1000,485,502,493,245,494,739
1000,488,494,503,245,498,743
1000,484,484,499,249,493,742
1000,477,477,465,234,485,719
1000,492,499,476,242,485,727
1000,501,516,498,253,500,753
1000,503,482,504,229,528,757
1000,505,496,519,238,530,768
1000,485,484,521,226,522,748
1000,516,539,503,278,481,759
1000,520,501,482,278,472,750
1000,489,499,525,249,508,757
1000,516,503,497,258,513,771
1000,503,515,499,255,505,760
1000,504,498,508,246,511,757
1000,467,491,530,227,516,743
1000,507,486,516,247,524,771
1000,498,509,500,254,499,753
1000,506,507,513,254,513,767
1000,518,478,498,236,523,759
1000,508,491,496,244,512,756
1000,495,486,525,236,532,768
1000,516,500,506,260,501,761
1000,494,465,508,245,509,754
1000,491,511,482,250,489,739
1000,476,542,504,262,484,746
1000,521,487,487,259,494,753
1000,535,487,519,254,532,786
1000,494,495,511,242,500,742
1000,481,455,490,233,507,740
1000,507,509,495,254,501,755
1000,472,514,483,241,482,723
1000,530,487,494,261,502,763
1000,500,500,501,247,488,735
1000,510,506,492,265,496,761
1000,482,519,486,246,489,735
1000,512,474,505,266,503,769
1000,474,510,489,244,497,741
1000,515,473,498,249,512,761
1000,510,523,492,269,486,755
1000,495,485,497,231,515,746
1000,492,507,501,254,490,744
1000,517,519,484,272,470,742
1000,527,513,512,277,490,767
1000,487,536,505,272,473,745
1000,519,479,495,259,510,769
1000,497,498,486,254,486,740
1000,510,496,483,246,503,749
1000,498,508,501,248,486,734
1000,496,479,494,233,520,753
1000,509,533,478,263,492,755
1000,511,497,513,254,516,770
1000,494,470,524,237,516,753
1000,514,489,532,249,525,774
1000,475,473,494,228,514,742
1000,517,508,469,275,463,738
1000,496,489,510,242,525,767
1000,500,494,502,261,483,744
1000,530,520,515,266,513,779
1000,490,506,520,249,495,744
1000,476,477,525,224,550,774
1000,489,493,500,255,495,750
1000,520,481,515,257,513,770
1000,483,480,505,228,519,747
1000,508,506,534,259,513,772
1000,508,515,486,262,473,735
1000,506,529,509,276,477,753
1000,491,500,527,244,515,759
1000,543,505,492,283,487,770
1000,511,526,512,261,511,772
1000,495,499,488,254,497,751
1000,496,528,498,273,474,747
1000,483,477,521,236,516,752
1000,453,477,493,209,499,708
1000,512,511,464,253,486,739
1000,480,499,478,232,500,732
1000,545,532,488,283,470,753
1000,496,495,513,254,508,762
1000,502,526,503,267,489,756
1000,514,513,490,277,483,760
1000,501,497,502,249,494,743
1000,494,463,488,221,526,747
1000,482,510,471,243,490,733
1000,493,530,497,257,491,748
1000,495,478,501,252,505,757
1000,505,513,504,267,483,750
1000,510,484,499,261,483,744
1000,498,489,510,242,508,750
1000,494,504,481,257,490,747
1000,517,492,520,253,498,751
1000,482,478,436,233,486,719
1000,502,501,512,243,508,751
1000,511,494,516,247,511,758
1000,506,502,493,261,481,742
1000,501,529,501,269,497,766
1000,492,516,476,249,480,729
1000,510,513,503,260,502,762
1000,487,497,500,244,516,760
1000,494,480,515,255,492,747
1000,521,480,501,260,517,777
1000,507,505,473,263,466,729
1000,506,494,490,247,490,737
1000,485,490,501,233,496,729
1000,502,517,503,252,510,762
1000,506,514,503,260,496,756
1000,486,487,479,247,478,725
1000,487,482,516,232,517,749
1000,471,491,503,227,508,735
1000,515,493,493,254,504,758
1000,488,517,508,243,521,764
1000,508,519,512,260,512,772
1000,512,491,476,241,502,743
1000,513,504,497,267,490,757
1000,491,484,508,232,516,748
1000,505,475,486,241,515,756
1000,525,511,497,261,493,754
1000,500,518,506,254,507,761
1000,506,509,507,253,502,755
1000,531,519,510,274,490,764
1000,473,499,505,232,523,755
1000,521,498,473,270,481,751
1000,485,477,510,234,512,746
1000,499,516,464,276,452,728
1000,514,518,492,267,486,753
1000,475,522,493,248,490,738
1000,487,499,493,250,504,754
1000,493,506,482,250,482,732
1000,505,510,515,267,497,764
1000,530,547,525,293,475,768
1000,479,513,512,246,494,740
1000,533,500,507,273,495,768
1000,518,503,491,256,507,763
1000,520,479,523,252,525,777
1000,516,511,491,259,489,748
1000,505,502,507,243,516,759
1000,528,492,490,241,527,768
1000,509,475,497,235,520,755
1000,513,482,494,248,504,752
1000,516,515,488,258,491,749
1000,493,509,519,256,493,749
1000,502,515,454,253,466,719
1000,483,487,506,231,515,746
1000,474,498,476,236,481,717
1000,482,474,492,238,494,732
1000,523,491,498,253,511,764
1000,522,517,510,268,479,747
1000,499,502,517,254,526,780
1000,507,521,519,266,504,770
1000,505,502,493,256,494,750
1000,467,486,515,224,511,735
1000,513,495,487,241,515,756
1000,498,487,505,241,512,753
1000,500,495,515,238,510,748
1000,483,492,498,252,484,736
1000,494,513,507,267,494,761
1000,497,490,480,239,499,738
1000,501,541,480,283,454,737
1000,502,484,483,238,507,745
1000,519,480,523,241,526,767
1000,495,484,503,238,517,755
1000,477,485,507,224,531,755
1000,494,511,481,259,481,740
1000,529,483,497,255,507,762
1000,478,500,479,243,496,739
1000,489,507,517,239,503,742
1000,521,499,484,264,492,756
1000,496,512,490,263,474,737
1000,518,482,515,241,544,785
1000,480,510,521,236,500,736
1000,492,478,479,224,502,726
1000,508,503,504,261,504,765
1000,509,488,493,245,519,764
1000,476,495,518,243,492,735
1000,505,489,477,245,492,737
1000,534,493,524,260,521,781
1000,509,483,518,235,545,780
1000,501,497,494,262,481,743
1000,495,509,471,246,488,734
1000,481,508,497,238,508,746
1000,495,513,509,256,497,753
1000,487,496,496,240,491,731
1000,462,506,510,226,507,733
1000,491,499,492,251,493,744
1000,482,508,483,237,490,727
1000,487,480,495,230,524,754
1000,502,530,489,266,471,737
1000,512,489,494,243,510,753
1000,489,524,492,254,484,738
1000,506,501,493,257,488,745
1000,495,503,513,262,486,748
1000,526,512,504,276,489,765
1000,475,491,499,238,517,755
1000,478,483,487,216,510,726
1000,510,481,513,251,507,758
1000,494,512,498,256,485,741
1000,529,515,513,266,503,769
1000,480,500,509,240,513,753
1000,493,497,500,247,500,747
1000,488,516,493,249,501,750
1000,480,515,498,247,499,746
1000,493,507,496,243,505,748
1000,532,513,510,270,494,764
1000,504,503,517,252,512,764
1000,483,494,487,255,480,735
1000,479,503,504,244,490,734
1000,491,501,502,249,492,741
1000,501,481,506,244,524,768
1000,484,479,461,229,489,718
1000,503,500,517,249,496,745
1000,496,511,482,236,502,738
1000,503,503,484,248,508,756
1000,490,497,477,237,495,732
1000,536,486,482,246,514,760
1000,500,496,495,252,501,753
1000,493,498,505,238,516,754
1000,503,487,493,246,509,755
1000,493,497,502,243,521,764
1000,493,479,482,238,501,739
1000,486,506,464,245,479,724
1000,512,514,485,277,458,735
1000,501,510,493,250,497,747
1000,518,510,484,257,483,740
1000,487,503,522,237,505,742
1000,483,479,498,218,523,741
1000,506,485,487,243,502,745
1000,508,526,494,261,490,751
1000,488,519,510,239,504,743
1000,504,527,505,269,478,747
1000,514,494,539,255,533,788
1000,489,483,473,239,504,743
1000,497,500,461,244,467,711
1000,490,495,491,231,499,730
1000,462,499,512,234,503,737
1000,471,508,529,259,486,745
1000,498,513,506,260,482,742
1000,480,504,487,234,508,742
1000,509,491,468,261,483,744
1000,501,495,545,261,514,775
1000,472,486,503,239,516,755
1000,509,521,496,260,491,751
1000,508,500,501,246,500,746
1000,519,505,487,253,496,749
1000,468,497,517,231,509,740
1000,477,523,517,253,495,748
1000,504,528,502,264,494,758
1000,487,498,493,257,482,739
1000,512,490,487,257,491,748
1000,489,482,496,240,504,744
1000,498,493,487,244,511,755
1000,497,495,499,244,503,747
1000,479,544,523,256,511,767
1000,515,495,526,258,514,772
1000,468,531,503,256,468,724
1000,496,521,481,256,472,728
1000,519,501,477,273,494,767
1000,485,507,507,246,496,742
1000,473,504,526,234,509,743
1000,515,506,486,268,478,746
1000,491,500,509,239,497,736
1000,528,482,510,270,506,776
1000,507,512,500,261,489,750
1000,498,471,460,229,508,737
1000,489,477,472,238,504,742
1000,522,481,506,252,502,754
1000,497,495,493,244,495,739
1000,511,496,522,245,525,770
1000,530,505,510,261,497,758
1000,512,489,487,260,490,750
1000,530,482,514,247,515,762
1000,488,496,525,249,513,762
1000,516,500,483,268,484,752
1000,502,506,521,256,513,769
1000,524,492,509,260,512,772
1000,478,490,502,238,516,754
1000,525,513,496,275,470,745
1000,471,491,519,223,529,752
1000,518,487,490,262,499,761
1000,490,511,511,262,492,754
1000,510,501,490,255,493,748
1000,516,510,497,260,491,751
1000,492,513,514,235,502,737
1000,513,514,508,267,493,760
1000,508,509,521,268,496,764
1000,512,516,495,261,496,757
1000,512,483,503,262,503,765
1000,499,508,493,272,466,738
1000,488,495,518,235,522,757
1000,510,499,487,253,498,751
1000,510,481,502,244,506,750
1000,489,492,473,226,510,736
1000,512,532,492,274,476,750
1000,518,522,506,264,498,762
1000,512,493,497,267,480,747
1000,488,507,493,257,475,732
1000,497,489,477,238,508,746
1000,473,520,522,237,511,748
1000,531,528,474,280,471,751
1000,480,498,502,235,509,744
1000,494,511,503,240,500,740
1000,488,504,495,261,488,749
1000,511,485,487,253,499,752
1000,474,485,470,236,473,709
1000,521,513,499,254,497,751
1000,509,518,501,274,481,755
1000,527,494,482,257,504,761
1000,520,489,508,266,490,756
1000,518,482,501,258,512,770
1000,525,483,514,248,529,777
1000,507,499,504,258,496,754
1000,521,499,487,253,503,756
1000,514,518,511,280,488,768
1000,488,516,465,250,470,720
1000,522,475,495,258,509,767
1000,506,494,495,246,509,755
1000,515,494,519,265,495,760
1000,496,516,503,248,510,758
1000,507,476,491,253,482,735
1000,499,511,481,255,460,715
1000,492,476,496,229,520,749
1000,499,475,496,227,525,752
1000,490,498,484,250,487,737
1000,492,479,500,237,515,752
1000,529,525,482,274,477,751
1000,484,481,507,230,516,746
1000,498,533,485,271,468,739
1000,521,469,502,240,537,777
1000,506,515,478,275,465,740
1000,517,527,494,268,474,742
1000,473,491,488,220,511,731
1000,485,508,450,266,449,715
1000,523,510,515,264,495,759
1000,523,470,494,245,509,754
1000,487,500,496,228,499,727
1000,473,508,527,233,512,745
1000,526,492,519,262,517,779
1000,498,500,528,252,507,759
1000,509,503,503,260,486,746
1000,517,495,501,263,489,752
1000,471,501,481,241,490,731
1000,512,501,499,249,515,764
1000,492,491,498,225,525,750
1000,521,510,508,271,478,749
1000,487,494,512,246,508,754
1000,504,495,490,239,507,746
1000,489,499,478,246,491,737
1000,525,495,476,252,490,742
1000,480,529,501,251,489,740
1000,518,498,534,256,518,774
1000,515,498,503,253,508,761
1000,490,495,507,234,527,761
1000,520,488,499,250,498,748
1000,484,511,512,250,487,737
1000,497,498,493,251,474,725
1000,515,509,499,260,496,756
1000,482,509,520,234,525,759
1000,483,518,520,261,506,767
1000,511,504,475,252,501,753
1000,512,521,499,255,502,757
1000,499,513,500,261,489,750
1000,482,527,516,244,504,748
1000,515,494,480,264,483,747
1000,503,510,490,253,498,751
1000,508,507,494,266,473,739
1000,499,495,473,232,508,740
1000,490,483,497,235,503,738
1000,501,495,530,248,519,767
1000,502,492,486,261,476,737
1000,532,489,479,269,494,763
1000,490,484,491,242,493,735
1000,527,504,498,256,506,762
1000,494,496,502,242,512,754
1000,497,505,500,255,504,759
1000,515,510,479,252,480,732
1000,499,496,523,235,541,776
1000,495,501,492,252,501,753
1000,475,504,523,245,504,749
1000,468,509,479,241,490,731
1000,519,493,505,257,507,764
1000,513,489,527,239,520,759
1000,470,511,524,233,522,755
1000,508,508,484,262,486,748
1000,504,504,481,243,505,748
1000,520,484,515,252,505,757
1000,495,521,513,268,476,744
1000,507,475,501,242,508,750
1000,483,482,497,225,514,739
1000,482,513,517,257,488,745
1000,528,513,502,274,492,766
1000,487,479,484,217,532,749
1000,501,483,503,245,496,741
1000,530,494,509,264,503,767
1000,507,506,520,263,499,762
1000,519,488,494,267,491,758
1000,514,493,473,261,480,741
1000,501,502,516,233,512,745
1000,464,486,499,240,488,728
1000,496,488,462,243,484,727
1000,489,523,517,259,495,754
1000,496,501,509,257,497,754
1000,514,496,499,248,514,762
1000,488,504,522,240,507,747
1000,507,489,493,249,502,751
1000,475,502,513,236,517,753
1000,490,496,511,239,523,762
1000,538,505,497,273,489,762
1000,508,485,507,241,524,765
1000,509,516,507,259,500,759
1000,478,497,506,245,510,755
1000,500,509,493,262,492,754
1000,511,459,492,240,516,756
1000,476,508,496,239,511,750
1000,493,507,496,242,510,752
1000,477,513,485,245,486,731
1000,491,505,504,252,497,749
1000,473,491,520,235,523,758
1000,504,486,500,243,523,766
1000,536,514,511,289,476,765
1000,479,496,501,245,486,731
1000,500,531,481,270,458,728
1000,492,502,496,244,514,758
1000,476,489,499,240,493,733
1000,511,476,466,231,521,752
1000,506,483,484,250,490,740
1000,517,487,505,253,513,766
1000,500,521,473,258,486,744
1000,495,497,492,244,509,753
1000,496,524,504,264,483,747
1000,482,486,517,231,525,756
1000,522,500,478,258,490,748
1000,487,501,475,245,498,743
1000,491,496,500,244,513,757
1000,514,507,473,260,475,735
1000,504,538,504,272,495,767
1000,492,516,480,255,469,724
1000,499,526,499,256,495,751
1000,493,481,540,227,554,781
1000,522,498,502,267,490,757
1000,516,517,493,262,483,745
1000,510,499,489,256,494,750
1000,513,474,498,246,502,748
1000,498,475,497,230,525,755
1000,520,488,492,244,518,762
1000,497,482,489,243,497,740
1000,499,488,529,250,531,781
1000,490,495,506,233,518,751
1000,502,485,520,247,501,748
1000,497,523,478,253,486,739
1000,505,516,515,246,507,753
1000,515,484,490,246,515,761
1000,496,472,521,227,530,757
1000,492,522,469,250,488,738
1000,477,501,493,239,499,738
1000,484,506,467,253,471,724
1000,509,514,478,270,470,740
1000,509,484,484,258,486,744
1000,488,488,484,238,492,730
1000,512,488,509,251,498,749
1000,487,502,495,248,498,746
1000,463,509,501,240,498,738
1000,488,501,480,238,498,736
1000,514,509,500,255,504,759
1000,509,498,476,247,489,736
1000,492,506,506,253,490,743
1000,495,505,499,250,509,759
1000,519,493,459,243,496,739
1000,479,488,498,240,491,731
1000,517,480,501,248,519,767
1000,493,500,515,247,509,756
1000,517,508,482,270,471,741
1000,488,491,494,231,513,744
1000,513,489,521,244,529,773
1000,503,489,508,239,511,750
1000,475,485,528,226,533,759
1000,492,479,484,227,495,722
1000,527,542,474,294,453,747
1000,511,515,495,252,498,750
1000,539,512,514,276,521,797
1000,521,495,504,255,512,767
1000,485,521,536,247,517,764
1000,526,507,494,274,497,771
1000,494,492,501,242,510,752
1000,485,492,517,236,525,761
1000,512,517,491,280,478,758
1000,513,494,506,249,516,765
1000,512,486,496,260,483,743
1000,504,492,478,254,475,729
1000,501,496,499,238,512,750
1000,498,487,496,237,493,730
1000,481,516,489,265,470,735
1000,510,502,505,257,497,754
1000,491,513,471,232,512,744
1000,502,505,519,256,507,763
1000,529,497,523,263,512,775
1000,485,521,523,259,485,744
1000,495,497,517,235,529,764
1000,510,500,497,257,486,743
1000,489,526,487,252,478,730
1000,477,499,496,232,505,737
1000,508,479,488,243,522,765
1000,518,519,456,256,494,750
1000,463,503,505,218,512,730
1000,487,484,523,243,510,753
1000,501,481,494,246,490,736
1000,512,502,479,247,495,742
1000,506,504,518,259,503,762
1000,533,498,493,270,510,780
1000,502,492,504,241,511,752
1000,503,488,509,249,508,757
1000,513,512,506,250,509,759
1000,485,489,484,238,494,732
1000,490,496,521,237,513,750
1000,487,500,476,243,493,736
1000,497,470,482,229,515,744
1000,510,507,503,267,486,753
1000,490,502,506,254,500,754
1000,498,496,524,244,520,764
1000,493,516,497,256,484,740
1000,517,499,495,258,494,752
1000,511,487,519,250,504,754
1000,497,504,492,260,480,740
1000,468,499,484,236,481,717
1000,491,489,492,237,491,728
1000,485,514,505,262,480,742
1000,502,501,481,246,495,741
1000,503,487,505,250,493,743
1000,543,512,490,275,481,756
1000,491,527,505,256,488,744
1000,505,504,476,257,480,737
1000,510,497,525,255,528,783
1000,458,493,493,228,487,715
1000,524,516,497,281,478,759
1000,517,502,492,252,510,762
1000,523,516,488,262,506,768
1000,486,503,471,253,472,725
1000,477,502,513,226,510,736
1000,515,487,511,248,515,763
1000,501,495,512,257,496,753
1000,519,524,491,264,496,760
1000,506,525,519,281,476,757
1000,496,480,501,233,523,756
1000,487,495,494,228,505,733
1000,472,505,521,251,504,755
1000,504,510,502,262,488,750
1000,528,486,507,257,507,764
1000,524,516,514,279,488,767
1000,499,507,498,248,505,753
1000,508,515,519,267,477,744
1000,477,484,481,228,506,734
1000,478,515,479,249,474,723
1000,517,512,497,255,492,747
1000,498,515,519,267,491,758
1000,481,501,523,253,508,761
1000,504,512,518,258,506,764
1000,495,471,499,234,523,757
1000,525,503,512,262,507,769
1000,494,505,501,252,501,753
1000,511,514,510,245,512,757
1000,489,513,514,243,514,757
1000,513,476,507,247,516,763
1000,516,520,500,280,472,752
1000,477,502,525,232,531,763
1000,472,494,495,238,490,728
1000,492,477,508,239,512,751
1000,494,492,525,250,507,757
1000,533,480,494,249,533,782
1000,509,490,515,253,512,765
1000,519,522,486,265,486,751
1000,505,498,507,252,509,761
1000,504,518,477,269,472,741
1000,509,503,512,247,512,759
1000,517,497,517,256,500,756
1000,517,504,488,265,482,747
1000,503,488,531,245,520,765
1000,500,488,493,250,503,753
1000,513,490,494,250,515,765
1000,508,508,514,260,500,760
1000,503,496,490,236,516,752
1000,509,491,475,254,503,757
1000,518,502,514,253,512,765
1000,505,505,490,251,496,747
1000,527,525,468,274,466,740
1000,499,490,519,243,508,751
1000,480,504,522,249,492,741
1000,485,504,494,235,511,746
1000,472,521,497,245,483,728
1000,475,494,495,221,521,742
1000,491,483,529,236,534,770
1000,495,488,490,248,504,752
1000,485,464,521,228,519,747
1000,476,497,506,227,528,755
1000,482,523,516,234,526,760
1000,499,506,525,250,506,756
1000,497,488,511,243,507,750
1000,512,504,500,264,493,757
1000,515,510,496,254,502,756
1000,516,509,495,272,486,758
1000,513,486,515,254,519,773
1000,499,508,488,257,485,742
1000,502,505,483,263,489,752
1000,541,517,482,261,503,764
1000,483,485,528,243,512,755
1000,504,499,496,245,518,763
1000,481,489,487,244,501,745
1000,520,524,493,253,495,748
1000,478,494,500,236,502,738
1000,461,504,521,236,515,751
1000,504,504,516,263,501,764
1000,490,502,492,240,497,737
1000,505,483,502,242,514,756
1000,504,500,478,241,489,730
1000,502,512,497,259,479,738
1000,472,532,505,244,504,748
1000,520,494,499,260,497,757
1000,492,512,498,257,507,764
1000,501,494,506,254,496,750
1000,542,518,521,271,498,769
1000,480,523,499,252,483,735
1000,511,494,531,256,515,771
1000,501,489,507,229,534,763
1000,521,485,512,247,521,768
1000,499,506,488,245,490,735
1000,484,505,506,250,493,743
1000,504,486,497,239,528,767
1000,498,483,500,255,507,762
1000,511,514,486,261,497,758
1000,468,503,489,234,501,735
1000,462,526,493,256,472,728
1000,509,529,507,283,489,772
1000,479,483,510,239,495,734
1000,487,507,491,241,514,755
1000,519,502,498,272,492,764
1000,508,524,504,282,471,753
1000,503,490,484,241,509,750
1000,479,533,502,265,476,741
1000,507,501,477,259,483,742
1000,476,487,497,235,507,742
1000,486,522,491,257,464,721
1000,484,493,480,240,480,720
1000,534,485,507,245,526,771
1000,496,484,515,245,505,750
1000,485,511,479,262,470,732
1000,518,497,500,261,491,752
1000,489,497,487,257,470,727
1000,488,516,508,249,505,754
1000,498,463,512,240,512,752
1000,500,494,508,265,476,741
1000,502,492,497,243,495,738
1000,524,496,497,280,488,768
1000,520,501,510,271,486,757
1000,520,523,492,274,489,763
1000,492,509,493,241,504,745
1000,493,493,512,248,513,761
1000,527,494,537,251,525,776
1000,454,534,491,241,483,724
1000,490,508,462,251,481,732
1000,495,493,521,244,514,758
1000,514,530,501,270,487,757
1000,500,496,490,255,487,742
1000,520,508,526,255,515,770
1000,510,502,497,244,506,750
1000,501,511,501,257,489,746
1000,523,504,488,263,491,754
1000,526,487,484,255,489,744
1000,510,508,522,255,517,772
1000,487,532,505,265,471,736
1000,491,496,521,233,525,758
1000,520,503,495,258,504,762
1000,492,487,501,231,523,754
1000,499,498,466,242,493,735
1000,495,506,485,250,492,742
1000,484,518,500,247,491,738
1000,522,501,498,274,489,763
1000,468,516,515,236,507,743
1000,503,473,493,240,504,744
1000,465,520,537,232,519,751
1000,519,486,512,247,531,778
1000,487,492,478,232,502,734
1000,491,481,509,232,528,760
1000,517,504,518,260,495,755
1000,496,541,505,290,460,750
1000,503,491,511,252,488,740
1000,500,506,485,246,496,742
1000,490,489,497,239,504,743
1000,499,518,492,258,490,748
1000,515,460,488,240,518,758
1000,485,518,491,256,487,743
1000,507,498,505,239,514,753
1000,496,492,480,240,493,733
1000,487,493,502,238,502,740
1000,507,518,482,246,497,743
1000,492,460,500,232,519,751
1000,512,489,511,250,513,763
1000,510,515,507,264,495,759
1000,510,530,485,270,474,744
1000,483,508,480,254,478,732
1000,502,484,482,244,495,739
1000,502,481,502,242,506,748
1000,488,524,512,249,509,758
1000,517,493,504,252,506,758
1000,495,484,475,242,492,734
1000,476,508,491,243,481,724
1000,488,507,502,238,516,754
1000,498,489,480,237,500,737
1000,506,515,518,264,510,774
1000,518,467,495,240,497,737
1000,502,519,493,260,488,748
1000,507,497,497,260,485,745
1000,509,503,502,259,489,748
1000,500,501,521,243,522,765
1000,535,524,508,276,482,758
1000,519,489,478,253,499,752
1000,520,505,495,274,485,759
1000,513,498,497,273,468,741
1000,501,517,518,267,486,753
1000,518,493,479,249,505,754
1000,482,495,509,213,542,755
1000,496,496,486,247,488,735
1000,509,503,508,245,502,747
1000,498,483,471,248,488,736
1000,506,491,498,246,515,761
1000,495,495,502,257,485,742
1000,482,483,476,259,459,718
1000,492,500,470,236,500,736
1000,508,518,502,260,498,758
1000,506,487,496,242,501,743
1000,514,495,478,250,501,751
1000,505,493,495,237,511,748
1000,494,496,523,239,508,747
1000,489,492,475,248,486,734
1000,524,513,514,290,479,769
1000,470,498,501,216,532,748
1000,499,491,498,249,504,753
1000,495,521,492,267,474,741
1000,499,462,485,227,510,737
1000,483,506,486,240,513,753
1000,529,509,506,267,501,768
1000,531,498,493,251,501,752
1000,502,500,520,251,501,752
1000,518,481,519,249,529,778
1000,490,491,504,254,493,747
1000,509,518,504,266,487,753
1000,478,500,507,235,516,751
1000,531,509,503,277,504,781
1000,517,470,514,247,521,768
1000,503,530,519,252,514,766
1000,488,521,525,258,484,742
1000,493,484,520,244,487,731
1000,507,516,520,266,505,771
1000,473,515,489,253,474,727
1000,499,492,502,251,512,763
1000,486,477,526,211,541,752
1000,486,506,506,253,494,747
1000,514,481,474,241,501,742
1000,499,479,513,254,509,763
1000,505,515,516,254,513,767
1000,516,508,518,246,529,775
1000,520,526,488,274,482,756
1000,511,507,514,263,494,757
1000,481,492,503,226,511,737
1000,489,489,482,240,518,758
1000,510,526,515,273,493,766
1000,497,493,508,240,507,747
1000,472,510,502,236,497,733
1000,515,510,500,245,507,752
1000,486,513,508,239,505,744
1000,477,532,474,252,471,723
1000,479,509,493,265,477,742
1000,517,504,495,252,484,736
1000,492,506,515,254,511,765
1000,505,496,494,268,476,744
1000,523,480,508,248,516,764
1000,530,524,522,286,491,777
1000,499,507,486,246,500,746
1000,514,503,522,247,520,767
1000,504,491,472,252,484,736
1000,483,490,505,241,495,736
1000,498,481,486,231,506,737
1000,505,487,501,265,500,765
1000,498,501,480,246,490,736
1000,497,484,481,244,485,729
1000,480,525,502,249,505,754
1000,496,478,467,233,492,725
1000,513,494,495,241,493,734
1000,493,479,507,249,490,739
1000,532,502,493,265,490,755
1000,511,533,516,284,483,767
1000,539,471,530,255,526,781
1000,532,508,493,272,504,776
1000,503,483,532,240,528,768
1000,525,495,499,268,504,772
1000,495,511,489,250,496,746
1000,493,516,499,252,474,726
1000,480,486,471,232,485,717
1000,493,521,494,249,495,744
1000,491,483,518,235,519,754
1000,516,508,481,262,486,748
1000,511,512,498,254,507,761
1000,498,469,494,226,508,734
1000,500,495,492,248,495,743
1000,498,507,501,245,516,761
1000,532,490,491,267,495,762
1000,509,484,511,238,520,758
1000,472,511,506,244,501,745
1000,478,510,506,247,501,748
1000,491,511,508,256,513,769
1000,478,508,492,237,502,739
1000,481,509,495,244,480,724
1000,513,488,496,264,500,764
1000,518,495,533,266,514,780
1000,510,482,524,250,526,776
1000,525,485,536,258,527,785
1000,498,494,498,235,519,754
1000,512,474,498,242,510,752
1000,479,493,505,235,503,738
1000,486,505,480,243,492,735
1000,519,491,508,256,508,764
1000,518,469,498,246,516,762
1000,505,489,504,245,506,751
1000,510,497,510,264,492,756
1000,527,529,496,286,479,765
1000,482,507,503,232,517,749
1000,487,480,470,224,514,738
1000,518,507,495,262,497,759
1000,482,497,492,241,499,740
1000,489,508,501,248,495,743
1000,509,497,507,255,509,764
1000,487,489,477,230,499,729
1000,472,498,500,235,497,732
1000,520,497,493,263,499,762
1000,498,492,497,250,490,740
1000,502,494,477,242,496,738
1000,479,477,521,244,519,763
1000,492,515,488,250,510,760
1000,498,513,508,252,504,756
1000,508,517,503,262,500,762
1000,513,496,490,255,503,758
1000,489,520,504,263,488,751
1000,506,508,494,252,493,745
1000,508,492,492,251,518,769
1000,487,519,509,257,496,753
1000,511,498,484,250,509,759
1000,515,520,505,260,489,749
1000,512,498,495,245,511,756
1000,501,497,510,238,521,759
1000,483,506,513,255,505,760
1000,510,475,495,240,511,751
1000,504,486,500,256,504,760
1000,503,489,508,245,508,753
1000,521,518,488,281,488,769
1000,483,511,493,250,496,746
1000,514,505,507,270,483,753
1000,509,537,504,271,488,759
1000,493,535,509,266,505,771
1000,498,500,488,248,485,733
1000,486,508,501,259,477,736
1000,522,504,488,266,483,749
1000,526,497,490,262,487,749
1000,512,489,489,248,496,744
1000,511,498,527,257,513,770
1000,497,469,525,245,520,765
1000,498,484,519,243,520,763
1000,491,509,471,248,482,730
1000,525,494,507,252,526,778
1000,489,490,505,241,511,752
1000,482,493,497,228,515,743
1000,504,487,513,257,497,754
1000,492,502,494,247,492,739
1000,522,516,480,264,485,749
1000,484,478,492,230,496,726
1000,489,523,490,248,486,734
1000,519,513,491,268,478,746
1000,521,497,530,256,514,770
1000,492,490,504,236,519,755
1000,513,490,481,258,487,745
1000,500,508,500,251,503,754
1000,518,543,500,285,490,775
1000,499,494,527,251,499,750
1000,495,482,496,249,504,753
1000,498,522,514,260,497,757
1000,496,483,514,240,521,761
1000,492,473,489,236,518,754
1000,503,496,485,243,503,746
1000,473,514,472,236,484,720
1000,522,521,513,267,510,777
1000,481,525,523,262,489,751
1000,502,518,475,260,467,727
1000,512,481,493,249,500,749
1000,493,499,533,252,526,778
1000,507,492,498,243,512,755
1000,525,493,513,252,518,770
1000,512,513,501,269,486,755
1000,492,515,488,256,473,729
1000,501,470,531,241,525,766
1000,490,488,490,244,488,732
1000,469,514,503,208,525,733
1000,500,497,521,245,510,755
1000,504,508,494,259,488,747
1000,527,508,502,264,500,764
1000,503,508,473,259,482,741
1000,526,522,503,261,494,755
1000,528,486,518,251,513,764
1000,483,507,493,254,477,731
1000,489,507,513,248,498,746
1000,504,502,498,257,497,754
1000,508,518,497,266,489,755
1000,503,491,488,245,512,757
1000,500,497,525,245,519,764
1000,505,489,488,253,484,737
1000,478,498,502,242,508,750
1000,500,480,486,254,491,745
1000,502,477,461,229,514,743
1000,474,481,493,227,511,738
1000,490,499,482,238,495,733
1000,509,473,531,246,529,775
1000,510,504,482,267,481,748
1000,499,504,497,244,506,750
1000,508,532,514,262,489,751
1000,472,489,516,240,511,751
1000,510,504,491,254,501,755
1000,485,477,494,229,513,742
1000,506,510,506,259,479,738
1000,493,478,476,225,506,731
1000,510,514,492,266,493,759
1000,520,516,492,278,490,768
1000,490,517,503,251,502,753
1000,469,498,500,239,487,726
1000,457,525,489,244,483,727
1000,508,509,504,255,505,760
1000,484,513,504,247,494,741
1000,484,511,512,248,505,753
1000,492,536,492,264,472,736
1000,505,503,514,252,499,751
1000,519,491,481,269,468,737
1000,474,492,498,245,503,748
1000,488,492,517,230,518,748
1000,503,498,486,271,481,752
1000,507,501,527,259,514,773
1000,499,501,494,236,502,738
1000,492,473,501,230,508,738
1000,494,504,477,255,472,727
1000,500,507,494,257,495,752
1000,513,508,527,268,487,755
1000,497,490,504,226,521,747
1000,510,466,493,248,507,755
1000,504,516,501,251,506,757
1000,473,505,524,236,518,754
1000,501,494,491,245,508,753
1000,514,488,493,251,497,748
1000,468,500,515,227,526,753
1000,505,508,503,267,497,764
1000,501,476,469,226,501,727
1000,519,495,491,255,498,753
1000,505,495,511,247,506,753
1000,492,505,494,254,482,736
1000,532,502,496,268,497,765
1000,514,500,490,254,503,757
1000,520,504,497,259,495,754
1000,462,504,529,240,510,750
1000,518,506,511,271,509,780
1000,497,496,466,262,463,725
1000,484,517,484,242,492,734
1000,503,509,488,258,472,730
1000,487,498,535,241,521,762
1000,486,489,489,245,494,739
1000,504,502,497,254,498,752
1000,494,515,501,252,505,757
1000,504,503,514,266,494,760
1000,530,481,506,258,521,779
1000,501,522,487,258,489,747
1000,492,512,495,244,495,739
1000,501,513,489,252,487,739
1000,508,522,498,252,505,757
1000,490,513,483,258,475,733
1000,506,517,480,262,491,753
1000,497,489,503,246,505,751
1000,498,532,506,266,491,757
1000,504,491,494,238,512,750
1000,501,505,476,253,495,748
1000,491,482,481,240,478,718
1000,537,511,498,269,499,768
1000,492,498,498,244,502,746
1000,505,516,506,260,495,755
1000,517,494,506,254,518,772
1000,492,477,528,220,560,780
1000,502,497,507,258,483,741
1000,498,515,494,276,468,744
1000,476,504,512,240,500,740
1000,475,509,494,243,487,730
1000,507,476,495,248,504,752
1000,501,521,530,258,510,768
1000,504,495,522,252,509,761
1000,505,534,491,277,476,753
1000,501,494,467,243,494,737
1000,511,493,484,240,508,748
1000,514,491,489,240,512,752
1000,509,526,470,268,464,732
1000,531,483,515,248,539,787
1000,504,508,507,265,489,754
1000,508,480,522,226,530,756
1000,461,505,510,238,486,724
1000,513,504,505,264,492,756
1000,485,486,503,229,502,731
1000,502,489,521,245,522,767
1000,504,498,515,260,503,763
1000,523,525,518,266,502,768
1000,490,473,476,236,491,727
1000,485,516,483,246,459,705
1000,491,494,493,252,492,744
1000,509,492,507,249,496,745
1000,498,487,513,241,493,734
1000,509,501,482,247,486,733
1000,522,496,489,261,513,774
1000,540,475,520,258,518,776
1000,492,538,476,252,486,738
1000,486,520,481,258,487,745
1000,502,520,489,262,495,757
1000,507,504,528,255,535,790
1000,477,494,500,226,524,750
1000,508,506,521,263,511,774
1000,488,507,506,259,476,735
1000,530,474,501,238,528,766
1000,465,494,516,222,531,753
1000,516,467,516,246,528,774
1000,487,517,489,264,487,751
1000,489,476,505,236,507,743
1000,502,490,492,245,499,744
1000,507,475,511,246,500,746
1000,487,521,477,245,493,738
1000,507,528,501,271,472,743
1000,478,483,503,221,540,761
1000,487,483,479,237,505,742
1000,477,493,500,234,500,734
1000,505,502,494,255,481,736
1000,515,516,537,272,500,772
1000,506,515,487,258,485,743
1000,467,511,503,238,488,726
1000,479,496,465,236,498,734
1000,507,502,470,261,477,738
1000,496,506,499,242,508,750
1000,492,540,505,258,504,762
1000,475,502,467,231,484,715
1000,500,522,519,256,492,748
1000,509,494,503,246,511,757
1000,491,502,471,245,487,732
1000,512,521,515,261,512,773
1000,508,476,515,240,534,774
1000,513,507,499,259,490,749
1000,497,490,519,236,495,731
1000,505,522,492,268,481,749
1000,498,496,494,255,498,753
1000,500,511,497,256,489,745
1000,511,522,505,281,472,753
1000,486,484,461,239,483,722
1000,518,520,506,264,489,753
1000,500,491,516,252,513,765
1000,484,486,514,238,499,737
1000,491,499,496,240,505,745
1000,534,504,508,296,471,767
1000,504,490,470,248,482,730
1000,531,533,499,282,474,756
1000,502,490,504,254,501,755
1000,502,496,486,244,492,736
1000,507,507,492,255,495,750
1000,464,457,504,215,527,742
1000,490,491,488,248,498,746
1000,503,491,499,229,530,759
1000,494,477,495,232,510,742
1000,505,493,484,246,496,742
1000,511,527,475,290,450,740
1000,520,494,507,257,512,769
1000,506,484,507,257,487,744
1000,496,496,507,240,502,742
1000,479,507,478,245,478,723
1000,498,491,490,238,510,748
1000,488,514,524,239,520,759
1000,520,507,518,272,504,776
1000,487,522,497,262,484,746
1000,490,453,517,209,529,738
1000,491,499,515,248,503,751
1000,506,492,492,267,488,755
1000,485,515,483,266,463,729
1000,499,535,525,276,483,759
1000,515,497,495,251,499,750
1000,480,492,500,235,519,754
1000,503,520,499,265,490,755
1000,517,493,472,250,500,750
1000,517,487,486,244,510,754
1000,507,503,490,253,488,741
1000,506,501,512,245,512,757
1000,513,506,515,255,510,765
1000,519,522,485,271,478,749
1000,485,511,494,263,473,736
1000,529,487,502,257,504,761
1000,496,521,490,251,484,735
1000,510,479,505,266,492,758
1000,489,514,505,254,506,760
1000,482,498,502,236,514,750
1000,513,494,489,250,501,751
1000,498,482,505,241,508,749
1000,516,485,483,267,475,742
1000,489,516,522,254,500,754
1000,491,493,513,246,502,748
1000,462,505,499,248,485,733
1000,483,476,492,226,512,738
1000,491,522,475,267,460,727
1000,500,506,515,258,494,752
1000,502,509,541,257,511,768
1000,490,462,503,223,517,740
1000,489,514,529,241,514,755
1000,511,506,465,265,472,737
1000,496,504,517,257,491,748
1000,497,505,531,249,513,762
1000,470,490,487,239,481,720
1000,492,512,507,253,486,739
1000,469,523,530,242,516,758
1000,508,491,496,253,487,740
1000,484,508,482,248,486,734
1000,501,504,477,259,483,742
1000,514,506,483,253,496,749
1000,508,474,481,234,505,739
1000,516,522,490,260,502,762
1000,517,527,515,274,483,757
1000,487,490,499,243,502,745
1000,460,511,506,233,487,720
1000,516,510,506,254,494,748
1000,499,488,493,246,497,743
1000,503,501,495,265,484,749
1000,478,503,509,243,497,740
1000,487,501,510,241,508,749
1000,490,495,496,229,517,746
1000,513,493,497,247,502,749
1000,472,487,486,233,489,722
1000,493,495,515,235,526,761
1000,520,499,501,257,494,751
1000,513,489,510,231,526,757
1000,493,508,529,252,492,744
1000,489,519,535,260,490,750
1000,540,492,519,279,493,772
1000,498,498,496,247,501,748
1000,509,504,535,256,527,783
1000,513,497,529,266,500,766
1000,477,499,473,240,474,714
1000,536,512,481,271,494,765
1000,478,502,521,238,518,756
1000,518,484,496,242,511,753
1000,516,534,462,261,475,736
1000,495,524,473,274,455,729
1000,501,519,498,267,478,745
1000,464,505,510,225,506,731
1000,485,498,487,249,486,735
1000,540,502,499,272,500,772
1000,491,482,511,254,499,753
1000,502,521,492,267,490,757
1000,481,521,496,250,469,719
1000,501,465,474,235,509,744
1000,496,518,482,271,463,734
1000,485,496,483,239,505,744
1000,524,487,524,267,483,750
1000,497,490,487,247,506,753
1000,490,499,488,239,495,734
1000,509,506,527,248,528,776
1000,513,489,506,245,507,752
1000,509,516,499,256,499,755
1000,511,500,487,249,498,747
1000,504,484,514,235,521,756
1000,505,488,489,249,502,751
1000,529,487,502,269,499,768
1000,504,479,455,240,484,724
1000,511,481,488,233,524,757
1000,524,492,520,260,517,777
1000,514,498,500,247,508,755
1000,522,508,498,256,526,782
1000,501,502,522,250,521,771
1000,508,491,531,252,523,775
1000,521,519,481,272,476,748
1000,493,472,511,235,519,754
1000,530,508,503,277,494,771
1000,506,535,501,260,498,758
1000,505,513,514,269,478,747
1000,513,487,506,242,514,756
1000,502,508,479,256,481,737
1000,507,521,484,254,491,745
1000,488,484,492,231,511,742
1000,498,503,503,253,513,766
1000,527,514,540,264,531,795
1000,498,511,492,253,499,752
1000,504,501,478,236,507,743
1000,484,499,517,238,511,749
1000,483,482,535,227,522,749
1000,512,504,497,248,503,751
1000,476,512,498,234,512,746
1000,493,472,485,232,523,755
1000,498,480,475,240,492,732
1000,503,483,501,235,514,749
1000,513,504,498,265,488,753
1000,516,501,482,266,483,749
1000,500,522,470,259,483,742
1000,499,507,473,244,499,743
1000,490,517,496,254,488,742
1000,497,516,490,254,479,733
1000,512,511,491,259,497,756
1000,506,532,488,273,485,758
1000,519,500,495,262,506,768
1000,498,481,497,240,499,739
1000,490,492,476,239,494,733
1000,486,504,476,243,488,731
1000,499,516,478,254,492,746
1000,491,534,504,261,481,742
1000,499,505,536,240,528,768
1000,517,504,506,280,496,776
1000,493,504,501,242,507,749
1000,515,527,497,277,488,765
1000,487,513,477,254,483,737
1000,507,477,502,247,505,752
1000,511,482,507,261,491,752
1000,533,488,521,260,526,786
1000,497,522,506,255,483,738
1000,498,508,484,259,480,739
1000,518,518,533,268,507,775
1000,511,504,509,260,504,764
1000,502,472,502,240,513,753
1000,505,468,498,241,520,761
1000,484,496,479,239,489,728
1000,485,496,485,260,480,740
1000,502,519,511,258,503,761
1000,502,492,525,236,521,757
1000,505,502,520,249,531,780
1000,494,480,521,232,542,774
1000,486,506,500,235,513,748
1000,512,507,504,262,497,759
1000,481,487,493,236,508,744
1000,513,518,494,269,479,748
1000,488,507,508,244,498,742
1000,493,482,512,242,520,762
1000,522,499,488,251,513,764
1000,510,502,514,243,512,755
1000,480,511,523,240,514,754
1000,503,489,480,235,506,741
1000,465,468,514,223,520,743
1000,502,507,516,251,496,747
1000,508,499,500,256,487,743
1000,507,507,509,270,500,770
1000,497,484,517,244,518,762
1000,505,504,508,253,495,748
1000,486,501,511,248,504,752
1000,508,498,505,253,502,755
1000,488,502,489,238,500,738
1000,507,473,505,241,516,757
1000,502,484,497,251,508,759
1000,528,509,497,260,508,768
1000,489,524,498,250,488,738
1000,493,498,486,244,485,729
1000,493,487,509,233,527,760
1000,483,491,533,224,529,753
1000,484,510,506,250,498,748
1000,483,510,522,238,523,761
1000,512,531,490,266,487,753
1000,490,498,523,237,522,759
1000,456,494,485,233,474,707
1000,515,511,493,249,500,749
1000,503,483,497,231,528,759
1000,499,497,515,259,497,756
1000,501,540,517,261,511,772
1000,483,492,465,236,482,718
1000,507,515,505,260,482,742
1000,504,520,497,263,474,737
1000,512,473,480,243,504,747
1000,512,488,515,246,507,753
1000,491,516,502,246,502,748
1000,510,495,484,263,479,742
1000,501,495,476,248,488,736
1000,492,505,505,248,505,753
1000,504,513,496,263,476,739
1000,504,506,485,252,483,735
1000,497,498,508,235,521,756
1000,477,504,520,245,493,738
1000,506,536,496,262,487,749
1000,520,509,485,275,489,764
1000,487,522,468,267,459,726
1000,489,475,495,233,498,731
1000,516,512,492,258,489,747
1000,493,495,532,238,517,755
1000,480,496,512,232,514,746
1000,521,509,490,256,499,755
1000,482,518,507,243,506,749
1000,494,538,501,274,465,739
1000,528,494,486,267,487,754
1000,503,504,499,248,491,739
1000,512,471,497,234,519,753
1000,529,517,503,304,464,768
1000,486,511,529,255,515,770
1000,492,495,500,241,491,732
1000,502,495,531,246,508,754
1000,505,509,507,257,489,746
1000,495,499,508,237,513,750
1000,489,487,497,248,503,751
1000,493,511,518,238,520,758
1000,512,502,509,255,500,755
1000,497,494,503,244,492,736
1000,507,478,490,255,481,736
1000,509,532,483,254,494,748
1000,521,475,501,241,536,777
1000,486,484,502,231,509,740
1000,531,475,517,246,538,784
1000,484,489,474,231,492,723
1000,510,479,499,257,498,755
1000,492,487,521,247,513,760
1000,506,490,482,264,478,742
1000,512,516,508,266,494,760
1000,491,519,493,261,466,727
1000,514,493,523,268,501,769
1000,484,491,486,242,479,721
1000,507,508,484,255,498,753
1000,497,521,499,239,509,748
1000,486,483,505,233,505,738
1000,533,500,475,270,485,755
1000,496,491,521,235,538,773
1000,486,488,495,221,527,748
1000,494,488,491,240,504,744
1000,488,490,479,231,501,732
1000,513,527,509,283,474,757
1000,510,480,507,243,509,752
1000,500,515,515,261,499,760
1000,494,484,515,238,519,757
1000,485,509,482,240,486,726
1000,513,496,499,265,490,755
1000,524,483,486,252,504,756
1000,507,527,510,269,501,770
1000,522,480,512,237,536,773
1000,524,487,507,254,510,764
1000,492,498,479,255,468,723
1000,503,502,516,252,507,759
1000,532,489,489,263,513,776
1000,514,469,503,253,523,776
1000,496,486,517,247,510,757
1000,502,496,504,249,494,743
1000,523,534,495,282,487,769
1000,483,504,497,238,498,736
1000,483,509,493,248,486,734
1000,479,469,496,223,510,733
1000,488,489,477,240,482,722
1000,492,503,510,245,521,766
1000,504,504,515,254,517,771
1000,471,480,534,217,524,741
1000,482,543,500,273,470,743
1000,498,492,483,239,486,725
1000,528,472,489,258,507,765
1000,491,510,486,253,484,737
1000,550,491,517,268,517,785
1000,485,517,484,256,469,725
1000,520,518,519,267,497,764
1000,518,496,506,265,493,758
1000,491,458,475,219,529,748
1000,463,495,503,219,533,752
1000,516,505,507,262,508,770
1000,500,497,498,244,509,753
1000,494,484,469,246,496,742
1000,497,500,479,245,482,727
1000,505,498,481,249,492,741
1000,504,486,518,251,493,744
1000,542,508,496,267,491,758
1000,508,483,483,243,500,743
1000,497,500,501,242,514,756
1000,504,522,497,240,510,750
1000,481,488,505,229,501,730
1000,527,490,465,261,495,756
1000,499,517,528,261,498,759
1000,504,509,475,254,471,725
1000,492,495,517,249,511,760
1000,487,504,495,240,507,747
1000,513,485,495,251,506,757
1000,506,495,502,244,498,742
1000,486,493,476,243,493,736
1000,483,501,503,244,492,736
1000,475,479,473,211,507,718
1000,492,512,504,262,486,748
1000,509,480,497,250,512,762
1000,512,519,527,258,521,779
1000,501,479,483,233,508,741
1000,513,482,504,258,500,758
1000,511,495,487,256,481,737
1000,494,496,497,227,525,752
1000,493,502,477,247,482,729
1000,517,509,504,275,482,757
1000,495,488,497,238,508,746
1000,523,514,505,258,503,761
1000,523,529,506,272,488,760
1000,513,501,488,261,482,743
1000,480,516,494,248,480,728
1000,513,489,506,261,502,763
1000,499,491,508,241,514,755
1000,508,510,516,259,501,760
1000,513,499,520,257,516,773
1000,488,502,502,254,493,747
1000,511,503,505,254,510,764
1000,539,498,484,266,491,757
1000,544,503,498,289,489,778
1000,505,498,496,235,516,751
1000,488,475,510,234,496,730
1000,515,468,503,230,536,766
1000,518,519,511,259,496,755
1000,513,492,483,257,499,756
1000,504,507,527,255,507,762
1000,500,488,513,238,509,747
1000,498,498,505,255,500,755
1000,483,497,493,238,503,741
1000,519,495,496,259,516,775
1000,497,496,483,254,491,745
1000,487,511,543,249,523,772
1000,531,499,496,255,523,778
1000,544,474,513,258,511,769
1000,476,488,520,219,536,755
1000,500,493,514,255,486,741
1000,462,487,496,227,507,734
1000,481,476,511,238,517,755
1000,510,492,480,249,486,735
1000,489,529,466,256,478,734
1000,506,497,487,251,501,752
1000,516,536,494,274,479,753
1000,468,528,497,249,485,734
1000,480,507,518,239,507,746
1000,492,459,527,217,532,749
1000,501,482,496,239,506,745
1000,512,504,494,251,506,757
1000,495,500,478,246,497,743
1000,493,513,479,254,475,729
1000,501,522,515,257,500,757
1000,501,490,521,256,493,749
1000,505,491,468,247,494,741
1000,495,482,517,246,511,757
1000,520,531,499,272,488,760
1000,473,499,502,227,515,742
1000,489,498,518,248,499,747
1000,494,468,513,230,532,762
1000,510,486,485,246,495,741
1000,493,519,500,254,494,748
1000,497,505,513,244,509,753
1000,522,515,491,252,509,761
1000,496,497,525,243,524,767
1000,503,520,502,265,484,749
1000,528,509,513,258,515,773
1000,508,497,493,254,493,747
1000,501,472,508,227,535,762
1000,501,480,504,239,516,755
1000,492,501,506,249,493,742
1000,482,482,506,241,492,733
1000,493,479,527,230,532,762
1000,474,499,500,233,512,745
1000,510,514,531,273,499,772
1000,492,534,497,272,477,749
1000,516,490,465,252,498,750
1000,495,491,478,244,496,740
1000,518,521,473,281,469,750
1000,521,489,511,255,519,774
1000,497,534,532,259,498,757
1000,493,508,476,255,466,721
1000,491,484,493,226,512,738
1000,495,486,494,231,518,749
1000,501,492,494,243,508,751
1000,480,518,489,265,466,731
1000,483,489,485,232,499,731
1000,476,464,494,226,501,727
1000,530,494,493,259,505,764
1000,486,497,507,250,499,749
1000,510,532,479,273,475,748
1000,504,490,498,260,501,761
1000,505,524,481,265,490,755
1000,497,488,498,240,507,747
1000,514,490,507,235,509,744
1000,481,503,483,235,491,726
1000,484,490,518,227,521,748
1000,482,473,517,214,537,751
1000,509,488,508,249,514,763
1000,490,478,497,234,505,739
1000,479,482,477,229,495,724
1000,504,492,489,245,500,745
1000,473,506,506,244,494,738
1000,471,492,519,226,515,741
1000,502,497,510,248,501,749
1000,483,495,496,239,486,725
1000,505,497,495,246,506,752
1000,489,493,498,242,515,757
1000,510,532,505,265,499,764
1000,492,526,526,247,494,741
1000,493,506,464,231,503,734
1000,527,498,494,258,489,747
1000,503,511,500,257,479,736
1000,520,509,509,273,478,751
1000,517,500,514,249,521,770
1000,477,504,510,238,504,742
1000,488,494,489,241,482,723
1000,488,494,489,246,493,739
1000,476,491,519,240,513,753
1000,502,494,501,232,532,764
1000,488,495,480,238,500,738
1000,502,479,504,248,522,770
1000,489,494,532,246,507,753
1000,516,467,508,230,527,757
1000,508,500,501,252,495,747
1000,497,502,505,259,482,741
1000,500,514,527,251,507,758
1000,491,485,510,238,523,761
1000,476,476,482,233,508,741
1000,476,490,492,234,492,726
1000,494,484,501,250,493,743
1000,508,474,490,240,510,750
1000,515,522,504,268,488,756
1000,516,487,500,248,505,753
1000,501,527,495,253,487,740
1000,519,488,537,244,530,774
1000,484,491,455,231,489,720
1000,517,513,493,269,487,756
1000,487,481,476,241,485,726
1000,504,488,484,253,487,740
1000,495,491,479,257,473,730
1000,501,523,495,268,474,742
1000,494,536,508,264,485,749
1000,502,488,510,244,516,760
1000,515,490,505,255,514,769
1000,506,487,515,251,505,756
1000,471,487,490,229,494,723
1000,467,493,469,223,484,707
1000,488,496,504,242,506,748
1000,496,506,489,253,490,743
1000,510,483,511,250,502,752
1000,521,488,497,259,495,754
1000,512,512,488,266,494,760
1000,496,475,503,236,528,764
1000,514,514,506,272,483,755
1000,500,488,474,237,492,729
1000,461,528,514,241,491,732
1000,498,519,490,263,474,737
1000,474,496,490,239,490,729
1000,519,478,523,235,547,782
1000,482,510,475,258,463,721
1000,504,508,511,257,491,748
1000,491,493,486,256,474,730
1000,487,510,494,241,493,734
1000,480,515,480,245,490,735
1000,492,504,485,240,501,741
1000,503,461,503,244,504,748
1000,512,503,481,253,504,757
1000,503,500,503,243,503,746
1000,486,491,495,231,507,738
1000,488,501,493,238,504,742
1000,503,519,491,260,493,753
1000,514,531,491,278,489,767
1000,486,468,492,228,508,736
1000,482,537,507,263,492,755
1000,479,503,481,242,493,735
1000,509,490,500,249,505,754
1000,498,509,473,258,484,742
1000,502,510,487,259,490,749
1000,487,489,495,239,495,734
1000,494,459,484,224,508,732
1000,518,498,486,261,473,734
1000,506,503,513,248,500,748
1000,509,490,490,256,483,739
1000,507,492,511,261,492,753
1000,518,497,511,265,508,773
1000,496,492,500,245,508,753
1000,465,503,492,232,484,716
1000,524,503,514,256,519,775
1000,496,490,473,241,491,732
1000,517,506,514,265,493,758
1000,514,514,506,250,506,756
1000,479,498,485,240,495,735
1000,478,492,496,235,509,744
1000,502,520,526,252,506,758
1000,498,514,497,250,492,742
1000,476,507,479,241,481,722
1000,480,500,532,230,535,765
1000,502,496,520,236,532,768
1000,477,496,493,231,508,739
1000,506,498,477,251,482,733
1000,511,504,483,262,470,732
1000,507,499,501,247,514,761
1000,504,492,513,252,505,757
1000,489,485,519,225,523,748
1000,478,501,477,233,501,734
1000,481,506,500,240,497,737
1000,485,490,510,234,519,753
1000,501,526,485,246,487,733
1000,483,488,477,239,499,738
1000,489,492,497,254,496,750
1000,484,502,508,234,505,739
1000,480,505,507,247,496,743
1000,504,504,497,250,505,755
1000,520,497,483,266,485,751
1000,510,496,487,238,514,752
1000,509,485,464,249,486,735
1000,484,470,476,225,510,735
1000,474,488,453,231,495,726
1000,500,536,497,266,483,749
1000,475,505,492,260,473,733
1000,505,504,481,252,488,740
1000,515,493,485,241,511,752
1000,514,506,503,268,503,771
1000,494,507,527,255,504,759
1000,499,495,506,240,523,763
1000,473,536,492,275,453,728
1000,511,488,517,263,496,759
1000,510,520,486,258,488,746
1000,496,496,493,228,516,744
1000,498,481,507,240,501,741
1000,512,525,504,274,489,763
1000,490,488,491,244,499,743
1000,505,512,526,258,513,771
1000,510,506,484,256,501,757
1000,539,525,507,279,503,782
1000,499,527,500,257,486,743
1000,501,494,464,250,482,732
1000,499,517,498,262,477,739
1000,491,522,534,256,512,768
1000,501,516,515,256,497,753
1000,521,496,517,259,511,770
1000,513,505,483,267,484,751
1000,508,514,492,258,483,741
1000,515,517,484,267,478,745
1000,516,475,510,244,522,766
1000,489,496,490,228,521,749
1000,500,503,470,241,496,737
1000,500,497,498,251,504,755
1000,503,531,494,262,503,765
1000,512,516,491,256,494,750
1000,487,479,520,223,528,751
1000,504,507,527,252,519,771
1000,496,514,509,252,495,747
1000,478,490,501,231,510,741
1000,492,481,487,240,499,739
1000,492,514,479,250,477,727
1000,487,495,508,248,510,758
1000,519,504,495,258,505,763
1000,513,496,510,252,510,762
1000,493,499,499,251,501,752
1000,504,512,488,268,498,766
1000,481,488,503,225,503,728
1000,525,503,475,261,494,755
1000,519,503,531,261,521,782
1000,510,495,505,245,510,755
1000,487,510,482,229,494,723
1000,501,489,487,231,517,748
1000,521,542,508,282,486,768
1000,497,511,488,255,480,735
1000,497,507,471,252,477,729
1000,487,483,497,235,500,735
1000,488,498,502,249,483,732
1000,501,499,522,252,509,761
1000,521,476,510,245,514,759
1000,478,502,498,246,483,729
1000,501,515,507,264,494,758
1000,500,505,456,248,475,723
1000,495,503,506,259,498,757
1000,496,542,493,272,471,743
1000,523,508,491,275,489,764
1000,507,507,498,255,503,758
1000,506,500,490,236,515,751
1000,475,482,508,227,526,753
1000,474,507,488,245,491,736
1000,503,532,495,269,489,758
1000,498,507,515,249,509,758
1000,504,499,491,244,509,753
1000,465,492,501,239,493,732
1000,510,497,466,258,497,755
1000,515,472,496,243,517,760
1000,521,517,503,271,502,773
1000,494,500,516,227,520,747
1000,536,485,493,265,496,761
1000,490,500,489,235,501,736
1000,483,478,472,242,475,717
1000,525,502,509,243,529,772
1000,505,492,511,257,499,756
1000,507,499,508,256,527,783
1000,482,484,501,229,522,751
1000,520,492,513,256,499,755
1000,513,495,474,246,500,746
1000,521,464,475,242,500,742
1000,500,523,488,261,478,739
1000,520,469,474,257,484,741
1000,474,486,528,228,520,748
1000,533,473,488,244,517,761
1000,484,508,483,248,489,737
1000,495,488,497,233,500,733
1000,485,507,514,246,510,756
1000,498,504,470,245,483,728
1000,497,529,516,276,484,760
1000,484,496,478,248,488,736
1000,467,507,499,223,514,737
1000,486,495,495,230,504,734
1000,493,514,495,258,491,749
1000,491,502,511,240,521,761
1000,483,486,522,227,521,748
1000,515,501,502,268,485,753
1000,533,509,499,268,484,752
1000,508,508,506,268,488,756
1000,499,482,542,246,515,761
1000,508,492,507,244,523,767
1000,529,550,477,297,450,747
1000,509,520,497,274,470,744
1000,507,497,497,246,502,748
1000,450,494,501,219,505,724
1000,514,497,512,253,500,753
1000,507,535,520,270,489,759
1000,519,516,478,246,508,754
1000,507,504,488,250,499,749
1000,509,468,500,243,501,744
1000,519,488,496,251,502,753
1000,518,495,516,256,518,774
1000,489,502,490,252,483,735
1000,478,508,502,225,505,730
1000,506,469,494,232,510,742
1000,504,470,481,237,508,745
1000,496,510,465,255,482,737
1000,522,502,523,255,507,762
1000,498,507,497,256,488,744
1000,506,489,538,259,520,779
1000,495,464,516,220,535,755
1000,508,484,474,251,488,739
1000,504,505,504,255,504,759
1000,494,484,526,244,505,749
1000,498,508,498,257,487,744
1000,498,511,486,246,498,744
1000,497,498,520,250,512,762
1000,507,489,507,255,502,757
1000,500,478,518,231,524,755
1000,527,498,510,276,496,772
1000,507,512,508,263,507,770
1000,486,504,487,247,486,733
1000,518,531,472,279,468,747
1000,522,501,505,247,522,769
1000,506,472,489,227,505,732
1000,522,491,528,271,491,762
1000,510,525,508,274,483,757
1000,522,529,510,286,484,770
1000,475,468,525,220,509,729
1000,507,500,494,241,506,747
1000,501,483,489,246,494,740
1000,464,521,504,255,480,735
1000,481,514,502,259,478,737
1000,497,509,478,264,470,734
1000,477,473,504,229,503,732
1000,509,532,507,266,503,769
1000,511,503,487,261,490,751
1000,492,539,507,262,496,758
1000,493,460,503,213,534,747
1000,474,501,510,243,487,730
1000,546,493,480,275,477,752
1000,513,484,517,237,526,763
1000,505,504,525,241,514,755
1000,496,526,503,256,503,759
1000,501,501,509,264,489,753
1000,513,488,499,248,499,747
1000,502,491,495,245,514,759
1000,489,512,501,243,493,736
1000,501,504,502,247,507,754
1000,508,489,499,260,489,749
1000,514,534,488,277,481,758
1000,485,508,509,234,527,761
1000,504,491,488,247,485,732
1000,491,495,513,249,502,751
1000,532,471,492,250,514,764
1000,474,482,507,220,517,737
1000,484,496,528,243,510,753
1000,505,506,481,254,483,737
1000,491,505,511,250,503,753
1000,484,484,499,240,498,738
1000,486,510,502,240,500,740
1000,521,510,501,262,504,766
1000,478,497,495,240,504,744
1000,459,476,522,205,529,734
1000,481,512,490,257,483,740
1000,497,491,486,242,517,759
1000,491,499,518,242,517,759
1000,486,483,499,229,502,731
1000,490,495,481,229,523,752
1000,484,526,544,252,523,775
1000,495,497,522,246,505,751
1000,473,517,495,237,506,743
1000,513,513,499,267,474,741
1000,488,487,462,239,484,723
1000,485,509,495,258,489,747
1000,492,489,472,241,498,739
1000,467,514,502,230,495,725
1000,504,511,512,248,514,762
1000,491,495,528,237,537,774
1000,502,535,519,254,510,764
1000,543,483,478,279,486,765
1000,475,498,490,234,496,730
1000,500,524,510,267,492,759
1000,504,511,504,240,521,761
1000,481,502,527,242,522,764
1000,495,518,513,268,484,752
1000,466,478,497,229,487,716
1000,487,510,512,245,504,749
1000,520,496,505,269,501,770
1000,491,518,492,259,476,735
1000,490,515,504,254,492,746
1000,487,507,505,251,512,763
1000,517,525,467,293,439,732
1000,497,479,482,239,496,735
1000,513,515,534,271,520,791
1000,489,489,505,238,518,756
1000,507,476,489,237,497,734
1000,507,478,513,229,539,768
1000,487,491,482,241,486,727
1000,497,488,540,247,518,765
1000,494,477,477,228,525,753
1000,504,492,500,256,514,770
1000,515,534,507,267,488,755
1000,508,484,491,254,503,757
1000,513,506,486,262,479,741
1000,492,497,512,259,500,759
1000,504,485,511,238,521,759
1000,511,487,507,256,516,772
1000,526,520,511,276,511,787
1000,526,497,497,262,494,756
1000,515,497,513,257,499,756
1000,526,483,505,266,495,761
1000,494,514,520,261,497,758
1000,516,490,515,243,523,766
1000,515,488,496,242,525,767
1000,476,496,489,234,499,733
1000,496,486,517,239,502,741
1000,483,486,482,229,513,742
1000,464,481,507,225,495,720
1000,495,485,474,240,509,749
1000,499,483,483,239,483,722
1000,507,504,513,245,526,771
1000,479,511,480,252,486,738
1000,527,500,498,267,507,774
1000,491,502,497,242,506,748
1000,516,484,513,257,511,768
1000,471,495,478,234,472,706
1000,483,488,499,251,485,736
1000,474,489,494,232,500,732
1000,500,516,482,259,497,756
1000,485,493,494,217,522,739
1000,515,493,518,259,507,766
1000,498,469,484,230,508,738
1000,496,498,521,246,511,757
1000,476,498,493,232,509,741
1000,507,497,480,264,468,732
1000,484,497,515,243,515,758
1000,507,505,488,260,477,737
1000,508,495,497,243,515,758
1000,483,489,520,243,497,740
1000,495,512,497,258,493,751
1000,515,498,509,251,517,768
1000,529,491,466,265,496,761
1000,508,500,512,263,488,751
1000,490,492,517,237,522,759
1000,507,527,510,265,495,760
1000,498,512,489,244,484,728
1000,495,505,501,259,480,739
1000,519,483,496,249,495,744
1000,531,485,532,260,510,770
1000,508,509,493,254,503,757
1000,502,486,497,238,503,741
1000,509,485,538,247,532,779
1000,483,547,497,250,493,743
1000,502,488,477,272,479,751
1000,484,494,490,246,497,743
1000,475,503,486,257,469,726
1000,491,493,485,247,487,734
1000,522,502,516,260,513,773
1000,517,483,501,252,496,748
1000,508,523,476,273,475,748
1000,517,513,507,259,496,755
1000,533,481,467,255,493,748
1000,509,497,512,260,504,764
1000,475,491,488,239,488,727
1000,531,489,486,267,468,735
1000,486,467,507,233,521,754
1000,493,521,507,265,482,747
1000,509,512,490,266,484,750
1000,486,469,506,231,522,753
1000,483,488,485,235,505,740
1000,487,472,483,226,504,730
1000,484,501,496,245,501,746
1000,511,511,496,274,474,748
1000,491,495,489,249,492,741
1000,504,484,529,240,530,770
1000,503,488,493,236,505,741
1000,503,502,498,258,488,746
1000,494,497,483,240,503,743
1000,490,514,478,242,475,717
1000,485,490,489,238,498,736
1000,501,512,526,257,503,760
1000,496,480,505,233,520,753
1000,479,513,496,247,487,734
1000,542,497,498,264,511,775
1000,503,496,500,253,503,756
1000,519,492,498,244,506,750
1000,509,523,468,251,480,731
1000,519,513,507,268,501,769
1000,521,495,486,256,498,754
1000,506,513,508,252,511,763
1000,468,503,493,248,475,723
1000,487,483,491,232,513,745
1000,501,485,486,253,482,735
1000,504,523,499,254,487,741
1000,539,503,513,282,496,778
1000,497,501,506,246,496,742
1000,489,484,505,241,506,747
1000,492,481,488,241,485,726
1000,487,494,482,246,476,722
1000,534,523,516,281,505,786
1000,539,500,499,261,506,767
1000,488,502,478,242,493,735
1000,482,505,488,245,494,739
1000,484,495,511,239,518,757
1000,498,506,511,244,511,755
1000,499,505,499,250,506,756
1000,517,508,492,267,489,756
1000,509,515,519,252,514,766
1000,489,514,525,258,502,760
1000,511,482,522,237,538,775
1000,471,540,505,248,499,747
1000,496,496,493,245,503,748
1000,524,496,485,259,496,755
1000,497,500,494,251,487,738
1000,511,521,476,268,469,737
1000,483,507,506,250,490,740
1000,463,496,477,233,490,723
1000,517,508,511,269,498,767
1000,501,524,491,258,480,738
1000,520,461,492,226,526,752
1000,513,497,466,263,480,743
1000,507,490,477,254,500,754
1000,540,476,484,247,529,776
1000,523,523,507,276,472,748
1000,471,510,524,250,484,734
1000,486,502,488,265,461,726
1000,490,490,492,239,501,740
1000,503,495,492,226,518,744
1000,500,471,501,230,517,747
1000,513,507,501,252,507,759
1000,508,475,499,244,510,754
1000,524,515,492,275,484,759
1000,481,490,495,244,490,734
1000,497,525,518,255,497,752
1000,504,478,497,249,490,739
1000,515,528,516,266,504,770
1000,539,511,528,272,511,783
1000,483,491,499,247,493,740
1000,529,472,512,231,534,765
1000,494,507,493,250,475,725
1000,491,512,491,256,497,753
1000,495,508,495,262,495,757
1000,507,496,504,253,516,769
1000,496,523,492,275,466,741
1000,542,464,497,251,525,776
1000,484,491,487,211,509,720
1000,525,502,513,265,505,770
1000,494,488,483,245,505,750
1000,491,517,510,250,506,756
1000,519,504,476,262,495,757
1000,481,531,470,250,465,715
1000,470,486,502,209,542,751
1000,494,492,515,236,532,768
1000,484,487,495,241,499,740
1000,499,503,522,247,501,748
1000,494,496,527,237,521,758
1000,495,504,489,246,496,742
1000,509,512,517,262,508,770
1000,499,500,503,261,485,746
1000,487,500,513,240,519,759
1000,518,512,491,252,508,760
1000,484,502,481,237,491,728
1000,469,502,530,237,518,755
1000,494,506,479,243,482,725
1000,488,498,502,242,502,744
1000,518,501,485,256,486,742
1000,490,510,488,265,483,748
1000,494,487,515,240,521,761
1000,503,504,517,248,505,753
1000,523,492,493,254,496,750
1000,487,537,505,261,487,748
1000,482,489,507,231,504,735
1000,524,509,486,274,491,765
1000,499,486,498,236,516,752
1000,515,499,487,258,496,754
1000,513,463,498,234,518,752
1000,492,514,499,259,488,747
1000,495,531,512,267,495,762
1000,500,484,475,245,490,735
1000,513,494,500,249,512,761
1000,497,495,503,249,506,755
1000,491,497,498,247,490,737
1000,511,513,481,269,480,749
1000,506,489,502,242,517,759
1000,497,468,490,235,503,738
1000,493,505,504,250,517,767
1000,498,491,516,242,505,747
1000,501,507,526,265,488,753
1000,528,513,488,250,527,777
1000,510,524,498,265,492,757
1000,477,507,506,240,495,735
1000,492,498,502,246,499,745
1000,496,507,498,245,513,758
1000,510,491,496,259,503,762
1000,509,508,479,251,499,750
1000,504,506,505,244,519,763
1000,506,518,517,269,484,753
1000,535,497,494,279,492,771
1000,495,511,509,262,491,753
1000,502,500,501,250,501,751
1000,500,490,528,241,527,768
1000,482,464,499,221,523,744
1000,490,489,487,233,496,729
1000,497,523,534,265,488,753
1000,498,487,494,243,504,747
1000,503,512,477,263,476,739
1000,528,484,484,262,495,757
1000,532,513,506,272,482,754
1000,495,522,517,258,510,768
1000,494,502,472,254,474,728
1000,505,533,477,290,449,739
1000,486,507,491,249,496,745
1000,504,501,530,250,513,763
1000,529,471,512,247,512,759
1000,508,470,497,237,522,759
1000,532,491,508,268,491,759
1000,475,501,499,244,482,726
1000,501,511,509,245,512,757
1000,486,502,478,247,468,715
1000,497,484,515,236,522,758
1000,524,506,492,257,497,754
1000,487,477,498,244,487,731
1000,480,506,499,252,497,749
1000,488,511,497,266,482,748
1000,498,476,514,232,532,764
1000,494,499,503,240,515,755
1000,498,488,467,250,499,749
1000,489,479,497,230,508,738
1000,468,495,492,229,483,712
1000,485,505,500,252,504,756
1000,518,530,498,269,488,757
1000,489,504,474,259,471,730
1000,522,507,479,270,481,751
1000,500,509,497,260,487,747
1000,506,505,497,265,481,746
1000,506,515,513,265,480,745
1000,480,487,487,215,521,736
1000,507,517,498,245,507,752
1000,503,513,512,264,510,774
1000,505,474,475,247,505,752
1000,490,499,513,250,513,763
1000,510,501,467,249,490,739
1000,502,486,512,241,523,764
1000,519,488,471,243,504,747
1000,512,482,543,251,520,771
1000,509,519,526,245,510,755
1000,504,487,494,248,509,757
1000,483,494,512,250,492,742
1000,503,510,497,256,504,760
1000,481,524,530,247,520,767
1000,512,483,525,248,516,764
1000,487,499,482,246,485,731
1000,523,496,471,263,489,752
1000,475,500,514,233,515,748
1000,491,504,532,243,521,764
1000,510,507,524,255,510,765
1000,482,495,503,252,511,763
1000,527,501,490,257,496,753
1000,511,502,474,259,479,738
1000,490,508,491,252,493,745
1000,523,489,532,245,521,766
1000,511,489,514,251,516,767
1000,496,521,513,252,501,753
1000,513,512,510,266,491,757
1000,469,517,504,244,496,740
1000,495,488,491,243,503,746
1000,501,511,481,278,449,727
1000,490,502,509,243,494,737
1000,524,497,499,255,510,765
1000,486,475,480,230,513,743
1000,497,502,500,250,497,747
1000,517,503,493,256,491,747
1000,522,493,526,243,529,772
1000,490,498,514,237,527,764
1000,490,508,500,249,500,749
1000,480,479,539,239,520,759
1000,491,497,507,237,514,751
1000,474,522,491,252,475,727
1000,497,508,489,255,488,743
1000,490,497,499,246,490,736
1000,528,497,521,270,501,771
1000,495,472,500,243,499,742
1000,476,503,510,230,505,735
1000,500,507,500,259,484,743
1000,518,481,459,251,485,736
1000,511,493,509,255,511,766
1000,529,488,486,260,501,761
1000,492,528,492,263,472,735
1000,506,515,504,261,478,739
1000,503,465,494,230,528,758
1000,511,507,520,256,510,766
1000,520,516,507,272,495,767
1000,497,516,501,257,508,765
1000,510,500,461,256,501,757
1000,500,538,481,276,458,734
1000,483,503,497,250,491,741
1000,477,480,481,227,496,723
1000,479,483,500,230,505,735
1000,504,531,504,285,453,738
1000,507,523,499,265,494,759
1000,511,500,508,252,520,772
1000,502,525,515,262,493,755
1000,512,506,501,249,519,768
1000,491,497,501,250,507,757
1000,513,520,500,263,499,762
1000,486,518,514,260,498,758
1000,485,522,514,248,492,740
1000,527,526,501,283,487,770
1000,505,490,497,233,512,745
1000,522,494,477,258,495,753
1000,517,528,498,288,461,749
1000,511,488,474,264,493,757
1000,488,506,494,254,488,742
1000,531,487,464,274,474,748
1000,500,482,491,237,503,740
1000,473,518,528,234,509,743
1000,470,522,471,241,482,723
1000,501,497,514,243,513,756
1000,444,471,520,204,535,739
1000,480,516,479,237,511,748
1000,511,527,511,270,488,758
1000,466,497,520,233,502,735
1000,507,494,524,249,508,757
1000,474,473,515,230,512,742
1000,502,517,481,256,499,755
1000,480,492,503,247,502,749
1000,480,512,517,234,515,749
1000,491,502,486,242,509,751
1000,496,472,494,234,508,742
1000,489,519,516,243,496,739
1000,490,494,488,242,493,735
1000,472,495,496,239,505,744
1000,512,531,505,259,492,751
1000,476,496,482,234,493,727
1000,521,502,515,274,497,771
1000,505,509,493,251,505,756
1000,513,466,501,250,517,767
1000,491,505,464,250,481,731
1000,498,505,520,266,493,759
1000,500,502,509,251,496,747
1000,493,522,510,263,488,751
1000,507,530,528,275,492,767
1000,492,467,467,246,472,718
1000,529,500,494,260,503,763
1000,480,525,492,246,496,742
1000,520,497,528,256,523,779
1000,504,495,506,258,497,755
1000,476,480,462,220,498,718
1000,491,514,515,248,500,748
1000,485,515,511,253,491,744
1000,506,471,482,248,492,740
1000,507,517,499,270,499,769
1000,516,506,489,262,482,744
1000,511,490,475,251,492,743
1000,474,491,503,219,518,737
1000,496,516,489,259,476,735
1000,502,523,522,265,503,768
1000,504,484,504,244,518,762
1000,507,517,491,256,501,757
1000,506,473,504,244,509,753
1000,494,527,500,267,488,755
1000,509,467,519,243,513,756
1000,514,495,496,254,509,763
1000,500,497,511,261,508,769
1000,500,513,477,269,471,740
1000,517,480,484,239,513,752
1000,492,505,480,263,465,728
1000,508,518,510,262,490,752
1000,486,493,500,244,504,748
1000,492,492,504,249,484,733
1000,494,489,496,216,523,739
1000,509,547,491,277,485,762
1000,520,497,483,257,499,756
1000,485,519,515,248,508,756
1000,496,500,493,249,503,752
1000,513,501,516,249,510,759
1000,493,506,485,256,481,737
1000,495,521,496,248,499,747
1000,503,513,513,248,501,749
1000,546,479,511,254,545,799
1000,513,507,480,269,461,730
1000,513,499,529,256,519,775
1000,484,488,490,230,509,739
1000,497,523,496,259,496,755
1000,513,496,493,235,533,768
1000,483,481,513,233,504,737
1000,481,486,523,235,511,746
1000,503,512,518,267,483,750
1000,495,521,477,248,504,752
1000,515,522,497,275,469,744
1000,518,505,486,249,496,745
1000,525,493,492,255,495,750
1000,488,478,495,223,509,732
1000,493,507,507,249,494,743
1000,483,495,523,232,516,748
1000,519,499,507,273,486,759
1000,487,498,498,234,499,733
1000,508,495,504,251,507,758
1000,499,478,484,239,522,761
1000,502,496,483,246,490,736
1000,492,485,512,233,532,765
1000,503,499,478,244,485,729
1000,497,509,502,240,519,759
1000,484,532,500,267,485,752
1000,518,493,502,244,508,752
1000,503,540,501,258,499,757
1000,514,475,478,239,516,755
1000,497,499,475,238,491,729
1000,517,484,497,249,510,759
1000,507,506,511,250,524,774
1000,507,526,536,269,508,777
1000,503,497,490,243,507,750
1000,503,501,481,258,482,740
1000,502,499,513,256,508,764
1000,508,509,448,265,462,727
1000,497,500,474,254,473,727
1000,511,527,514,273,495,768
1000,511,530,480,269,477,746
1000,506,521,473,257,480,737
1000,491,495,511,244,510,754
1000,519,519,497,280,490,770
1000,489,492,482,241,489,730
1000,472,488,520,246,505,751
1000,500,509,483,264,464,728
1000,484,501,483,243,488,731
1000,496,488,482,227,517,744
1000,519,486,495,253,507,760
1000,485,491,501,223,528,751
1000,499,503,517,256,514,770
1000,502,500,461,250,486,736
1000,518,512,485,253,492,745
1000,481,502,486,239,495,734
1000,471,512,494,239,478,717
1000,495,497,504,256,495,751
1000,499,495,498,251,511,762
1000,522,491,480,254,502,756
1000,492,463,500,218,528,746
1000,509,526,520,262,510,772
1000,486,506,499,240,504,744
1000,470,493,493,235,495,730
1000,495,509,486,263,465,728
1000,505,491,504,241,529,770
1000,507,481,506,247,516,763
1000,495,493,535,254,489,743
1000,494,513,497,259,481,740
1000,496,488,472,234,493,727
1000,490,494,501,237,504,741
1000,504,482,531,249,510,759
1000,494,492,502,247,503,750
1000,513,479,497,236,507,743
1000,475,489,507,240,498,738
1000,533,509,501,274,508,782
1000,516,469,517,249,523,772
1000,507,487,511,250,508,758
1000,505,508,498,261,475,736
1000,516,471,485,237,511,748
1000,501,521,484,275,463,738
1000,498,495,491,253,488,741
1000,517,458,509,235,536,771
1000,496,503,477,241,493,734
1000,502,500,490,242,504,746
1000,504,470,522,243,508,751
1000,515,511,487,258,486,744
1000,533,494,515,265,508,773
1000,536,506,494,276,493,769
1000,503,515,502,238,501,739
1000,518,496,537,262,506,768
1000,505,489,516,240,521,761
1000,487,464,521,223,526,749
1000,519,527,517,266,490,756
1000,493,494,486,243,495,738
1000,521,476,506,244,503,747
1000,501,517,505,255,503,758
1000,514,503,478,262,489,751
1000,485,502,481,240,491,731
1000,482,523,484,248,481,729
1000,492,501,521,250,503,753
1000,521,469,525,244,533,777
1000,515,472,521,248,516,764
1000,524,496,477,255,490,745
1000,472,516,503,249,497,746
1000,529,499,496,263,511,774
1000,517,469,487,254,500,754
1000,478,478,508,227,518,745
1000,467,478,499,225,508,733
1000,493,501,498,257,484,741
1000,517,511,476,268,476,744
1000,516,501,489,264,495,759
1000,474,508,528,218,526,744
1000,478,496,500,243,492,735
1000,500,484,519,242,517,759
1000,504,508,508,262,487,749
1000,501,479,510,237,532,769
1000,494,492,520,240,515,755
1000,501,484,506,227,516,743
1000,547,521,491,290,488,778
1000,493,495,499,244,506,750
1000,522,498,493,264,500,764
1000,511,483,483,262,483,745
1000,499,473,491,226,529,755
1000,472,533,508,247,486,733
1000,523,519,499,264,504,768
1000,514,498,475,256,487,743
1000,513,518,485,266,476,742
1000,504,508,511,260,481,741
1000,489,539,490,267,457,724
1000,469,530,489,238,504,742
1000,494,523,482,243,495,738
1000,513,510,496,266,485,751
1000,521,489,509,261,502,763
1000,495,542,513,261,499,760
1000,500,544,502,265,481,746
1000,484,452,526,202,549,751
1000,495,507,518,250,511,761
1000,489,491,473,242,504,746
1000,507,492,479,248,494,742
1000,512,501,511,249,510,759
1000,518,497,507,244,519,763
1000,509,514,503,250,495,745
1000,492,495,497,240,503,743
1000,487,492,494,233,509,742
1000,532,527,493,287,483,770
1000,494,493,509,239,513,752
1000,498,512,491,251,500,751
1000,493,502,513,239,512,751
1000,508,500,496,253,493,746
1000,492,501,494,248,490,738
1000,506,492,470,250,491,741
1000,490,509,506,232,514,746
1000,494,493,492,246,499,745
1000,497,497,481,241,499,740
1000,473,498,486,232,480,712
1000,490,523,514,255,500,755
1000,481,502,493,246,489,735
1000,499,473,492,239,517,756
1000,476,488,495,219,514,733
1000,490,525,516,257,502,759
1000,526,516,482,266,476,742
1000,488,496,480,252,479,731
1000,502,481,510,250,507,757
1000,523,520,483,264,475,739
1000,518,504,479,274,470,744
1000,525,507,514,256,506,762
1000,500,522,513,256,493,749
1000,503,498,482,246,500,746
1000,503,491,517,229,528,757
1000,491,459,496,233,501,734
1000,526,520,497,267,500,767
1000,497,526,510,262,479,741
1000,519,518,539,275,485,760
1000,499,490,504,260,486,746
1000,491,496,492,246,482,728
1000,495,518,474,252,473,725
1000,488,528,516,266,481,747
1000,480,509,501,247,492,739
1000,502,481,495,238,509,747
1000,500,495,525,248,508,756
1000,505,497,485,255,500,755
1000,525,513,513,259,512,771
1000,526,493,506,255,508,763
1000,504,503,516,253,526,779
1000,513,482,487,249,497,746
1000,517,492,489,257,494,751
1000,504,500,476,254,484,738
1000,521,515,520,274,496,770
1000,480,494,490,240,474,714
1000,509,496,496,248,512,760
1000,514,502,484,270,481,751
1000,502,514,500,260,485,745
1000,492,500,483,254,478,732
1000,497,506,466,245,485,730
1000,509,520,512,262,508,770
1000,469,483,489,229,509,738
1000,501,484,499,248,514,762
1000,503,510,501,249,513,762
1000,496,475,515,244,524,768
1000,502,516,518,259,489,748
1000,510,481,485,248,496,744
1000,520,509,495,262,501,763
1000,498,509,490,246,494,740
1000,468,487,497,239,491,730
1000,493,518,480,260,478,738
1000,491,501,509,239,502,741
1000,489,494,482,249,483,732
1000,517,522,509,263,507,770
1000,490,520,515,256,496,752
1000,494,516,512,261,498,759
1000,501,510,518,256,514,770
1000,464,477,477,210,515,725
1000,489,480,510,230,520,750
1000,493,521,505,252,498,750
1000,500,499,482,231,508,739
1000,500,499,494,245,511,756
1000,497,503,540,240,538,778
1000,512,473,484,239,513,752
1000,514,506,495,266,497,763
1000,500,480,503,230,524,754
1000,494,475,487,238,510,748
1000,502,489,465,241,487,728
1000,539,507,494,267,498,765
1000,503,464,506,227,526,753
1000,479,437,510,220,523,743
1000,485,499,491,234,515,749
1000,512,487,476,243,501,744
1000,480,497,496,249,475,724
1000,499,509,505,264,485,749
1000,532,479,506,251,522,773
1000,544,518,492,289,467,756
1000,504,487,499,239,516,755
1000,499,488,517,232,530,762
1000,501,497,489,249,484,733
1000,487,489,491,233,508,741
1000,506,490,528,263,506,769
1000,511,516,507,259,497,756
1000,505,504,499,249,506,755
1000,473,492,504,225,519,744
1000,512,507,469,249,493,742
1000,502,548,493,283,459,742
1000,510,520,492,260,483,743
1000,476,478,505,221,525,746
1000,514,519,490,267,490,757
1000,493,478,511,226,518,744
1000,506,504,513,256,496,752
1000,481,525,507,256,483,739
1000,488,497,511,250,507,757
1000,497,494,504,242,515,757
1000,514,491,500,251,511,762
1000,505,467,506,237,510,747
1000,473,503,503,236,502,738
1000,499,507,485,255,479,734
1000,520,511,484,266,494,760
1000,510,508,462,269,477,746
1000,510,509,536,267,490,757
1000,529,502,480,274,481,755
1000,503,493,472,264,478,742
1000,500,520,492,259,486,745
1000,477,490,499,228,504,732
1000,522,502,536,257,525,782
1000,491,509,512,247,494,741
1000,519,501,510,259,509,768
1000,489,504,474,248,485,733
1000,483,509,523,236,512,748
1000,499,494,497,245,492,737
1000,504,508,495,249,503,752
1000,456,495,515,235,515,750
1000,528,507,500,268,507,775
1000,494,493,505,230,517,747
1000,501,483,481,239,508,747
1000,497,531,535,266,502,768
1000,525,487,532,257,519,776
1000,486,497,528,248,502,750
1000,512,488,470,251,491,742
1000,494,525,531,256,496,752
1000,506,491,489,254,491,745
1000,496,478,512,243,505,748
1000,513,515,487,255,492,747
1000,454,496,465,226,474,700
1000,509,515,473,259,466,725
1000,498,526,464,261,453,714
1000,516,468,483,248,501,749
1000,494,508,520,256,505,761
1000,511,490,482,249,502,751
1000,526,514,497,277,476,753
1000,527,491,527,267,492,759
1000,500,481,489,220,509,729
1000,516,517,498,268,467,735
1000,498,479,470,249,489,738
1000,507,503,506,246,498,744
1000,519,496,497,264,508,772
1000,499,485,479,247,493,740
1000,518,484,478,256,499,755
1000,510,490,512,258,513,771
1000,498,513,526,249,515,764
1000,471,503,516,247,492,739
1000,518,488,509,248,515,763
1000,480,492,514,234,518,752
1000,496,495,510,232,526,758
1000,497,476,490,240,506,746
1000,478,505,502,239,499,738
1000,469,514,515,240,484,724
1000,510,552,513,292,482,774
1000,524,498,494,263,500,763
1000,513,490,517,257,497,754
1000,482,534,530,249,511,760
1000,518,518,496,268,494,762
1000,500,514,510,244,497,741
1000,502,538,503,275,485,760
1000,483,495,481,219,506,725
1000,498,519,513,259,502,761
1000,499,489,502,238,520,758
1000,475,489,488,237,499,736
1000,516,504,515,250,527,777
1000,457,518,485,244,477,721
1000,492,486,507,243,506,749
1000,484,487,500,229,511,740
1000,505,519,473,258,478,736
1000,534,504,484,256,502,758
1000,522,478,487,256,512,768
1000,495,507,501,250,494,744
1000,519,505,476,272,472,744
1000,485,503,522,236,525,761
1000,501,495,475,245,494,739
1000,447,470,503,207,529,736
1000,491,515,507,240,520,760
1000,501,482,504,252,509,761
1000,485,505,506,238,496,734
1000,492,503,510,253,508,761
1000,528,496,491,266,492,758
1000,480,486,503,252,486,738
1000,518,495,505,255,518,773
1000,492,482,524,238,516,754
1000,502,498,505,260,489,749
1000,497,488,504,242,504,746
1000,503,493,499,254,505,759
1000,490,487,495,256,493,749
1000,494,483,486,232,507,739
1000,517,511,502,266,513,779
1000,499,498,498,249,511,760
1000,489,531,503,264,477,741
1000,529,501,491,256,504,760
1000,503,505,505,266,500,766
1000,497,480,488,244,502,746
1000,470,521,510,252,501,753
1000,499,499,483,238,503,741
1000,526,538,531,285,498,783
1000,492,468,476,237,492,729
1000,496,501,487,245,500,745
1000,499,471,494,240,499,739
1000,520,521,491,261,484,745
1000,486,510,525,243,515,758
1000,481,511,502,233,506,739
1000,538,529,516,286,476,762
1000,498,489,502,237,504,741
1000,493,503,520,245,506,751
1000,530,498,512,256,520,776
1000,483,491,489,221,516,737
1000,469,515,492,242,488,730
1000,474,478,479,223,491,714
1000,525,520,505,284,495,779
1000,503,471,511,236,500,736
1000,487,505,500,249,503,752
1000,515,496,497,251,500,751
1000,497,493,495,253,484,737
1000,494,512,510,263,491,754
1000,500,489,510,230,527,757
1000,510,495,536,254,519,773
1000,544,508,497,272,506,778
1000,498,514,497,256,498,754
1000,519,475,499,257,510,767
1000,471,478,513,222,516,738
1000,484,488,512,243,504,747
1000,519,521,493,262,473,735
1000,462,492,501,232,488,720
1000,508,534,516,273,494,767
1000,480,495,500,233,492,725
1000,507,504,487,259,474,733
1000,516,504,494,260,491,751
1000,509,522,464,262,476,738
1000,490,499,516,263,503,766
1000,504,527,493,262,486,748
1000,484,512,509,244,504,748
1000,507,483,483,254,486,740
1000,466,510,530,246,491,737
1000,510,493,488,247,503,750
1000,486,477,507,234,514,748
1000,519,514,497,270,497,767
1000,515,507,498,262,497,759
1000,512,505,507,251,524,775
1000,507,506,523,264,500,764
1000,491,508,503,249,499,748
1000,504,528,491,270,466,736
1000,493,504,506,254,514,768
1000,488,530,504,258,483,741
1000,498,518,527,263,509,772
1000,483,521,507,251,496,747
1000,512,489,496,246,500,746
1000,501,525,519,264,495,759
1000,488,523,493,257,487,744
1000,503,515,499,254,511,765
1000,521,500,487,269,473,742
1000,510,497,510,262,500,762
1000,500,465,502,230,517,747
1000,512,488,483,244,500,744
1000,491,494,494,245,492,737
1000,498,507,497,241,507,748
1000,525,491,495,270,487,757
1000,498,504,484,251,492,743
1000,480,500,498,223,510,733
1000,488,457,493,222,516,738
1000,464,483,506,227,500,727
1000,474,488,500,229,496,725
1000,504,495,498,249,513,762
1000,490,512,493,260,477,737
1000,483,482,488,239,495,734
1000,516,514,507,260,485,745
1000,503,500,526,251,505,756
1000,500,515,503,253,506,759
1000,491,509,496,247,513,760
1000,496,487,476,253,489,742
1000,492,488,501,226,521,747
1000,509,520,510,260,501,761
1000,473,521,509,252,480,732
1000,523,494,482,253,500,753
1000,515,481,481,259,495,754
1000,480,471,496,229,524,753
1000,492,482,520,249,499,748
1000,485,501,477,228,498,726
1000,508,506,511,263,490,753
1000,497,499,490,239,512,751
1000,504,500,539,242,517,759
1000,516,493,491,246,496,742
1000,505,494,498,240,510,750
1000,496,467,532,236,532,768
1000,480,492,518,237,515,752
1000,488,496,487,229,499,728
1000,502,504,502,242,505,747
1000,483,514,491,236,513,749
1000,491,497,490,246,497,743
1000,486,503,484,242,494,736
1000,477,521,484,253,466,719
1000,491,514,510,258,502,760
1000,518,509,487,259,490,749
1000,512,470,526,240,525,765
1000,484,495,492,231,508,739
1000,480,500,489,253,488,741
1000,475,488,484,232,504,736
1000,497,512,517,253,503,756
1000,499,479,512,227,534,761
1000,529,498,500,267,490,757
1000,514,487,501,247,516,763
1000,488,474,493,224,518,742
1000,500,496,505,237,521,758
1000,514,501,511,260,502,762
1000,498,491,516,248,511,759
1000,512,506,515,272,480,752
1000,509,497,494,247,512,759
1000,517,511,508,259,497,756
1000,517,533,500,285,474,759
1000,511,517,506,255,499,754
1000,510,496,526,251,523,774
1000,480,466,493,223,523,746
1000,527,519,486,268,483,751
1000,475,483,480,229,489,718
1000,492,502,500,251,499,750
1000,486,509,518,255,491,746
1000,493,468,491,222,523,745
1000,495,470,523,233,529,762
1000,505,521,491,270,485,755
1000,519,508,499,267,504,771
1000,502,499,509,249,533,782
1000,484,467,478,234,475,709
1000,510,501,517,257,497,754
1000,489,504,490,240,506,746
1000,482,506,505,239,498,737
1000,510,516,513,265,498,763
1000,524,481,502,254,504,758
1000,495,514,495,266,478,744
1000,520,481,519,248,512,760
1000,528,490,513,258,507,765
1000,510,506,473,263,469,732
1000,509,518,504,260,493,753
1000,533,492,507,256,511,767
1000,506,495,481,258,509,767
1000,505,483,488,245,505,750
1000,500,494,483,245,504,749
1000,531,496,488,259,502,761
1000,514,497,499,267,489,756
1000,529,499,484,282,472,754
1000,502,521,490,255,481,736
1000,515,498,493,257,504,761
1000,486,498,491,259,469,728
1000,494,485,521,250,503,753
1000,508,520,499,267,484,751
1000,514,509,511,257,498,755
1000,485,504,486,241,499,740
1000,487,512,529,220,535,755
1000,473,510,487,246,492,738
1000,484,507,483,242,492,734
1000,477,482,505,243,493,736
1000,511,508,492,257,489,746
1000,513,480,500,242,519,761
1000,500,505,487,253,487,740
1000,525,506,514,266,506,772
1000,508,509,522,245,510,755
1000,499,496,498,267,474,741
1000,499,516,489,262,495,757
1000,511,510,499,267,494,761
1000,502,510,499,252,500,752
1000,489,514,520,250,489,739
1000,514,511,512,246,503,749
1000,493,510,487,254,487,741
1000,492,509,460,236,497,733
1000,500,522,502,271,488,759
1000,484,484,519,239,507,746
1000,474,511,511,258,489,747
1000,497,520,500,253,495,748
1000,502,507,522,252,508,760
1000,521,507,526,258,524,782
1000,498,525,491,270,477,747
1000,511,520,509,262,484,746
1000,510,512,488,273,481,754
1000,480,495,521,241,506,747
1000,499,480,494,242,501,743
1000,477,506,498,250,483,733
1000,488,502,532,243,508,751
1000,475,485,491,249,480,729
1000,475,507,505,232,501,733
1000,495,535,497,273,476,749
1000,523,489,534,266,501,767
1000,517,489,508,252,515,767
1000,537,483,499,247,518,765
1000,511,505,495,262,483,745
1000,495,523,485,262,492,754
1000,512,513,498,266,494,760
1000,496,488,512,230,532,762
1000,493,487,508,241,491,732
1000,490,487,477,240,489,729
1000,508,481,463,242,489,731
1000,505,520,505,238,520,758
1000,512,515,484,261,486,747
1000,488,531,528,249,504,753
1000,497,513,490,267,479,746
1000,501,512,511,252,502,754
1000,490,514,494,259,482,741
1000,526,504,511,251,505,756
1000,502,521,486,269,461,730
1000,501,510,458,248,470,718
1000,520,479,473,244,493,737
1000,462,502,491,231,485,716
1000,477,527,514,263,470,733
1000,499,510,516,256,489,745
1000,491,497,514,234,515,749
1000,503,496,495,250,503,753
1000,515,498,516,263,504,767
1000,531,496,503,267,513,780
1000,503,489,501,255,492,747
1000,479,488,523,237,515,752
1000,476,492,523,246,499,745
1000,514,509,515,259,516,775
1000,498,493,499,233,519,752
1000,504,495,532,259,509,768
1000,507,526,473,275,460,735
1000,504,504,506,253,512,765
1000,511,467,508,224,527,751
1000,458,512,481,240,482,722
1000,513,490,494,259,488,747
1000,507,512,487,268,483,751
1000,505,483,498,241,517,758
1000,483,486,518,242,517,759
1000,481,510,510,236,515,751
1000,491,493,496,241,502,743
1000,504,490,513,244,516,760
1000,482,486,492,235,498,733
1000,491,504,512,245,499,744
1000,502,515,494,259,485,744
1000,481,498,525,249,502,751
1000,477,484,497,237,496,733
1000,481,504,520,232,527,759
1000,502,514,510,248,500,748
1000,513,520,495,270,491,761
1000,518,492,483,259,495,754
1000,502,519,489,249,498,747
1000,511,539,504,285,472,757
1000,514,486,498,241,513,754
1000,495,468,514,240,517,757
1000,500,479,507,237,519,756
1000,554,532,483,294,475,769
1000,514,516,504,269,482,751
1000,504,515,512,254,503,757
1000,516,501,494,266,478,744
1000,517,463,513,262,508,770
1000,515,513,468,268,479,747
1000,511,522,495,279,461,740
1000,510,500,503,261,496,757
1000,505,519,499,261,500,761
1000,500,518,501,246,497,743
1000,511,522,503,270,488,758
1000,495,513,480,262,462,724
1000,503,486,513,261,507,768
1000,515,531,522,279,487,766
1000,504,513,519,258,505,763
1000,498,498,485,232,500,732
1000,509,517,498,265,480,745
1000,494,494,508,240,495,735
1000,505,471,541,234,547,781
1000,469,519,520,248,497,745
1000,499,507,513,256,512,768
1000,495,498,509,244,506,750
1000,483,532,476,254,475,729
1000,489,486,482,236,496,732
1000,489,488,511,246,492,738
1000,485,523,528,256,516,772
1000,479,501,532,248,494,742
1000,488,525,501,257,478,735
1000,500,515,484,254,479,733
1000,496,505,473,250,489,739
1000,498,495,517,264,503,767
1000,514,474,538,245,521,766
1000,502,475,466,243,492,735
1000,502,518,495,268,474,742
1000,512,510,522,276,493,769
1000,536,499,521,273,503,776
1000,484,489,510,233,511,744
1000,493,486,516,233,521,754
1000,526,481,509,263,515,778
1000,469,507,512,243,490,733
1000,513,486,526,242,536,778
1000,487,490,493,231,510,741
1000,500,523,483,258,485,743
1000,495,486,522,247,504,751
1000,512,518,490,271,486,757
1000,511,508,498,259,501,760
1000,519,479,507,241,515,756
1000,497,520,500,241,499,740
1000,518,496,486,265,487,752
1000,517,483,516,240,522,762
1000,483,511,510,252,487,739
1000,495,510,490,259,484,743
1000,501,491,504,251,511,762
1000,490,514,498,253,488,741
1000,510,484,525,227,541,768
1000,492,457,489,221,510,731
1000,499,504,504,259,498,757
1000,479,507,514,253,488,741
1000,495,485,525,243,506,749
1000,493,515,509,263,502,765
1000,491,498,511,250,513,763
1000,499,491,514,235,514,749
1000,507,493,510,246,515,761
1000,525,486,502,252,504,756
1000,494,487,480,230,499,729
1000,496,525,529,274,479,753
1000,479,479,505,235,502,737
1000,526,491,505,265,506,771
1000,514,503,497,253,506,759
1000,486,517,483,252,482,734
1000,497,475,496,233,520,753
1000,496,529,519,267,500,767
1000,502,529,505,261,502,763
1000,496,486,484,250,485,735
1000,513,531,518,278,484,762
1000,507,515,504,249,501,750
1000,502,492,512,233,522,755
1000,516,487,516,246,503,749
1000,510,511,503,259,497,756
1000,483,527,503,263,492,755
1000,503,505,489,254,484,738
1000,498,508,479,265,482,747
1000,480,490,502,245,492,737
1000,484,503,465,237,491,728
1000,495,504,480,262,485,747
1000,504,495,474,242,486,728
1000,502,475,528,246,505,751
1000,483,494,492,238,492,730
1000,510,512,511,265,514,779
1000,518,503,511,257,510,767
1000,512,514,467,260,499,759
1000,505,519,494,265,479,744
1000,496,519,525,241,509,750
1000,489,528,540,263,506,769
1000,471,495,492,237,497,734
1000,486,515,506,236,524,760
1000,514,528,506,266,480,746
1000,507,475,491,229,535,764
1000,483,532,479,252,469,721
1000,476,494,512,241,502,743
1000,489,498,515,252,498,750
1000,510,517,491,270,491,761
1000,492,486,512,248,511,759
1000,510,499,512,250,500,750
1000,506,492,532,249,515,764
1000,491,506,503,264,482,746
1000,478,493,520,238,503,741
1000,497,497,527,255,510,765
1000,501,472,538,247,514,761
1000,486,489,495,233,521,754
1000,504,495,529,248,517,765
1000,462,502,513,226,511,737
1000,511,481,488,247,492,739
1000,485,473,491,232,503,735
1000,513,489,498,253,487,740
1000,492,487,493,248,500,748
1000,473,477,534,225,512,737
1000,479,501,491,244,499,743
1000,529,467,488,243,520,763
1000,467,510,496,243,489,732
1000,503,479,502,245,507,752
1000,510,519,512,256,523,779
1000,492,476,488,240,510,750
1000,489,482,488,238,506,744
1000,529,503,492,256,496,752
1000,474,503,500,244,500,744
1000,515,490,494,259,500,759
1000,500,499,504,249,493,742
1000,476,500,496,230,508,738
1000,493,510,475,251,482,733
1000,519,502,492,250,506,756
1000,512,486,469,245,485,730
1000,521,497,500,273,492,765
1000,512,495,483,255,489,744
1000,514,508,533,265,515,780
1000,490,520,514,267,484,751
1000,513,503,493,250,495,745
1000,475,505,515,247,496,743
1000,497,487,480,259,483,742
1000,502,502,483,271,472,743
1000,478,477,486,242,476,718
1000,480,512,501,248,496,744
1000,490,486,489,234,496,730
1000,482,479,490,230,494,724
1000,501,524,477,252,484,736
1000,487,494,485,231,508,739
1000,489,486,498,232,501,733
1000,468,485,492,224,498,722
1000,512,508,504,255,515,770
1000,491,476,508,230,517,747
1000,504,476,491,241,499,740
1000,513,501,543,276,494,770
1000,508,514,479,248,490,738
1000,514,490,508,257,510,767
1000,527,473,481,263,474,737
1000,504,504,492,257,485,742
1000,489,522,526,241,521,762
1000,516,523,494,263,491,754
1000,479,509,491,249,495,744
1000,509,493,522,253,508,761
1000,494,486,490,240,498,738
1000,493,536,529,270,501,771
1000,498,524,489,269,467,736
1000,506,507,509,263,509,772
1000,492,513,494,255,505,760
1000,467,520,522,240,504,744
1000,469,490,501,215,523,738
1000,532,490,501,272,498,770
1000,500,503,524,267,505,772
1000,494,519,524,242,523,765
1000,481,529,503,271,480,751
1000,491,495,466,235,506,741
1000,515,476,506,243,518,761
1000,483,518,487,244,495,739
1000,515,506,505,265,489,754
1000,511,500,521,243,513,756
1000,500,527,517,251,525,776
1000,534,506,502,277,502,779
1000,520,499,482,260,487,747
1000,522,490,510,269,502,771
1000,476,506,485,246,473,719
1000,471,490,534,218,533,751
1000,493,507,491,261,477,738
1000,484,493,466,240,477,717
1000,476,506,522,239,514,753
1000,486,485,494,231,510,741
1000,500,522,494,275,457,732
1000,499,482,498,253,492,745
1000,485,469,522,230,524,754
1000,511,470,483,235,512,747
1000,494,490,508,230,516,746
1000,497,494,516,252,505,757
1000,500,507,491,252,501,753
1000,486,509,491,245,501,746
1000,496,519,495,247,490,737
1000,515,524,511,270,482,752
1000,489,504,506,255,481,736
1000,504,522,469,251,489,740
1000,502,505,475,245,490,735
1000,496,487,497,246,500,746
1000,467,513,489,240,487,727
1000,500,494,504,251,495,746
1000,496,497,468,241,486,727
1000,502,457,502,222,549,771
1000,491,500,499,239,503,742
1000,505,478,516,244,524,768
1000,469,495,526,225,513,738
1000,526,522,507,276,489,765
1000,500,485,490,231,514,745
1000,516,511,510,258,498,756
1000,507,525,506,259,487,746
1000,503,487,505,247,510,757
1000,534,499,531,267,526,793
1000,485,487,511,236,516,752
1000,497,505,529,247,530,777
1000,538,487,498,250,536,786
1000,523,484,513,238,524,762
1000,504,499,509,244,510,754
1000,514,516,510,259,505,764
1000,502,501,505,253,503,756
1000,486,516,512,250,505,755
1000,506,482,483,246,518,764
1000,523,501,493,261,490,751
1000,506,485,494,260,495,755
1000,486,473,521,220,532,752
1000,497,501,467,250,488,738
1000,458,519,497,238,502,740
1000,529,514,532,268,531,799
1000,468,505,489,236,505,741
1000,488,501,489,253,482,735
1000,500,510,516,251,507,758
1000,507,473,466,240,496,736
1000,494,495,480,237,497,734
1000,501,516,481,261,473,734
1000,498,515,529,261,493,754
1000,488,492,491,237,501,738
1000,501,528,508,270,488,758
1000,511,503,489,248,495,743
1000,489,485,511,231,515,746
1000,514,513,466,266,476,742
1000,480,501,509,237,505,742
1000,504,498,477,244,507,751
1000,489,508,479,244,490,734
1000,515,514,455,266,474,740
1000,501,495,534,253,516,769
1000,520,501,516,261,521,782
1000,508,506,498,245,514,759
1000,483,501,497,249,498,747
1000,497,496,522,244,520,764
1000,511,491,503,248,507,755
1000,481,498,504,233,506,739
1000,514,494,505,259,497,756
1000,485,499,489,244,514,758
1000,526,502,504,277,495,772
1000,486,501,496,241,506,747
1000,500,504,496,257,480,737
1000,495,506,518,254,496,750
1000,505,476,483,243,505,748
1000,503,475,482,221,520,741
1000,502,516,522,249,507,756
1000,479,490,508,231,507,738
1000,486,493,523,248,497,745
1000,509,479,496,246,510,756
1000,471,528,497,247,488,735
1000,496,499,480,254,499,753
1000,511,501,483,261,507,768
1000,529,518,503,263,499,762
1000,490,508,549,233,532,765
1000,497,521,494,273,477,750
1000,498,479,505,247,500,747
1000,529,515,517,275,505,780
1000,488,499,483,236,496,732
1000,479,510,519,243,499,742
1000,488,519,495,249,497,746
1000,507,500,516,259,503,762
1000,507,481,519,240,531,771
1000,487,514,487,252,485,737
1000,491,494,511,231,515,746
1000,489,532,502,269,482,751
1000,511,472,513,240,535,775
1000,492,504,475,235,489,724
1000,499,518,506,251,505,756
1000,471,481,493,217,507,724
1000,517,506,505,259,500,759
1000,521,505,500,261,503,764
1000,515,490,492,259,497,756
1000,516,492,500,260,499,759
1000,492,514,481,254,497,751
1000,509,511,513,248,514,762
1000,472,501,500,235,509,744
1000,511,524,516,267,509,776
1000,504,497,493,253,497,750
1000,503,494,508,250,509,759
1000,487,486,496,238,501,739
1000,479,503,488,252,487,739
1000,488,474,524,228,521,749
1000,526,499,499,264,489,753
1000,502,509,508,260,489,749
1000,504,532,511,276,472,748
1000,484,491,493,229,519,748
1000,498,473,489,244,494,738
1000,496,516,487,242,494,736
1000,456,512,511,234,493,727
1000,497,490,500,259,506,765
1000,500,464,462,245,475,720
1000,500,488,487,247,492,739
1000,496,528,494,275,457,732
1000,483,483,482,227,510,737
1000,492,504,505,255,501,756
1000,504,513,521,270,485,755
1000,488,503,494,235,508,743
1000,499,534,486,250,486,736
1000,485,511,520,238,513,751
1000,508,497,480,267,466,733
1000,509,489,504,258,491,749
1000,507,493,486,250,491,741
1000,502,505,479,238,507,745
1000,489,483,488,240,493,733
1000,475,522,492,239,508,747
1000,477,497,481,226,508,734
1000,494,516,522,264,493,757
1000,500,481,482,222,526,748
1000,499,514,500,253,498,751
1000,522,505,480,263,485,748
1000,501,501,512,243,519,762
1000,524,466,495,252,501,753
1000,503,519,505,254,501,755
1000,515,505,511,271,496,767
1000,495,507,499,262,488,750
1000,523,480,506,251,504,755
1000,492,499,491,237,513,750
1000,507,502,497,270,480,750
1000,505,469,489,221,532,753
1000,512,505,497,264,485,749
1000,492,505,509,254,500,754
1000,475,525,477,245,483,728
1000,518,505,499,255,504,759
1000,474,494,494,237,510,747
1000,485,492,499,237,513,750
1000,505,489,493,239,509,748
1000,495,477,493,238,508,746
1000,486,489,482,241,486,727
1000,507,514,502,257,509,766
1000,492,526,502,241,497,738
1000,478,508,491,250,494,744
1000,493,501,475,250,485,735
1000,479,503,478,255,467,722
1000,506,494,490,243,500,743
1000,530,525,466,279,463,742
1000,519,521,469,281,456,737
1000,500,514,487,253,500,753
1000,502,511,492,259,504,763
1000,507,504,506,251,518,769
1000,486,524,513,265,480,745
1000,504,502,501,251,500,751
1000,509,494,493,243,509,752
1000,496,493,486,249,498,747
1000,504,497,496,258,481,739
1000,479,500,491,236,497,733
1000,448,504,522,229,504,733
1000,514,509,497,256,490,746
1000,498,515,509,248,506,754
1000,496,514,483,271,468,739
1000,484,504,517,245,511,756
1000,480,492,496,238,517,755
1000,504,523,522,272,501,773
1000,489,506,500,239,508,747
1000,520,501,527,248,512,760
1000,492,493,491,237,496,733
1000,467,483,501,224,510,734
1000,508,491,471,255,473,728
1000,511,488,510,250,509,759
1000,488,495,493,236,512,748
1000,506,473,492,254,482,736
1000,494,498,524,238,529,767
1000,490,501,512,245,500,745
1000,478,493,499,236,505,741
1000,478,510,494,247,488,735
1000,489,486,498,228,520,748
1000,506,501,492,244,503,747
1000,487,498,501,246,503,749
1000,437,516,513,235,493,728
1000,513,501,481,262,495,757
1000,489,489,507,240,491,731
1000,506,478,501,242,506,748
1000,504,499,502,249,493,742
1000,483,500,476,246,484,730
1000,472,507,492,232,490,722
1000,481,514,513,248,491,739
1000,507,506,516,260,504,764
1000,517,518,508,267,496,763
1000,525,498,472,266,483,749
1000,511,505,518,252,516,768
1000,533,489,494,262,507,769
1000,493,475,464,236,482,718
1000,490,505,468,246,475,721
1000,500,500,488,247,491,738
1000,498,490,487,238,488,726
1000,495,492,507,242,519,761
1000,492,515,509,259,495,754
1000,488,479,522,242,525,767
1000,483,487,485,240,511,751
1000,475,504,504,239,493,732
1000,500,498,492,263,487,750
1000,506,486,527,240,528,768
1000,507,522,456,268,470,738
1000,495,481,491,250,496,746
1000,513,501,522,253,500,753
1000,503,507,478,254,488,742
1000,507,487,526,239,514,753
1000,482,519,486,257,459,716
1000,514,494,492,253,492,745
1000,495,511,494,258,488,746
1000,504,508,516,258,505,763
1000,503,503,518,249,503,752
1000,496,475,476,231,506,737
1000,520,488,505,250,511,761
1000,495,511,508,235,531,766
1000,484,473,497,234,508,742
1000,487,508,491,248,496,744
1000,493,524,483,253,485,738
1000,505,500,479,257,479,736
1000,511,546,482,266,471,737
1000,506,495,526,247,516,763
1000,515,522,515,265,503,768
1000,508,483,519,244,520,764
1000,502,508,493,254,486,740
1000,512,478,494,246,504,750
1000,491,500,505,258,485,743
1000,503,517,489,255,478,733
1000,476,488,505,234,507,741
1000,502,503,511,244,521,765
1000,484,465,501,218,534,752
1000,512,515,477,264,474,738
1000,526,492,490,266,487,753
1000,496,515,503,262,491,753
1000,500,511,490,262,470,732
1000,480,498,505,234,517,751
1000,512,506,519,254,517,771
1000,504,493,499,250,499,749
1000,526,501,502,259,500,759
1000,500,491,502,248,491,739
1000,490,498,490,239,494,733
1000,493,455,497,204,521,725
1000,476,489,508,219,513,732
1000,496,499,498,237,508,745
1000,528,500,492,266,503,769
1000,509,517,519,271,492,763
1000,513,491,523,249,521,770
1000,492,512,516,250,505,755
1000,495,518,523,260,497,757
1000,514,512,499,264,486,750
1000,452,493,478,230,473,703
1000,479,472,477,220,511,731
1000,498,488,490,251,491,742
1000,508,511,509,261,485,746
1000,468,468,485,205,523,728
1000,495,501,484,246,490,736
1000,496,499,492,249,488,737
1000,533,488,491,265,481,746
1000,487,471,487,241,488,729
1000,512,523,491,265,498,763
1000,484,519,496,247,494,741
1000,507,520,488,252,510,762
1000,494,507,495,256,489,745
1000,480,502,518,229,523,752
1000,520,475,508,245,507,752
1000,477,488,488,222,510,732
1000,483,523,510,252,485,737
1000,515,496,482,262,475,737
1000,480,513,501,234,519,753
1000,527,486,493,256,501,757
1000,526,510,518,265,511,776
1000,496,488,497,239,500,739
1000,501,514,488,271,477,748
1000,517,496,492,265,503,768
1000,487,472,510,227,534,761
1000,513,496,470,259,471,730
1000,498,500,466,255,472,727
1000,505,480,488,241,527,768
1000,498,530,506,256,495,751
1000,520,510,490,267,499,766
1000,510,513,512,270,482,752
1000,481,479,513,239,501,740
1000,490,512,511,244,497,741
1000,505,509,499,264,494,758
1000,519,492,524,258,521,779
1000,500,489,490,243,493,736
1000,517,509,474,253,495,748
1000,508,523,486,277,487,764
1000,495,498,501,245,506,751
1000,530,494,505,260,522,782
1000,492,486,493,225,516,741
1000,509,492,508,252,497,749
1000,502,488,534,247,512,759
1000,481,509,470,244,484,728
1000,511,482,510,254,502,756
1000,508,487,489,244,489,733
1000,496,486,488,237,510,747
1000,469,492,484,229,511,740
1000,504,497,501,261,497,758
1000,512,517,484,264,482,746
1000,506,499,508,254,499,753
1000,533,510,515,253,532,785
1000,512,499,513,260,502,762
1000,484,507,484,245,487,732
1000,492,510,511,245,526,771
1000,492,507,469,251,468,719
1000,509,515,478,266,487,753
1000,481,489,513,229,515,744
1000,514,488,494,248,508,756
1000,513,506,524,262,502,764
1000,493,515,497,253,495,748
1000,496,508,495,247,504,751
1000,471,510,509,248,512,760
1000,487,500,509,248,509,757
1000,458,500,492,230,488,718
1000,504,493,504,244,521,765
1000,476,518,497,255,488,743
1000,504,493,494,249,515,764
1000,497,513,520,251,510,761
1000,494,505,502,250,502,752
1000,502,490,503,238,512,750
1000,478,469,512,234,514,748
1000,521,523,514,265,509,774
1000,475,500,508,240,496,736
1000,501,505,461,235,495,730
1000,502,491,522,255,494,749
1000,507,490,530,252,514,766
1000,481,493,484,240,490,730
1000,481,519,488,247,486,733
1000,502,484,486,243,492,735
1000,502,497,490,256,481,737
1000,491,493,477,241,486,727
1000,511,490,504,252,506,758
1000,499,528,511,266,491,757
1000,482,492,481,243,486,729
1000,498,520,489,259,486,745
1000,512,494,507,234,527,761
1000,491,501,509,227,516,743
1000,492,495,517,240,522,762
1000,514,521,477,259,482,741
1000,494,491,512,244,510,754
1000,501,514,495,248,506,754
1000,517,530,494,275,472,747
1000,501,517,531,252,508,760
1000,515,485,486,258,501,759
1000,504,469,518,248,506,754
1000,492,496,490,237,492,729
1000,485,530,490,269,469,738
1000,507,500,492,260,492,752
1000,498,507,487,261,480,741
1000,488,486,526,236,506,742
1000,474,505,480,239,501,740
1000,500,494,514,239,521,760
1000,500,498,488,238,514,752
1000,498,524,469,265,475,740
1000,478,507,490,240,497,737
1000,492,527,519,273,490,763
1000,504,491,509,261,486,747
1000,474,476,528,237,513,750
1000,503,512,491,251,497,748
1000,477,504,525,232,522,754
1000,524,510,500,278,480,758
1000,497,495,495,242,492,734
1000,487,504,511,241,503,744
1000,504,509,491,265,470,735
1000,521,473,503,253,511,764
1000,509,504,530,266,499,765
1000,543,526,503,284,490,774
1000,510,520,453,264,462,726
1000,522,470,499,239,525,764
1000,513,495,475,274,462,736
1000,480,491,487,225,504,729
1000,518,496,498,263,493,756
1000,500,500,482,241,506,747
1000,495,484,495,243,499,742
1000,487,479,494,229,516,745
1000,504,494,486,247,501,748
1000,490,500,488,246,498,744
1000,512,507,505,260,501,761
1000,492,449,477,224,504,728
1000,477,532,534,263,487,750
1000,511,496,474,256,477,733
1000,526,483,513,261,498,759
1000,497,493,492,242,505,747
1000,490,506,530,233,523,756
1000,542,489,489,265,502,767
1000,484,484,479,234,485,719
1000,510,501,514,261,505,766
1000,487,527,481,269,453,722
1000,462,519,500,236,498,734
1000,533,491,487,263,508,771
1000,507,515,519,260,505,765
1000,527,501,502,283,486,769
1000,514,493,518,249,524,773
1000,483,511,508,242,495,737
1000,475,530,507,256,496,752
1000,485,503,510,239,501,740
1000,517,493,505,255,505,760
1000,518,498,515,260,494,754
1000,507,489,513,243,509,752
1000,516,524,507,260,514,774
1000,483,517,466,251,473,724
1000,499,482,476,242,485,727
1000,506,509,505,261,494,755
1000,496,503,509,240,498,738
1000,482,476,506,227,522,749
1000,534,493,498,277,486,763
1000,495,510,535,253,510,763
1000,485,508,498,241,516,757
1000,496,478,485,233,500,733
1000,510,514,517,242,519,761
1000,483,480,495,224,514,738
1000,489,519,494,244,492,736
1000,512,499,498,250,503,753
1000,494,489,485,237,507,744
1000,494,501,503,254,493,747
1000,519,486,500,259,491,750
1000,483,522,526,246,513,759
1000,486,527,530,243,510,753
1000,516,529,476,271,477,748
1000,528,472,517,237,536,773
1000,534,499,497,266,505,771
1000,481,521,491,240,492,732
1000,481,479,492,222,508,730
1000,498,498,513,239,522,761
1000,508,485,501,264,488,752
1000,489,532,498,257,498,755
1000,498,513,493,242,498,740
1000,510,495,481,249,499,748
1000,505,510,505,262,487,749
1000,502,493,507,244,512,756
1000,502,477,481,243,485,728
1000,498,486,509,240,512,752
1000,483,506,505,239,517,756
1000,483,498,502,234,514,748
1000,477,507,517,240,505,745
1000,510,511,487,259,497,756
1000,513,469,518,251,516,767
1000,489,501,522,245,507,752
1000,493,506,516,253,501,754
1000,498,486,478,236,495,731
1000,503,492,502,241,508,749
1000,494,497,509,240,507,747
1000,507,523,499,269,484,753
1000,487,522,533,243,519,762
1000,511,540,526,277,491,768
1000,504,513,492,259,475,734
1000,506,493,489,246,506,752
1000,526,481,474,243,517,760
1000,485,495,487,237,497,734
1000,523,494,478,253,502,755
1000,478,510,482,247,466,713
1000,491,505,471,242,487,729
1000,513,494,531,268,497,765
1000,514,500,489,250,496,746
1000,478,502,478,211,513,724
1000,481,518,495,246,496,742
1000,500,486,503,241,509,750
1000,502,501,504,249,512,761
1000,482,481,525,253,501,754
1000,521,513,533,269,516,785
1000,505,481,504,240,505,745
1000,497,493,493,253,499,752
1000,510,493,505,244,516,760
1000,482,530,491,265,468,733
1000,509,510,510,258,509,767
1000,502,488,508,244,519,763
1000,495,485,487,225,509,734
1000,492,493,524,231,532,763
1000,506,516,523,257,500,757
1000,486,489,483,242,497,739
1000,477,471,499,216,517,733
1000,495,521,488,259,480,739
1000,481,491,489,240,490,730
1000,508,516,521,262,510,772
1000,486,491,490,243,499,742
1000,502,494,490,247,496,743
1000,512,523,484,280,475,755
1000,469,484,503,227,504,731
1000,494,509,485,248,493,741
1000,503,500,500,257,493,750
1000,476,518,477,242,482,724
1000,496,492,483,243,497,740
1000,492,474,494,220,525,745
1000,478,501,504,244,489,733
1000,506,514,510,266,479,745
1000,494,500,503,253,496,749
1000,498,496,508,253,503,756
1000,485,483,487,232,503,735
1000,502,486,511,247,514,761
1000,501,485,474,233,508,741
1000,527,509,499,274,484,758
1000,513,496,495,252,513,765
1000,484,501,506,237,502,739
1000,511,505,462,273,470,743
1000,484,513,509,247,506,753
1000,519,483,484,262,487,749
1000,517,496,521,252,519,771
1000,502,534,521,271,486,757
1000,488,510,470,268,457,725
1000,491,510,483,247,484,731
1000,478,519,512,252,500,752
1000,487,482,512,230,517,747
1000,510,500,522,254,511,765
1000,483,494,481,232,490,722
1000,499,530,468,267,469,736
1000,488,519,498,255,483,738
1000,532,509,504,280,484,764
1000,516,489,518,259,503,762
1000,499,491,484,249,481,730
1000,496,528,498,252,495,747
1000,521,514,490,264,513,777
1000,492,521,469,256,474,730
1000,504,481,515,245,514,759
1000,470,488,526,222,519,741
1000,502,519,464,265,458,723
1000,500,511,504,255,503,758
1000,501,529,533,254,515,769
1000,506,456,507,219,546,765
1000,495,480,508,226,515,741
1000,490,505,489,247,489,736
1000,471,466,501,220,514,734
1000,488,507,516,247,498,745
1000,504,507,527,264,505,769
1000,477,489,496,245,487,732
1000,521,498,508,249,503,752
1000,494,492,476,237,506,743
1000,482,508,506,239,508,747
1000,479,513,515,255,492,747
1000,473,476,491,220,508,728
1000,487,494,477,230,495,725
1000,502,530,505,268,498,766
1000,479,490,479,247,492,739
1000,504,512,492,248,491,739
1000,511,532,486,255,491,746
1000,476,466,485,230,505,735
1000,490,492,493,244,503,747
1000,489,498,514,240,520,760
1000,484,475,488,236,494,730
1000,539,513,472,280,474,754
1000,491,487,492,227,509,736
1000,512,506,490,264,491,755
1000,514,469,470,245,496,741
1000,508,520,495,260,495,755
1000,536,492,498,272,507,779
1000,496,525,490,246,485,731
1000,500,493,503,240,525,765
1000,497,512,478,246,500,746
1000,483,491,511,231,509,740
1000,484,490,487,241,500,741
1000,490,467,506,221,530,751
1000,475,485,491,232,493,725
1000,486,472,482,216,516,732
1000,499,464,516,227,536,763
1000,508,509,489,265,467,732
1000,510,503,499,264,500,764
1000,472,492,498,214,501,715
1000,492,500,476,248,483,731
1000,519,492,509,250,510,760
1000,500,479,497,250,498,748
1000,485,522,481,254,486,740
1000,491,484,515,246,508,754
1000,488,513,468,259,467,726
1000,524,538,488,270,487,757
1000,523,495,468,252,496,748
1000,521,510,488,262,496,758
1000,505,498,489,246,494,740
1000,508,502,474,258,482,740
1000,480,515,530,241,524,765
1000,507,487,498,261,507,768
1000,480,519,512,242,496,738
1000,501,490,490,244,511,755
1000,486,494,494,239,498,737
1000,483,465,501,224,513,737
1000,491,490,489,241,492,733
1000,514,510,471,244,495,739
1000,506,515,477,265,473,738
1000,515,487,474,256,487,743
1000,517,494,491,258,488,746
1000,490,492,486,236,506,742
1000,492,487,497,247,515,762
1000,495,515,485,255,488,743
1000,493,503,500,247,490,737
1000,510,483,493,252,501,753
1000,500,492,500,244,509,753
1000,516,482,510,246,518,764
1000,487,508,486,243,489,732
1000,491,506,470,233,493,726
1000,508,464,534,243,525,768
1000,552,491,488,256,523,779
1000,503,515,491,249,497,746
1000,468,520,506,243,495,738
1000,501,489,482,243,501,744
1000,508,511,507,258,487,745
1000,472,473,485,230,490,720
1000,481,519,496,254,491,745
1000,459,507,495,232,488,720
1000,502,498,528,238,525,763
1000,513,521,494,263,493,756
1000,487,518,497,254,492,746
1000,523,487,519,261,505,766
1000,453,508,493,233,493,726
1000,497,495,487,251,503,754
1000,521,496,484,241,527,768
1000,515,500,480,259,494,753
1000,488,494,484,241,508,749
1000,503,510,515,253,507,760
1000,512,488,479,239,497,736
1000,541,546,493,293,480,773
1000,505,484,505,256,502,758
1000,522,495,498,264,486,750
1000,503,491,489,239,506,745
1000,510,507,524,257,506,763
1000,489,480,491,226,523,749
1000,503,519,487,256,494,750
1000,500,476,476,253,486,739
1000,489,505,499,246,504,750
1000,507,486,485,247,491,738
1000,510,508,484,255,503,758
1000,510,513,494,259,488,747
1000,528,499,508,269,485,754
1000,520,507,494,257,500,757
1000,486,504,502,239,512,751
1000,502,491,515,252,501,753
1000,476,502,526,227,516,743
1000,488,503,501,235,502,737
1000,470,472,499,228,508,736
1000,493,504,498,239,523,762
1000,492,517,489,257,485,742
1000,483,505,500,253,499,752
1000,501,514,497,258,487,745
1000,504,500,480,251,502,753
1000,505,540,508,268,488,756
1000,514,475,523,254,509,763
1000,501,515,490,254,503,757
1000,497,500,497,247,511,758
1000,512,498,505,242,513,755
1000,509,497,511,251,500,751
1000,493,497,511,244,506,750
1000,540,467,495,259,507,766
1000,492,491,480,235,505,740
1000,507,493,480,248,477,725
1000,481,525,504,270,455,725
1000,493,510,517,259,504,763
1000,496,483,514,235,519,754
1000,503,483,490,253,492,745
1000,478,495,501,245,495,740
1000,489,471,494,227,519,746
1000,499,465,499,237,520,757
1000,515,510,519,284,491,775
1000,479,494,486,225,504,729
1000,488,490,487,243,499,742
1000,514,502,483,256,497,753
1000,504,515,514,244,518,762
1000,514,507,482,255,500,755
1000,511,496,480,257,502,759
1000,464,497,500,235,495,730
1000,503,507,477,261,492,753
1000,489,469,493,224,520,744
1000,488,494,511,252,483,735
1000,490,503,491,250,493,743
1000,476,483,524,230,518,748
1000,530,496,515,263,504,767
1000,509,518,505,265,488,753
1000,506,497,516,259,502,761
1000,490,496,482,248,503,751
1000,497,486,512,236,514,750
1000,492,520,498,242,502,744
1000,513,479,496,229,520,749
1000,500,518,497,250,483,733
1000,493,474,503,245,504,749
1000,517,477,507,247,519,766
1000,501,493,504,245,508,753
1000,514,522,501,271,492,763
1000,473,503,531,219,525,744
1000,468,492,473,229,491,720
1000,509,495,503,257,507,764
1000,505,507,477,257,475,732
1000,496,478,518,240,500,740
1000,486,474,477,229,506,735
1000,497,507,500,247,515,762
1000,497,507,513,251,493,744
1000,520,490,492,260,506,766
1000,506,478,507,232,526,758
1000,509,490,494,253,509,762
1000,484,496,523,237,523,760
1000,477,506,484,242,498,740
1000,499,497,492,232,507,739
1000,510,487,479,245,499,744
1000,477,475,498,230,501,731
1000,484,485,479,234,504,738
1000,495,481,475,247,489,736
1000,479,503,489,243,499,742
1000,514,497,496,256,503,759
1000,501,474,524,232,534,766
1000,502,510,487,249,494,743
1000,504,516,505,262,491,753
1000,511,519,499,259,509,768
1000,505,503,521,245,519,764
1000,483,510,497,259,478,737
1000,491,493,471,240,484,724
1000,496,508,504,250,497,747
1000,518,502,475,261,487,748
1000,500,499,518,247,514,761
1000,510,508,493,251,493,744
1000,492,488,512,245,520,765
1000,528,491,495,248,509,757
1000,496,492,469,230,496,726
1000,529,510,499,266,505,771
1000,490,476,483,236,510,746
1000,485,462,516,236,515,751
1000,480,499,509,254,479,733
1000,488,506,526,246,510,756
1000,511,507,509,269,482,751
1000,514,490,496,255,496,751
1000,531,487,514,258,499,757
1000,532,470,511,264,503,767
1000,543,512,506,276,488,764
1000,498,495,496,260,486,746
1000,492,518,499,263,485,748
1000,524,514,492,275,493,768
1000,482,485,489,233,505,738
1000,510,503,500,259,502,761
1000,473,512,470,238,482,720
1000,498,506,526,251,514,765
1000,482,508,478,246,491,737
1000,482,521,512,260,489,749
1000,488,469,511,215,531,746
1000,479,460,521,228,525,753
1000,519,477,491,244,501,745
1000,496,515,510,240,518,758
1000,542,493,516,271,514,785
1000,527,491,479,265,484,749
1000,507,509,503,265,494,759
1000,507,509,482,261,484,745
1000,513,498,524,259,508,767
1000,490,507,493,250,496,746
1000,494,509,498,256,494,750
1000,486,503,505,248,495,743
1000,488,506,506,247,505,752
1000,513,521,474,276,465,741
1000,503,520,503,274,479,753
1000,499,529,500,258,491,749
1000,482,482,505,240,515,755
1000,496,482,495,244,496,740
1000,509,504,495,269,458,727
1000,519,509,509,267,494,761
1000,477,491,504,230,500,730
1000,527,503,518,265,498,763
1000,491,480,520,230,504,734
1000,515,501,484,256,506,762
1000,473,505,476,248,465,713
1000,492,524,524,245,503,748
1000,481,491,516,245,509,754
1000,504,520,494,264,493,757
1000,480,512,502,248,489,737
1000,536,489,505,271,492,763
1000,492,502,503,241,493,734
1000,484,512,494,254,491,745
1000,516,494,495,249,515,764
1000,533,533,515,280,498,778
1000,517,477,492,241,515,756
1000,457,492,505,226,505,731
1000,510,497,517,261,501,762
1000,510,493,505,242,520,762
1000,514,501,520,264,504,768
1000,518,504,468,280,462,742
1000,505,533,500,272,485,757
1000,473,490,512,211,533,744
1000,507,498,500,254,510,764
1000,514,492,487,256,503,759
1000,506,498,489,255,485,740
1000,494,494,507,249,493,742
1000,501,508,464,261,470,731
1000,500,487,469,238,497,735
1000,496,501,475,244,491,735
1000,504,507,485,256,479,735
1000,503,512,528,257,505,762
1000,496,483,491,250,492,742
1000,497,502,477,242,487,729
1000,519,517,500,266,493,759
1000,489,507,518,245,527,772
1000,513,486,522,243,525,768
1000,493,526,485,280,448,728
1000,513,503,511,257,497,754
1000,515,504,500,262,497,759
1000,487,481,505,244,494,738
1000,485,492,510,246,513,759
1000,512,487,499,248,501,749
1000,535,489,509,258,513,771
1000,491,505,508,243,502,745
1000,495,498,487,242,496,738
1000,519,516,530,262,523,785
1000,481,499,531,228,514,742
1000,489,477,500,254,489,743
1000,515,473,486,246,507,753
1000,504,523,492,264,482,746
1000,486,502,482,234,509,743
1000,509,495,510,250,517,767
1000,505,514,502,259,488,747
1000,509,509,527,263,506,769
1000,479,479,487,225,505,730
1000,490,485,480,238,515,753
1000,486,480,512,228,512,740
1000,512,503,483,262,499,761
1000,505,493,495,259,489,748
1000,502,509,511,257,495,752
1000,504,496,474,252,485,737
1000,516,498,537,261,520,781
1000,490,477,493,244,497,741
1000,488,479,495,237,499,736
1000,507,493,493,246,496,742
1000,493,498,491,248,494,742
1000,498,472,499,241,502,743
1000,492,503,512,249,478,727
1000,515,506,501,264,493,757
1000,488,492,486,245,494,739
1000,514,498,500,245,513,758
1000,492,501,484,234,507,741
1000,479,511,485,241,496,737
1000,486,498,478,229,495,724
1000,451,504,491,229,485,714
1000,510,479,510,241,516,757
1000,480,519,520,262,498,760
1000,489,494,500,246,490,736
1000,466,517,487,227,492,719
1000,469,507,477,233,479,712
1000,500,501,500,258,501,759
1000,500,517,512,241,517,758
1000,525,505,514,274,486,760
1000,484,492,496,239,508,747
1000,478,476,502,219,513,732
1000,504,476,494,240,514,754
1000,496,537,524,255,507,762
1000,501,491,492,236,501,737
1000,498,490,510,230,525,755
1000,471,502,493,241,488,729
1000,531,522,520,280,509,789
1000,484,502,502,252,485,737
1000,480,482,503,231,506,737
1000,502,514,490,243,513,756
1000,469,490,475,206,526,732
1000,484,500,475,239,500,739
1000,485,487,495,249,502,751
1000,504,494,497,244,507,751
1000,498,518,511,262,509,771
1000,489,507,512,269,481,750
1000,512,488,479,248,491,739
1000,499,498,480,258,475,733
1000,501,497,516,245,518,763
1000,481,497,530,231,523,754
1000,505,491,522,239,531,770
1000,504,500,500,262,492,754
1000,505,488,506,245,511,756
1000,502,515,502,267,473,740
1000,498,481,501,252,500,752
1000,514,512,489,279,458,737
1000,498,502,477,239,501,740
1000,495,521,516,266,471,737
1000,493,507,471,253,473,726
1000,502,493,496,240,499,739
1000,516,505,493,269,498,767
1000,484,519,504,261,500,761
1000,506,486,488,248,494,742
1000,499,496,504,247,501,748
1000,502,483,508,249,513,762
1000,485,486,496,248,479,727
1000,497,516,482,268,491,759
1000,486,475,493,218,516,734
1000,456,517,501,241,492,733
1000,493,512,520,247,504,751
1000,469,481,509,223,508,731
1000,500,502,492,250,502,752
1000,465,493,477,229,488,717
1000,500,504,505,246,494,740
1000,490,494,510,232,522,754
1000,485,479,482,231,501,732
1000,486,503,512,247,515,762
1000,490,499,494,242,516,758
1000,514,521,478,258,481,739
1000,524,494,491,257,493,750
1000,511,473,492,232,510,742
1000,503,518,525,268,492,760
1000,500,495,506,235,517,752
1000,476,505,508,244,513,757
1000,492,519,470,249,492,741
1000,499,488,504,247,496,743
1000,477,527,505,255,484,739
1000,500,501,472,239,488,727
1000,521,502,485,253,495,748
1000,502,484,524,237,526,763
1000,503,502,504,248,519,767
1000,496,500,508,236,501,737
1000,489,488,497,252,475,727
1000,496,508,489,244,495,739
1000,509,498,498,246,516,762
1000,496,488,499,238,503,741
1000,511,513,516,254,506,760
1000,487,522,528,260,500,760
1000,483,499,492,243,510,753
1000,487,486,485,241,493,734
1000,476,516,509,252,477,729
1000,485,503,510,255,482,737
1000,507,525,525,259,503,762
1000,484,518,518,249,485,734
1000,522,503,504,257,509,766
1000,492,491,467,257,456,713
1000,531,502,517,263,507,770
1000,488,494,504,244,494,738
1000,497,497,488,238,490,728
1000,517,492,517,249,514,763
1000,517,503,507,257,514,771
1000,507,496,483,255,491,746
1000,517,498,491,244,511,755
1000,504,519,474,254,493,747
1000,535,513,509,276,495,771
1000,501,488,462,234,490,724
1000,506,519,527,257,504,761
1000,491,485,492,240,495,735
1000,516,512,485,257,490,747
1000,490,504,526,250,505,755
1000,471,493,532,231,520,751
1000,528,513,515,270,502,772
1000,488,518,478,261,478,739
1000,482,484,517,224,520,744
1000,514,509,507,266,497,763
1000,516,494,523,249,525,774
1000,493,495,489,239,519,758
1000,496,472,487,226,508,734
1000,460,472,501,205,518,723
1000,529,499,526,267,507,774
1000,479,491,492,246,490,736
1000,481,500,520,245,525,770
1000,547,488,505,256,517,773
1000,512,510,515,278,474,752
1000,524,508,483,246,505,751
1000,524,489,509,266,492,758
1000,499,501,541,255,520,775
1000,495,471,484,234,500,734
1000,525,486,483,273,494,767
1000,508,480,489,251,511,762
1000,486,498,499,220,531,751
1000,492,471,497,228,521,749
1000,497,497,489,267,479,746
1000,498,515,498,262,484,746
1000,488,500,508,248,503,751
1000,511,481,481,249,489,738
1000,539,520,511,287,481,768
1000,500,497,514,234,534,768
1000,504,485,465,237,489,726
1000,506,477,499,249,500,749
1000,488,511,490,258,477,735
1000,489,516,469,253,477,730
1000,505,501,476,255,478,733
1000,504,471,514,234,516,750
1000,485,505,494,253,493,746
1000,502,483,485,241,528,769
1000,496,481,507,237,522,759
1000,491,520,511,260,477,737
1000,468,504,508,235,502,737
1000,517,505,502,259,497,756
1000,490,479,500,245,491,736
1000,509,486,482,245,494,739
1000,497,488,467,244,481,725
1000,496,470,498,233,500,733
1000,509,479,492,234,508,742
1000,492,489,509,223,526,749
1000,485,484,503,242,500,742
1000,510,509,498,269,479,748
1000,500,517,501,253,508,761
1000,483,516,516,253,497,750
1000,498,469,496,247,486,733
1000,521,490,505,262,492,754
1000,479,472,522,223,538,761
1000,502,500,541,251,530,781
1000,519,495,505,273,482,755
1000,494,495,487,241,487,728
1000,509,506,512,267,492,759
1000,507,510,500,250,501,751
1000,474,500,488,243,491,734
1000,484,507,497,247,490,737
1000,509,501,499,256,500,756
1000,528,476,512,247,527,774
1000,496,502,495,253,497,750
1000,508,495,505,251,510,761
1000,497,482,488,233,514,747
1000,502,489,483,247,483,730
1000,508,482,493,234,517,751
1000,505,502,507,254,511,765
1000,482,497,499,225,524,749
1000,505,487,485,252,506,758
1000,495,522,517,267,486,753
1000,525,492,521,258,511,769
1000,490,490,485,227,510,737
1000,513,487,501,246,513,759
1000,527,516,469,255,507,762
1000,503,493,489,248,496,744
1000,499,510,492,254,493,747
1000,508,483,533,254,509,763
1000,486,493,480,252,467,719
1000,495,509,479,249,496,745
1000,502,499,507,257,505,762
1000,506,525,499,272,471,743
1000,507,490,505,252,502,754
1000,537,516,492,292,473,765
1000,515,529,527,268,509,777
1000,526,515,503,263,511,774
1000,508,505,525,260,512,772
1000,483,487,499,246,504,750
1000,495,523,488,256,487,743
1000,498,514,530,254,512,766
1000,514,498,480,263,487,750
1000,503,515,491,252,491,743
1000,501,474,503,235,506,741
1000,513,533,508,274,488,762
1000,497,497,502,252,494,746
1000,501,509,506,252,496,748
1000,480,515,477,250,485,735
1000,481,481,499,223,517,740
1000,497,504,478,257,486,743
1000,501,517,481,256,486,742
1000,508,517,496,266,492,758
1000,477,525,487,243,489,732
1000,494,498,512,258,496,754
1000,491,509,500,242,493,735
1000,486,482,495,237,500,737
1000,483,492,524,234,511,745
1000,466,517,514,243,498,741
1000,487,491,495,235,508,743
1000,492,473,484,230,503,733
1000,521,506,509,270,489,759
1000,488,491,528,238,525,763
1000,513,458,502,235,517,752
1000,482,490,464,233,500,733
1000,526,507,494,265,489,754
1000,512,494,523,253,514,767
1000,492,483,511,252,499,751
1000,494,509,493,248,500,748
1000,483,502,495,252,498,750
1000,504,493,468,246,486,732
1000,516,504,489,271,483,754
1000,464,526,525,257,473,730
1000,505,483,526,241,519,760
1000,519,489,503,261,494,755
1000,501,479,512,239,528,767
1000,496,481,514,233,535,768
1000,501,470,510,238,517,755
1000,504,505,495,267,472,739
1000,489,507,502,254,491,745
1000,497,512,505,251,505,756
1000,541,498,507,265,516,781
1000,484,482,493,216,531,747
1000,506,491,511,261,494,755
1000,497,494,501,249,506,755
1000,526,507,486,270,489,759
1000,492,516,494,266,469,735
1000,516,482,514,264,497,761
1000,496,523,485,269,473,742
1000,527,475,512,242,529,771
1000,521,511,508,271,484,755
1000,511,508,467,260,461,721
1000,504,508,515,248,505,753
1000,504,496,488,236,521,757
1000,517,510,494,272,482,754
1000,480,507,506,255,474,729
1000,495,519,496,256,484,740
1000,508,509,510,277,480,757
1000,523,522,492,270,491,761
1000,507,497,513,235,520,755
1000,500,478,487,249,487,736
1000,485,479,529,229,521,750
1000,510,497,469,245,485,730
1000,497,512,487,257,487,744
1000,501,479,502,236,518,754
1000,510,523,505,263,487,750
1000,500,478,520,237,516,753
1000,511,492,489,254,496,750
1000,501,501,500,256,490,746
1000,481,484,509,236,511,747
1000,512,479,499,236,523,759
1000,541,510,523,274,505,779
1000,506,456,506,229,516,745
1000,482,514,495,242,486,728
1000,466,503,502,230,494,724
1000,467,507,511,241,500,741
1000,495,508,504,242,504,746
1000,535,524,479,286,464,750
1000,498,510,496,242,501,743
1000,499,520,499,264,487,751
1000,507,509,521,261,504,765
1000,483,496,495,244,484,728
1000,547,510,498,268,506,774
1000,507,472,518,241,519,760
1000,501,515,473,261,482,743
1000,520,506,485,251,496,747
1000,519,479,485,250,506,756
1000,493,509,507,252,496,748
1000,499,511,530,250,525,775
1000,486,526,482,274,457,731
1000,501,512,529,254,510,764
1000,508,497,492,263,481,744
1000,483,499,499,242,507,749
1000,488,515,499,266,466,732
1000,472,493,509,227,508,735
1000,478,503,484,249,476,725
1000,480,509,508,231,515,746
1000,503,479,503,236,511,747
1000,514,508,519,257,504,761
1000,514,524,520,276,500,776
1000,505,517,484,256,493,749
1000,486,502,491,263,468,731
1000,490,521,500,263,482,745
1000,500,507,520,245,515,760
1000,518,516,501,275,495,770
1000,504,512,501,260,500,760
1000,499,480,500,232,518,750
1000,521,504,499,265,493,758
1000,483,491,500,235,497,732
1000,496,501,533,251,513,764
1000,506,487,505,243,501,744
1000,489,510,519,245,506,751
1000,501,499,483,253,487,740
1000,467,516,532,247,502,749
1000,502,499,503,244,504,748
1000,503,522,499,251,497,748
1000,499,494,479,251,491,742
1000,513,521,502,267,490,757
1000,473,499,511,236,500,736
1000,502,457,504,232,524,756
1000,495,464,484,227,503,730
1000,497,528,513,259,487,746
1000,484,505,499,250,489,739
1000,510,510,512,254,518,772
1000,495,502,500,254,496,750
1000,518,493,487,252,500,752
1000,486,527,523,260,499,759
1000,472,513,485,249,476,725
1000,485,505,512,244,500,744
1000,513,521,502,264,500,764
1000,506,522,495,263,484,747
1000,493,514,493,248,502,750
1000,475,507,525,236,506,742
1000,502,501,502,241,498,739
1000,481,509,516,251,492,743
1000,485,496,487,238,511,749
1000,507,493,474,254,482,736
1000,500,498,490,240,502,742
1000,503,485,478,247,496,743
1000,490,508,466,236,491,727
1000,527,531,500,289,478,767
1000,519,499,492,252,503,755
1000,515,496,485,263,477,740
1000,478,502,491,228,517,745
1000,519,499,469,264,480,744
1000,501,495,487,236,504,740
1000,479,463,497,231,513,744
1000,497,510,519,252,503,755
1000,513,487,487,247,514,761
1000,499,493,530,271,504,775
1000,473,508,476,237,489,726
1000,491,524,528,241,511,752
1000,483,457,500,210,530,740
1000,514,510,517,274,502,776
1000,513,465,497,237,521,758
1000,499,504,498,260,498,758
1000,496,502,533,237,528,765
1000,497,500,500,247,493,740
1000,541,514,465,298,440,738
1000,482,498,515,241,527,768
1000,532,503,526,271,513,784
1000,510,486,517,243,513,756
1000,488,482,520,228,520,748
1000,480,511,502,261,483,744
1000,514,513,502,257,494,751
1000,486,507,504,248,494,742
1000,472,535,509,236,489,725
1000,467,508,464,237,479,716
1000,498,497,496,246,502,748
1000,498,512,517,239,522,761
1000,543,504,492,284,483,767
1000,529,485,506,268,507,775
1000,474,473,475,228,507,735
1000,528,492,504,267,500,767
1000,504,506,494,247,501,748
1000,465,485,511,200,537,737
1000,495,497,476,247,494,741
1000,489,510,482,255,496,751
1000,533,507,529,275,516,791
1000,506,496,497,249,505,754
1000,510,525,503,260,490,750
1000,509,501,501,251,505,756
1000,486,497,528,253,514,767
1000,513,492,516,241,524,765
1000,510,495,525,248,524,772
1000,496,528,508,245,506,751
1000,506,513,533,275,482,757
1000,497,508,521,251,511,762
1000,483,512,505,259,478,737
1000,495,496,505,248,492,740
1000,501,491,471,237,499,736
1000,484,464,491,236,503,739
1000,500,508,486,261,482,743
1000,481,513,503,247,494,741
1000,508,488,466,247,492,739
1000,507,492,467,244,501,745
1000,499,507,501,254,515,769
1000,490,500,527,243,517,760
1000,478,492,506,231,507,738
1000,497,512,509,264,497,761
1000,494,485,502,237,518,755
1000,515,516,503,273,489,762
1000,482,489,516,239,503,742
1000,496,475,479,230,514,744
1000,491,508,504,245,492,737
1000,503,477,497,229,534,763
1000,502,505,465,257,481,738
1000,482,495,511,231,510,741
1000,508,476,503,239,506,745
1000,509,473,504,246,514,760
1000,509,507,477,258,477,735
1000,495,495,504,238,501,739
1000,510,513,510,259,501,760
1000,511,516,500,262,498,760
1000,490,511,502,241,501,742
1000,524,504,490,252,505,757
1000,517,470,500,241,525,766
1000,527,492,501,252,525,777
1000,519,519,500,264,492,756
1000,521,501,512,261,508,769
1000,532,509,503,276,492,768
1000,481,511,527,240,509,749
1000,510,484,509,243,519,762
1000,516,502,509,254,498,752
1000,526,502,520,258,517,775
1000,533,489,476,253,512,765
1000,484,490,496,241,512,753
1000,507,493,483,256,483,739
1000,504,487,489,258,486,744
1000,494,488,493,255,490,745
1000,524,475,507,261,499,760
1000,520,524,529,278,493,771
1000,483,506,512,247,506,753
1000,498,483,494,239,518,757
1000,505,512,475,262,482,744
1000,492,471,504,220,526,746
1000,506,487,518,235,525,760
1000,524,483,512,241,518,759
1000,530,491,515,256,521,777
1000,516,484,528,237,544,781
1000,484,502,525,246,506,752
1000,468,493,518,227,518,745
1000,473,530,476,250,478,728
1000,527,491,496,259,501,760
1000,490,503,519,242,505,747
1000,509,512,490,264,487,751
1000,529,495,495,244,508,752
1000,503,526,500,267,466,733
1000,496,491,511,256,501,757
1000,485,520,500,240,505,745
1000,499,505,514,245,512,757
1000,487,491,486,246,493,739
1000,493,522,505,250,515,765
1000,495,510,476,244,481,725
1000,526,500,498,271,497,768
1000,510,497,486,257,491,748
1000,528,516,526,268,519,787
1000,450,532,493,237,481,718
1000,509,488,513,246,520,766
1000,535,528,501,296,475,771
1000,521,502,506,254,510,764
1000,489,495,465,235,487,722
1000,502,513,465,267,474,741
1000,510,481,488,246,499,745
1000,496,505,497,251,494,745
1000,499,485,504,249,495,744
1000,497,469,469,226,513,739
1000,500,494,530,247,514,761
1000,505,488,493,257,480,737
1000,510,499,500,255,500,755
1000,512,494,477,247,499,746
1000,486,530,487,247,497,744
1000,496,497,494,236,511,747
1000,465,506,502,237,505,742
1000,455,485,516,214,536,750
1000,500,505,493,255,486,741
1000,513,483,493,252,513,765
1000,493,497,516,262,495,757
1000,483,506,496,256,488,744
1000,508,501,496,253,504,757
1000,472,507,498,230,507,737
1000,504,490,503,241,518,759
1000,487,468,493,228,517,745
1000,498,491,499,251,484,735
1000,505,507,512,241,525,766
1000,489,497,521,222,540,762
1000,498,510,505,268,468,736
1000,512,492,485,269,472,741
1000,495,519,497,265,469,734
1000,505,517,496,253,499,752
1000,483,518,488,237,498,735
1000,497,516,521,250,510,760
1000,520,496,451,258,474,732
1000,465,518,509,242,484,726
1000,518,517,494,273,481,754
1000,503,498,508,259,505,764
1000,519,503,491,263,494,757
1000,478,507,520,247,503,750
1000,508,521,513,258,503,761
1000,527,497,500,272,494,766
1000,539,482,488,255,494,749
1000,498,474,498,241,506,747
1000,490,480,476,244,491,735
1000,502,476,498,241,510,751
1000,532,498,501,267,511,778
1000,524,504,502,260,494,754
1000,499,498,514,240,508,748
1000,517,494,488,255,488,743
1000,498,491,510,251,500,751
1000,477,509,498,242,502,744
1000,510,518,473,260,487,747
1000,503,488,483,244,499,743
1000,484,512,489,246,494,740
1000,519,493,521,264,502,766
1000,519,481,477,248,506,754
1000,514,493,480,247,498,745
1000,483,499,502,239,507,746
1000,499,490,506,251,495,746
1000,509,520,516,260,492,752
1000,499,504,482,253,484,737
1000,511,504,523,243,523,766
1000,494,496,483,255,479,734
1000,507,500,485,263,490,753
1000,488,499,504,244,501,745
1000,512,495,502,251,496,747
1000,499,501,480,254,482,736
1000,488,472,500,222,530,752
1000,515,507,493,249,507,756
1000,494,534,478,268,467,735
1000,491,519,507,236,519,755
1000,490,520,480,257,478,735
1000,488,499,527,254,504,758
1000,528,492,481,264,484,748
1000,510,507,493,258,497,755
1000,550,505,509,274,519,793
1000,495,473,540,224,544,768
1000,476,481,489,229,512,741
1000,478,498,511,243,503,746
1000,503,497,489,247,490,737
1000,496,496,502,251,481,732
1000,498,497,526,254,502,756
1000,512,503,530,253,522,775
1000,508,497,490,253,519,772
1000,501,481,529,238,521,759
1000,510,500,486,262,499,761
1000,511,528,491,267,494,761
1000,494,485,504,244,498,742
1000,491,507,505,242,525,767
1000,489,508,486,246,493,739
1000,494,486,481,227,505,732
1000,508,509,497,250,491,741
1000,495,499,490,243,505,748
1000,493,486,481,242,500,742
1000,503,530,472,267,477,744
1000,479,494,522,234,521,755
1000,516,505,499,278,483,761
1000,468,487,502,231,523,754
1000,493,493,504,233,508,741
1000,520,504,526,274,514,788
1000,505,507,488,258,492,750
1000,468,511,488,239,477,716
1000,481,501,518,249,484,733
1000,478,509,498,254,482,736
1000,504,512,507,270,471,741
1000,494,514,521,243,510,753
1000,476,520,478,245,489,734
1000,485,491,497,248,509,757
1000,480,490,498,248,487,735
1000,497,499,501,247,505,752
1000,490,468,474,241,484,725
1000,511,474,507,236,522,758
1000,525,505,507,268,500,768
1000,510,498,503,258,490,748
1000,491,496,519,249,502,751
1000,509,505,500,254,492,746
1000,502,512,501,244,513,757
1000,501,482,518,241,514,755
1000,508,473,514,237,531,768
1000,500,486,487,250,492,742
1000,497,488,510,246,507,753
1000,524,491,493,248,520,768
1000,497,516,508,256,490,746
1000,506,496,499,258,497,755
1000,531,506,522,270,503,773
1000,500,522,521,255,502,757
1000,507,523,503,245,512,757
1000,482,454,502,221,513,734
1000,517,516,452,265,464,729
1000,485,508,506,249,489,738
1000,509,525,515,267,503,770
1000,491,486,512,257,492,749
1000,489,504,472,250,465,715
1000,506,505,523,273,471,744
1000,512,483,513,239,525,764
1000,503,498,483,224,513,737
1000,484,494,504,238,509,747
1000,486,516,491,257,484,741
1000,492,535,513,264,465,729
1000,506,514,526,253,511,764
1000,499,489,500,244,507,751
1000,492,516,497,245,504,749
1000,501,480,493,251,484,735
1000,522,498,505,260,503,763
1000,478,499,470,257,452,709
1000,492,497,490,258,470,728
1000,497,499,512,250,500,750
1000,509,527,510,260,506,766
1000,496,482,507,241,500,741
1000,473,495,491,230,502,732
1000,495,512,487,257,499,756
1000,502,474,488,238,494,732
1000,490,511,519,246,510,756
1000,492,503,482,241,516,757
1000,500,501,507,244,509,753
1000,502,488,488,240,511,751
1000,494,488,468,242,505,747
1000,512,513,506,262,504,766
1000,512,504,509,256,513,769
1000,482,505,507,243,498,741
1000,475,516,493,239,492,731
1000,484,486,484,243,490,733
1000,499,487,519,235,528,763
1000,480,492,512,232,526,758
1000,506,489,537,249,519,768
1000,499,489,491,242,508,750
1000,515,507,491,255,497,752
1000,497,521,509,262,489,751
1000,515,487,476,249,503,752
1000,528,482,483,253,497,750
1000,505,479,490,240,516,756
1000,489,454,487,221,519,740
1000,542,499,524,265,521,786
1000,479,482,517,222,520,742
1000,507,488,498,244,509,753
1000,496,487,498,250,484,734
1000,525,490,492,266,492,758
1000,519,478,512,239,533,772
1000,509,491,504,251,500,751
1000,464,464,488,218,506,724
1000,506,495,486,252,492,744
1000,513,511,486,257,483,740
1000,500,518,515,259,505,764
1000,507,499,479,245,507,752
1000,512,494,491,245,518,763
1000,483,498,476,235,489,724
1000,500,492,508,241,514,755
1000,474,517,466,238,477,715
1000,498,492,494,248,507,755
1000,530,530,503,275,483,758
1000,494,474,507,227,523,750
1000,504,492,492,238,511,749
1000,481,515,496,248,496,744
1000,507,524,506,263,484,747
1000,512,482,482,250,501,751
1000,518,507,490,273,475,748
1000,512,487,514,254,499,753
1000,519,491,491,250,513,763
1000,517,503,493,262,492,754
1000,489,488,485,237,496,733
1000,499,518,519,272,488,760
1000,501,517,530,276,496,772
1000,487,503,498,252,482,734
1000,502,475,492,246,489,735
1000,505,511,484,259,495,754
1000,507,510,469,250,495,745
1000,477,473,510,230,506,736
1000,510,515,482,281,464,745
1000,502,478,479,238,505,743
1000,517,508,475,264,489,753
1000,511,487,498,262,492,754
1000,498,518,502,252,477,729
1000,494,494,491,244,502,746
1000,509,483,520,249,513,762
1000,501,502,527,235,523,758
1000,502,498,498,248,506,754
1000,490,505,508,238,518,756
1000,492,488,520,249,505,754
1000,473,512,491,235,494,729
1000,497,523,514,275,470,745
1000,478,484,473,234,487,721
1000,509,493,517,240,526,766
1000,494,499,505,272,483,755
1000,518,471,488,227,522,749
1000,506,501,516,254,517,771
1000,526,520,491,274,484,758
1000,497,502,515,251,495,746
1000,509,476,499,231,523,754
1000,511,490,499,247,505,752
1000,492,491,493,232,505,737
1000,516,504,512,262,491,753
1000,504,524,490,271,476,747
1000,503,508,499,262,507,769
1000,469,498,506,226,490,716
1000,501,485,498,250,492,742
1000,505,456,502,231,523,754
1000,484,510,472,246,475,721
1000,491,518,524,259,485,744
1000,496,495,488,235,513,748
1000,508,533,512,271,485,756
1000,507,497,514,248,505,753
1000,514,503,495,261,500,761
1000,491,519,512,250,504,754
1000,524,480,502,240,527,767
1000,505,495,497,250,500,750
1000,503,470,494,234,511,745
1000,494,511,496,229,528,757
1000,526,488,485,243,529,772
1000,507,497,501,244,510,754
1000,516,477,499,234,512,746
1000,504,523,496,268,465,733
1000,485,503,486,234,510,744
1000,498,509,493,247,512,759
1000,504,515,511,258,516,774
1000,491,494,463,243,470,713
1000,500,515,503,245,505,750
1000,482,536,467,247,483,730
1000,500,472,500,243,506,749
1000,520,503,513,251,517,768
1000,499,498,492,235,512,747
1000,502,495,484,250,491,741
1000,487,490,514,225,523,748
1000,523,491,509,253,521,774
1000,483,504,532,232,520,752
1000,517,487,498,257,513,770
1000,535,491,483,261,503,764
1000,518,506,513,265,501,766
1000,490,490,495,253,485,738
1000,510,506,511,259,497,756
1000,492,492,511,258,491,749
1000,512,481,494,245,522,767
1000,501,511,500,252,499,751
1000,491,513,499,244,503,747
1000,498,493,502,244,505,749
1000,496,486,526,246,500,746
1000,490,517,514,254,487,741
1000,502,500,533,259,506,765
1000,530,506,517,262,508,770
1000,478,511,499,238,506,744
1000,510,480,487,251,497,748
1000,515,477,517,253,511,764
1000,496,484,482,234,515,749
1000,480,523,529,244,519,763
1000,496,492,479,261,462,723
1000,475,496,489,223,520,743
1000,507,498,501,245,527,772
1000,502,498,515,253,525,778
1000,511,498,473,261,493,754
1000,487,511,512,251,505,756
1000,481,488,508,221,528,749
1000,523,536,504,268,496,764
1000,499,497,508,244,502,746
1000,540,499,504,259,517,776
1000,483,512,529,253,502,755
1000,501,510,521,250,513,763
1000,494,495,490,237,500,737
1000,473,480,501,233,491,724
1000,489,493,506,231,526,757
1000,490,490,478,240,483,723
1000,509,494,499,252,494,746
1000,514,514,504,251,523,774
1000,485,451,492,230,506,736
1000,492,492,505,241,505,746
1000,475,478,468,218,496,714
1000,497,466,513,221,549,770
1000,516,493,521,255,504,759
1000,494,477,496,229,514,743
1000,499,511,478,261,484,745
1000,471,492,510,225,531,756
1000,467,484,524,219,531,750
1000,491,513,502,260,495,755
1000,499,476,508,234,525,759
1000,493,492,487,259,485,744
1000,511,509,518,268,487,755
1000,476,506,491,233,503,736
1000,491,483,506,231,521,752
1000,490,480,482,236,507,743
1000,479,505,510,240,487,727
1000,519,490,474,245,501,746
1000,519,480,503,269,501,770
1000,493,505,508,260,484,744
1000,494,481,492,234,512,746
1000,477,523,517,253,490,743
1000,513,513,519,257,510,767
1000,504,529,491,267,477,744
1000,473,465,528,216,543,759
1000,469,495,523,232,513,745
1000,503,504,456,246,479,725
1000,516,504,495,261,491,752
1000,476,495,514,233,500,733
1000,499,512,494,255,489,744
1000,490,483,491,238,508,746
1000,508,496,488,250,477,727
1000,505,518,503,268,481,749
1000,524,500,518,270,505,775
1000,500,514,511,259,488,747
1000,506,504,485,251,504,755
1000,492,518,511,272,498,770
1000,475,463,494,222,511,733
1000,493,489,489,241,505,746
1000,505,488,502,238,521,759
1000,507,505,489,256,496,752
1000,494,520,454,265,456,721
1000,481,520,484,238,496,734
1000,496,503,490,266,485,751
1000,508,486,510,251,500,751
1000,485,504,495,235,505,740
1000,485,490,476,247,485,732
1000,525,490,486,233,516,749
1000,516,489,501,247,510,757
1000,482,478,486,220,509,729
1000,504,510,481,270,471,741
1000,497,507,514,249,505,754
1000,489,495,506,241,502,743
1000,503,513,489,251,500,751
1000,481,492,483,231,516,747
1000,494,499,508,247,502,749
1000,466,480,510,214,533,747
1000,498,486,470,239,492,731
1000,499,485,513,229,527,756
1000,521,505,506,265,494,759
1000,494,485,518,235,520,755
1000,510,505,510,257,490,747
1000,500,498,481,251,487,738
1000,496,475,508,245,513,758
1000,505,532,508,276,486,762
1000,512,499,479,250,498,748
1000,549,515,504,278,510,788
1000,495,488,493,250,484,734
1000,516,469,488,241,498,739
1000,509,495,515,257,503,760
1000,482,502,506,230,515,745
1000,498,522,470,264,476,740
1000,495,468,537,242,526,768
1000,489,523,488,245,486,731
1000,508,496,524,246,514,760
1000,497,501,464,246,477,723
1000,486,508,517,248,500,748
1000,515,494,508,252,521,773
1000,499,508,490,251,489,740
1000,487,523,522,244,522,766
1000,486,494,501,241,507,748
1000,499,495,494,249,510,759
1000,489,512,511,257,498,755
1000,491,489,483,239,483,722
1000,494,493,489,251,491,742
1000,474,478,500,227,510,737
1000,488,496,523,250,511,761
1000,490,495,494,259,467,726
1000,470,520,491,244,478,722
1000,483,511,480,258,471,729
1000,523,531,534,275,520,795
1000,502,480,476,242,496,738
1000,496,499,503,248,494,742
1000,500,516,500,251,509,760
1000,495,500,516,241,509,750
1000,504,483,505,251,507,758
1000,489,499,526,239,511,750
1000,476,519,467,225,500,725
1000,508,499,479,260,486,746
1000,509,520,468,254,475,729
1000,510,501,494,250,506,756
1000,535,498,502,271,497,768
1000,520,519,496,268,485,753
1000,510,521,503,268,484,752
1000,494,504,475,247,490,737
1000,525,501,516,250,529,779
1000,513,506,524,269,510,779
1000,533,517,494,270,511,781
1000,519,499,496,256,499,755
1000,504,509,505,244,528,772
1000,495,516,530,257,512,769
1000,486,473,504,239,490,729
1000,488,508,489,260,477,737
1000,512,507,492,252,508,760
1000,495,497,477,252,495,747
1000,498,486,503,252,488,740
1000,550,480,464,255,492,747
1000,501,519,490,266,479,745
1000,489,496,466,232,487,719
1000,484,482,488,228,509,737
1000,506,505,503,257,493,750
1000,502,471,487,243,504,747
1000,494,480,505,220,534,754
1000,522,523,507,278,487,765
1000,503,503,487,243,514,757
1000,485,526,495,244,494,738
1000,484,488,485,233,519,752
1000,491,498,496,246,505,751
1000,521,520,535,276,494,770
1000,481,492,493,235,504,739
1000,494,510,464,239,491,730
1000,499,504,530,257,506,763
1000,516,473,511,261,497,758
1000,503,487,492,249,513,762
1000,483,513,492,239,498,737
1000,511,499,479,252,493,745
1000,503,506,502,249,499,748
1000,486,514,493,252,488,740
1000,517,505,456,259,481,740
1000,496,516,501,261,489,750
1000,502,531,490,277,466,743
1000,506,498,504,251,506,757
1000,488,489,482,240,498,738
1000,517,516,507,270,496,766
1000,488,534,469,253,475,728
1000,467,508,502,231,499,730
1000,498,492,499,248,490,738
1000,511,475,494,246,495,741
1000,517,510,496,259,504,763
1000,502,497,510,252,502,754
1000,496,516,494,257,487,744
1000,460,500,467,234,485,719
1000,487,516,498,255,478,733
1000,511,478,498,262,496,758
1000,498,522,499,247,509,756
1000,480,495,536,240,531,771
1000,522,490,498,249,518,767
1000,493,501,478,251,501,752
1000,489,479,484,223,503,726
1000,481,499,501,235,501,736
1000,486,501,516,239,525,764
1000,508,489,515,243,519,762
1000,519,498,508,257,505,762
1000,475,483,532,224,517,741
1000,484,478,502,231,526,757
1000,493,494,501,236,529,765
1000,511,492,487,254,499,753
1000,504,502,462,262,463,725
1000,505,493,496,251,497,748
1000,502,519,470,254,482,736
1000,497,493,500,246,493,739
1000,483,525,495,264,482,746
1000,508,513,507,246,511,757
1000,509,511,497,261,491,752
1000,478,522,498,241,495,736
1000,506,525,514,273,495,768
1000,502,507,477,239,502,741
1000,477,497,505,254,492,746
1000,471,486,503,222,517,739
1000,501,492,491,244,515,759
1000,488,494,518,240,514,754
1000,497,499,482,250,493,743
1000,519,496,496,261,478,739
1000,509,483,515,253,516,769
1000,478,492,480,239,496,735
1000,488,486,505,220,548,768
1000,490,459,498,233,511,744
1000,485,530,488,255,483,738
1000,510,514,492,274,479,753
1000,500,490,479,248,476,724
1000,485,513,494,255,498,753
1000,517,494,502,256,494,750
1000,455,508,527,233,505,738
1000,512,495,469,253,496,749
1000,504,503,520,257,506,763
1000,488,504,501,240,508,748
1000,490,492,500,237,517,754
1000,498,495,512,242,504,746
1000,485,493,502,239,519,758
1000,493,504,472,229,504,733
1000,483,478,520,239,520,759
1000,499,479,484,234,514,748
1000,505,517,500,262,495,757
1000,498,501,482,254,483,737
1000,483,507,481,247,481,728
1000,508,500,503,256,490,746
1000,504,509,482,259,483,742
1000,497,501,490,254,485,739
1000,519,495,530,247,534,781
1000,473,512,510,247,499,746
1000,508,513,497,248,509,757
1000,502,484,476,236,500,736
1000,494,500,505,239,514,753
1000,505,517,475,266,481,747
1000,483,505,511,241,526,767
1000,512,502,511,256,506,762
1000,478,508,485,243,485,728
1000,506,509,507,261,493,754
1000,507,502,534,258,531,789
1000,512,492,491,233,522,755
1000,498,532,473,273,472,745
1000,491,523,539,258,500,758
1000,484,511,495,231,515,746
1000,499,506,504,257,509,766
1000,470,504,491,215,513,728
1000,510,480,474,241,503,744
1000,514,492,501,248,512,760
1000,496,528,492,266,483,749
1000,511,483,519,260,503,763
1000,506,531,513,262,499,761
1000,507,510,510,249,515,764
1000,483,500,477,243,481,724
1000,488,509,497,242,513,755
1000,472,476,494,221,511,732
1000,505,501,494,257,488,745
1000,524,497,506,267,514,781
1000,500,475,520,247,508,755
1000,522,508,505,272,498,770
1000,522,468,516,252,527,779
1000,494,503,479,237,485,722
1000,487,494,513,240,524,764
1000,498,519,501,262,488,750
1000,516,491,512,270,480,750
1000,502,485,510,239,513,752
1000,503,497,503,253,498,751
1000,481,472,475,230,507,737
1000,510,502,510,265,488,753
1000,554,491,505,270,517,787
1000,475,515,490,244,489,733
1000,504,487,495,248,502,750
1000,492,494,510,259,492,751
1000,493,496,525,237,530,767
1000,489,497,527,254,504,758
1000,497,472,503,241,504,745
1000,479,528,524,264,496,760
1000,529,467,500,252,518,770
1000,547,505,502,277,497,774
1000,515,491,515,266,498,764
1000,500,496,519,228,532,760
1000,507,491,488,256,503,759
1000,517,486,500,255,494,749
1000,505,501,508,253,518,771
1000,470,498,510,227,519,746
1000,495,517,480,264,464,728
1000,486,508,482,240,494,734
1000,486,526,510,253,507,760
1000,502,527,503,270,490,760
1000,496,493,501,253,494,747
1000,488,545,512,264,480,744
1000,480,501,493,242,493,735
1000,494,480,488,235,493,728
1000,490,487,494,228,524,752
1000,495,491,514,247,517,764
1000,488,456,489,234,519,753
1000,500,438,511,218,533,751
1000,511,518,482,269,470,739
1000,494,502,522,258,493,751
1000,497,531,524,269,499,768
1000,484,501,511,234,514,748
1000,503,486,504,255,488,743
1000,491,508,496,253,502,755
1000,478,486,501,241,500,741
1000,521,499,518,253,514,767
1000,478,514,474,231,493,724
1000,489,499,529,248,514,762
1000,485,515,500,237,527,764
1000,521,501,509,252,506,758
1000,494,514,520,248,504,752
1000,497,495,485,241,510,751
1000,490,518,521,241,530,771
1000,501,496,474,243,499,742
1000,484,501,490,246,504,750
1000,495,541,512,279,488,767
1000,503,496,527,248,535,783
1000,517,526,523,267,505,772
1000,512,514,514,260,500,760
1000,504,490,504,240,507,747
1000,504,501,499,258,498,756
1000,492,513,490,249,489,738
1000,490,521,485,264,482,746
1000,508,518,513,269,480,749
1000,502,484,494,242,498,740
1000,512,493,485,263,489,752
1000,491,504,484,236,502,738
1000,489,502,493,240,493,733
1000,481,479,498,227,521,748
1000,515,525,506,259,505,764
1000,519,480,466,260,474,734
1000,498,522,503,247,508,755
1000,507,502,513,252,515,767
1000,508,515,505,252,497,749
1000,514,501,473,261,475,736
1000,507,490,486,252,509,761
1000,504,536,501,278,462,740
1000,493,533,490,271,461,732
1000,493,529,525,258,500,758
1000,499,490,507,241,519,760
1000,523,517,486,252,485,737
1000,479,474,506,230,509,739
1000,519,507,474,257,494,751
1000,524,466,498,250,527,777
1000,490,508,517,249,500,749
1000,499,485,498,242,519,761
1000,508,482,497,244,508,752
1000,481,498,487,238,513,751
1000,491,495,520,245,516,761
1000,507,516,515,271,486,757
1000,499,508,516,266,481,747
1000,517,491,475,255,489,744
1000,471,500,500,221,504,725
1000,482,499,510,239,506,745
1000,466,525,524,246,509,755
1000,494,495,489,248,501,749
1000,498,516,492,260,489,749
1000,474,485,504,225,516,741
1000,519,476,494,245,515,760
1000,513,511,499,267,491,758
1000,531,502,517,264,514,778
1000,514,489,506,257,517,774
1000,501,480,486,241,492,733
1000,497,502,501,242,503,745
1000,488,482,516,224,521,745
1000,541,511,517,281,507,788
1000,488,476,506,221,516,737
1000,476,495,501,227,520,747
1000,526,490,503,269,502,771
1000,507,516,491,268,470,738
1000,514,496,490,266,484,750
1000,497,505,510,258,510,768
1000,503,494,528,237,519,756
1000,530,495,513,249,516,765
1000,477,529,465,258,453,711
1000,503,527,506,254,505,759
1000,481,490,526,223,522,745
1000,483,492,496,238,501,739
1000,499,483,512,240,522,762
1000,511,505,487,268,462,730
1000,492,505,522,236,514,750
1000,485,471,502,233,514,747
1000,472,504,492,234,495,729
1000,492,523,489,276,463,739
1000,500,496,488,255,485,740
1000,503,520,525,245,533,778
1000,473,508,497,247,481,728
1000,505,502,486,250,501,751
1000,502,499,484,251,491,742
1000,521,509,499,256,507,763
1000,520,520,483,274,475,749
1000,511,506,485,261,475,736
1000,516,498,517,252,524,776
1000,487,504,504,247,496,743
1000,510,474,522,253,515,768
1000,500,535,502,251,496,747
1000,513,482,480,244,497,741
1000,510,525,504,263,493,756
1000,493,470,506,243,510,753
1000,502,481,488,232,512,744
1000,505,490,533,249,533,782
1000,470,494,523,243,505,748
1000,491,498,482,256,467,723
1000,475,467,491,222,507,729
1000,485,514,493,244,498,742
1000,460,508,484,246,478,724
1000,488,527,508,263,478,741
1000,509,493,527,251,528,779
1000,523,505,505,255,507,762
1000,508,489,499,256,496,752
1000,531,486,490,263,502,765
1000,520,479,496,246,515,761
1000,512,496,487,268,485,753
1000,506,526,506,261,490,751
1000,519,515,499,270,502,772
1000,479,507,525,239,523,762
1000,521,524,470,279,464,743
1000,538,492,472,262,507,769
1000,491,517,493,246,491,737
1000,506,510,489,274,486,760
1000,494,500,514,242,498,740
1000,483,490,527,252,506,758
1000,480,515,517,248,491,739
1000,506,525,514,264,491,755
1000,509,515,490,265,481,746
1000,499,515,497,257,494,751
1000,490,501,509,250,493,743
1000,489,474,487,238,520,758
1000,499,485,495,233,514,747
1000,495,497,472,248,497,745
1000,469,498,510,225,520,745
1000,478,503,492,234,505,739
1000,488,515,490,253,479,732
1000,507,495,513,258,496,754
1000,473,487,481,226,491,717
1000,488,509,513,250,496,746
1000,495,500,516,254,490,744
1000,483,528,495,268,473,741
1000,495,502,509,238,520,758
1000,494,493,500,247,507,754
1000,511,522,514,262,505,767
1000,502,514,522,259,509,768
1000,525,493,495,245,524,769
1000,521,514,503,261,501,762
1000,502,527,527,266,501,767
1000,516,521,522,277,496,773
1000,510,499,507,251,508,759
1000,523,526,511,265,517,782
1000,484,508,514,241,504,745
1000,523,479,504,256,498,754
1000,472,489,494,234,497,731
1000,486,482,492,224,508,732
1000,493,515,494,253,485,738
1000,498,485,501,242,512,754
1000,500,477,487,230,521,751
1000,501,508,532,253,518,771
1000,514,495,493,248,510,758
1000,520,484,489,256,497,753
1000,534,479,490,258,498,756
1000,471,507,484,236,493,729
1000,490,501,526,232,534,766
1000,517,495,498,261,491,752
1000,488,492,508,244,490,734
1000,496,521,502,265,479,744
1000,530,532,494,288,471,759
1000,518,527,508,270,483,753
1000,495,501,491,252,489,741
1000,509,472,529,236,523,759
1000,508,476,503,241,517,758
1000,536,494,511,274,484,758
1000,523,506,530,268,507,775
1000,477,496,496,241,495,736
1000,503,503,472,253,490,743
1000,499,507,514,268,495,763
1000,473,528,475,251,463,714
1000,512,478,504,240,526,766
1000,488,476,499,235,516,751
1000,511,497,517,242,525,767
1000,507,492,510,257,504,761
1000,487,530,503,269,481,750
1000,475,499,500,227,511,738
1000,506,504,520,251,511,762
1000,495,501,502,241,503,744
1000,498,529,510,268,495,763
1000,526,521,492,270,481,751
1000,481,523,471,242,487,729
1000,524,524,518,278,488,766
1000,510,507,497,253,519,772
1000,479,490,503,233,525,758
1000,508,507,518,255,502,757
1000,488,520,515,255,502,757
1000,503,505,540,261,514,775
1000,485,527,500,251,491,742
1000,467,482,504,221,518,739
1000,460,506,503,222,516,738
1000,508,506,468,263,472,735
1000,486,474,507,238,515,753
1000,508,484,498,237,513,750
1000,490,515,504,254,496,750
1000,490,512,494,250,498,748
1000,492,495,511,225,529,754
1000,526,497,491,269,482,751
1000,524,513,481,266,479,745
1000,499,476,510,244,515,759
1000,519,471,503,247,526,773
1000,512,485,513,240,530,770
1000,517,510,486,280,468,748
1000,506,488,484,252,490,742
1000,494,503,483,260,489,749
1000,502,488,495,242,522,764
1000,484,503,502,236,500,736
1000,495,496,511,248,506,754
1000,512,482,504,254,500,754
1000,527,506,532,257,530,787
1000,502,495,517,236,530,766
1000,494,498,514,239,512,751
1000,517,497,469,267,476,743
1000,490,513,466,251,474,725
1000,510,528,490,279,470,749
1000,487,470,495,235,508,743
1000,482,471,509,222,516,738
1000,498,501,481,248,491,739
1000,487,500,478,238,490,728
1000,507,504,530,263,513,776
1000,508,511,495,264,494,758
1000,465,508,484,235,486,721
1000,492,515,500,258,489,747
1000,474,509,510,233,519,752
1000,486,469,473,238,479,717
1000,495,503,474,249,487,736
1000,498,495,514,244,531,775
1000,492,505,503,234,515,749
1000,507,488,490,240,512,752
1000,486,473,526,226,534,760
1000,459,501,509,242,501,743
1000,506,507,483,263,488,751
1000,492,512,497,259,497,756
1000,475,525,510,253,476,729
1000,488,489,518,230,529,759
1000,501,515,504,255,504,759
1000,497,511,500,251,496,747
1000,509,481,489,259,487,746
1000,474,478,487,223,517,740
1000,518,514,494,260,492,752
1000,491,493,505,236,506,742
1000,465,494,518,230,525,755
1000,499,497,496,240,516,756
1000,493,480,475,233,503,736
1000,497,496,482,241,494,735
1000,518,483,494,238,511,749
1000,504,489,512,231,518,749
1000,517,509,495,267,476,743
1000,492,532,510,247,501,748
1000,500,495,502,242,510,752
1000,514,497,485,254,493,747
1000,531,525,525,290,513,803
1000,473,503,481,240,485,725
1000,506,494,465,245,488,733
1000,488,520,492,253,484,737
1000,521,490,519,257,513,770
1000,487,514,512,245,513,758
1000,515,472,527,246,518,764
1000,484,495,486,252,479,731
1000,523,500,495,273,473,746
1000,521,508,504,272,469,741
1000,469,492,487,225,504,729
1000,490,482,468,238,497,735
1000,486,485,483,237,486,723
1000,481,492,502,251,492,743
1000,498,492,508,243,501,744
1000,509,526,528,275,493,768
1000,482,506,524,235,532,767
1000,512,511,505,269,479,748
1000,501,472,531,232,523,755
1000,516,452,494,233,526,759
1000,499,512,497,253,499,752
1000,517,516,495,262,496,758
1000,468,497,491,234,503,737
1000,503,502,526,260,523,783
1000,497,484,479,236,502,738
1000,514,495,509,254,506,760
1000,513,481,487,244,500,744
1000,494,503,524,256,513,769
1000,489,514,496,256,507,763
1000,518,521,482,275,467,742
1000,515,496,498,254,515,769
1000,502,495,549,248,514,762
1000,487,502,481,252,480,732
1000,495,493,527,251,515,766
1000,483,544,477,265,476,741
1000,516,484,520,262,494,756
1000,499,488,511,229,515,744
1000,507,491,497,245,509,754
1000,474,523,522,244,517,761
1000,523,478,504,251,518,769
1000,488,501,511,242,516,758
1000,520,498,515,260,504,764
1000,484,478,520,236,523,759
1000,498,492,485,257,477,734
1000,495,501,492,249,508,757
1000,492,470,506,229,519,748
1000,501,524,487,264,474,738
1000,516,499,504,243,496,739
1000,484,485,454,233,477,710
1000,487,514,499,243,505,748
1000,511,505,470,242,494,736
1000,492,485,501,234,500,734
1000,499,487,485,243,492,735
1000,525,501,504,260,501,761
1000,535,488,481,257,489,746
1000,466,508,516,232,520,752
1000,498,500,521,253,503,756
1000,500,489,517,247,514,761
1000,492,518,481,245,493,738
1000,489,482,519,246,497,743
1000,542,522,500,287,488,775
1000,495,493,498,249,499,748
1000,507,472,477,239,497,736
1000,521,494,497,259,498,757
1000,485,481,508,223,526,749
1000,492,457,507,220,530,750
1000,510,485,507,237,516,753
1000,517,510,500,266,490,756
1000,512,491,474,251,501,752
1000,506,498,506,257,510,767
1000,507,504,503,241,514,755
1000,470,505,496,240,507,747
1000,512,459,487,237,500,737
1000,490,530,487,252,493,745
1000,516,497,525,242,528,770
1000,484,525,524,258,489,747
1000,484,495,468,232,496,728
1000,476,465,502,226,512,738
1000,476,460,500,217,517,734
1000,495,498,524,250,499,749
1000,495,509,497,251,494,745
1000,504,498,481,260,489,749
1000,492,503,490,250,499,749
1000,505,529,501,272,468,740
1000,496,508,510,253,500,753
1000,532,512,502,281,477,758
1000,504,483,520,248,510,758
1000,517,529,498,284,476,760
1000,527,521,487,288,460,748
1000,511,522,494,269,481,750
1000,498,519,501,248,510,758
1000,499,472,523,235,536,771
1000,501,491,503,244,523,767
1000,484,497,492,243,502,745
1000,512,508,489,261,485,746
1000,504,500,510,247,514,761
1000,494,519,508,248,492,740
1000,496,526,526,238,524,762
1000,498,528,478,260,482,742
1000,489,518,467,249,471,720
1000,488,504,485,241,484,725
1000,508,491,524,238,529,767
1000,478,475,483,229,503,732
1000,511,509,501,264,489,753
1000,508,485,493,256,489,745
1000,509,510,486,252,496,748
1000,477,481,490,236,509,745
1000,495,523,505,261,476,737
1000,505,503,524,256,519,775
1000,498,511,503,250,502,752
1000,496,518,484,259,484,743
1000,501,488,488,245,503,748
1000,520,480,467,250,492,742
1000,505,494,485,248,508,756
1000,514,495,510,263,501,764
1000,525,465,496,241,521,762
1000,501,501,502,244,513,757
1000,501,491,473,252,491,743
1000,506,495,499,269,484,753
1000,500,489,469,242,490,732
1000,474,484,475,236,487,723
1000,519,493,499,254,499,753
1000,498,506,510,257,498,755
1000,502,495,502,266,483,749
1000,489,497,486,244,496,740
1000,495,502,477,260,462,722
1000,490,504,492,246,485,731
1000,473,492,478,231,491,722
1000,499,522,511,274,477,751
1000,500,489,481,230,510,740
1000,510,520,510,283,478,761
1000,498,515,512,257,490,747
1000,498,488,485,247,486,733
1000,495,497,509,245,501,746
1000,500,531,507,265,482,747
1000,517,511,503,256,500,756
1000,480,494,492,240,503,743
1000,489,495,493,233,513,746
1000,486,513,480,249,483,732
1000,499,504,478,264,471,735
1000,475,515,502,243,490,733
1000,500,525,520,260,488,748
1000,504,504,503,246,519,765
1000,467,495,493,237,500,737
1000,510,478,501,245,512,757
1000,489,503,530,240,524,764
1000,504,514,542,265,516,781
1000,502,521,524,263,491,754
1000,493,491,482,243,511,754
1000,485,512,516,264,469,733
1000,507,486,483,236,502,738
1000,513,488,514,256,498,754
1000,494,507,498,245,509,754
1000,517,521,482,292,453,745
1000,516,501,491,257,497,754
1000,492,487,480,240,487,727
1000,527,498,512,264,500,764
1000,501,507,519,267,496,763
1000,503,489,518,248,513,761
1000,499,504,481,256,492,748
1000,486,482,532,228,516,744
1000,509,519,512,268,497,765
1000,519,506,514,254,512,766
1000,501,494,480,234,504,738
1000,483,492,508,234,515,749
1000,517,495,490,262,488,750
1000,508,493,505,243,520,763
1000,495,487,498,235,533,768
1000,520,499,492,258,494,752
1000,504,517,481,250,491,741
1000,500,507,513,239,537,776
1000,508,510,495,257,495,752
1000,500,512,502,263,502,765
1000,520,504,494,259,491,750
1000,474,501,499,248,479,727
1000,495,503,463,249,480,729
1000,514,496,520,264,511,775
1000,501,493,480,244,496,740
1000,493,483,525,241,511,752
1000,523,503,505,264,505,769
1000,483,505,479,232,485,717
1000,489,477,499,240,508,748
1000,479,488,484,234,500,734
1000,496,489,496,233,518,751
1000,498,496,507,251,484,735
1000,491,496,519,244,506,750
1000,487,490,518,252,509,761
1000,524,485,487,248,513,761
1000,503,492,487,249,508,757
1000,483,507,489,261,474,735
1000,485,521,488,241,483,724
1000,504,489,499,242,514,756
1000,479,529,498,257,502,759
1000,494,497,471,244,481,725
1000,480,477,488,221,512,733
1000,504,475,510,235,526,761
1000,508,474,497,237,506,743
1000,468,503,501,231,504,735
1000,479,514,483,235,490,725
1000,529,465,489,246,516,762
1000,465,486,488,233,503,736
1000,513,507,511,254,502,756
1000,531,500,502,262,502,764
1000,507,498,500,243,508,751
1000,514,500,521,247,530,777
1000,501,518,518,257,493,750
1000,514,509,463,264,485,749
1000,490,484,495,238,509,747
1000,462,487,501,226,518,744
1000,481,511,498,242,490,732
1000,506,498,520,240,529,769
1000,468,487,525,230,517,747
1000,506,497,483,257,485,742
1000,486,503,500,240,507,747
1000,505,511,515,263,491,754
1000,463,502,504,235,495,730
1000,501,491,508,240,523,763
1000,496,508,516,243,527,770
1000,495,518,511,256,504,760
1000,526,480,491,243,489,732
1000,519,502,492,271,486,757
1000,494,528,518,249,507,756
1000,493,482,484,238,510,748
1000,481,513,484,267,475,742
1000,508,505,498,254,497,751
1000,506,506,461,251,491,742
1000,503,494,485,244,491,735
1000,519,507,510,257,510,767
1000,505,513,484,266,475,741
1000,491,511,526,251,508,759
1000,505,533,486,254,490,744
1000,490,482,505,226,512,738
1000,511,488,501,247,515,762
1000,514,494,504,251,524,775
1000,529,517,475,269,483,752
1000,520,520,501,280,489,769
1000,516,481,515,244,520,764
1000,499,512,535,255,502,757
1000,496,483,525,243,517,760
1000,481,504,479,238,471,709
1000,532,469,493,252,513,765
1000,492,505,510,257,487,744
1000,519,482,509,238,527,765
1000,525,492,526,257,514,771
1000,499,491,509,242,522,764
1000,530,487,489,258,499,757
1000,507,498,515,245,515,760
1000,466,521,463,237,485,722
1000,499,523,499,260,484,744
1000,521,545,511,280,496,776
1000,494,464,508,230,521,751
1000,498,519,503,267,473,740
1000,495,496,478,241,510,751
1000,490,482,495,228,516,744
1000,507,497,480,262,484,746
1000,474,501,525,226,518,744
1000,494,477,503,241,522,763
1000,490,502,504,245,501,746
1000,472,492,508,238,495,733
1000,487,502,481,236,497,733
1000,500,495,502,250,488,738
1000,486,520,514,259,489,748
1000,499,507,490,268,467,735
1000,481,519,498,256,478,734
1000,538,470,484,251,508,759
1000,519,486,480,268,489,757
1000,496,487,481,245,474,719
1000,498,485,501,232,520,752
1000,494,519,519,259,494,753
1000,490,493,518,237,516,753
1000,528,480,534,245,542,787
1000,477,503,509,235,518,753
1000,524,505,495,272,477,749
1000,515,488,513,238,523,761
1000,495,475,496,225,505,730
1000,506,477,493,239,506,745
1000,487,512,527,247,515,762
1000,464,505,451,236,457,693
1000,513,505,489,257,487,744
1000,503,468,516,238,526,764
1000,487,509,493,254,486,740
1000,486,517,510,248,500,748
1000,507,514,525,252,512,764
1000,476,506,504,239,500,739
1000,491,502,513,246,510,756
1000,489,518,516,240,509,749
1000,507,478,503,244,516,760
1000,503,493,502,240,510,750
1000,481,499,493,247,482,729
1000,506,497,508,230,531,761
1000,509,508,498,252,514,766
1000,496,494,519,239,530,769
1000,506,508,469,245,485,730
1000,500,498,511,256,504,760
1000,506,492,474,245,496,741
1000,503,474,508,243,511,754
1000,481,504,506,245,497,742
1000,529,495,510,272,506,778
1000,489,511,491,252,489,741
1000,500,482,517,241,522,763
1000,532,498,502,273,504,777
1000,503,475,487,244,506,750
1000,486,472,504,239,506,745
1000,471,486,492,231,490,721
1000,510,498,485,244,509,753
1000,516,547,508,292,478,770
1000,467,504,481,241,475,716
1000,482,497,465,250,477,727
1000,490,486,509,232,515,747
1000,508,511,497,246,506,752
1000,523,515,493,277,484,761
1000,505,540,488,280,460,740
1000,507,506,502,247,500,747
1000,490,476,513,225,507,732
1000,487,518,492,247,486,733
1000,501,488,499,233,515,748
1000,479,498,499,244,487,731
1000,506,487,480,240,508,748
1000,520,519,495,267,485,752
1000,507,492,495,238,509,747
1000,507,491,513,252,512,764
1000,502,495,472,259,462,721
1000,489,499,500,236,509,745
1000,527,505,492,276,484,760
1000,496,505,518,251,513,764
1000,513,487,471,253,497,750
1000,498,507,483,254,483,737
1000,499,494,522,256,496,752
1000,509,484,512,253,514,767
1000,506,470,491,251,507,758
1000,508,497,472,241,499,740
1000,502,501,517,264,519,783
1000,492,511,488,256,491,747
1000,529,466,490,260,501,761
1000,493,523,505,269,477,746
1000,501,493,490,240,511,751
1000,524,517,475,279,475,754
1000,502,507,498,263,495,758
1000,480,449,517,227,521,748
1000,497,507,520,258,493,751
1000,508,509,495,255,514,769
1000,510,506,528,249,530,779
1000,503,524,494,255,502,757
1000,467,508,522,228,525,753
1000,518,492,504,250,511,761
1000,495,508,497,245,506,751
1000,508,492,493,250,492,742
1000,503,499,507,258,497,755
1000,483,498,523,243,514,757
1000,499,508,502,245,520,765
1000,490,499,505,253,491,744
1000,510,504,487,251,499,750
1000,490,500,510,251,497,748
1000,522,477,483,248,502,750
1000,494,505,500,244,502,746
1000,485,473,478,219,508,727
1000,493,525,506,270,463,733
1000,490,509,482,239,499,738
1000,494,476,495,231,522,753
1000,507,479,491,231,513,744
1000,498,494,496,240,510,750
1000,516,492,485,259,497,756
1000,483,469,502,223,511,734
1000,505,497,492,252,493,745
1000,516,534,490,283,470,753
1000,498,491,525,247,533,780
1000,503,502,511,254,505,759
1000,476,502,486,244,483,727
1000,504,482,462,243,494,737
1000,490,496,504,245,506,751
1000,512,495,490,248,504,752
1000,453,505,502,231,492,723
1000,551,543,473,303,461,764
1000,516,486,500,255,503,758
1000,518,453,503,239,529,768
1000,509,514,467,259,475,734
1000,503,537,512,275,472,747
1000,504,495,491,244,505,749
1000,485,496,497,248,500,748
1000,496,505,484,255,488,743
1000,483,487,495,246,495,741
1000,497,487,490,242,502,744
1000,483,483,518,208,546,754
1000,497,482,544,233,518,751
1000,490,532,502,252,487,739
1000,525,518,495,281,483,764
1000,514,525,509,274,480,754
1000,489,507,512,264,494,758
1000,491,498,506,238,517,755
1000,502,489,482,243,501,744
1000,497,521,534,258,521,779
1000,494,510,476,248,486,734
1000,474,496,506,231,518,749
1000,486,497,496,237,498,735
1000,500,496,512,258,502,760
1000,518,492,512,243,515,758
1000,485,492,503,236,513,749
1000,500,483,515,242,510,752
1000,485,498,525,255,490,745
1000,531,518,521,252,528,780
1000,497,485,503,231,517,748
1000,525,464,531,246,532,778
1000,495,535,498,261,485,746
1000,503,505,486,243,501,744
1000,500,526,511,255,501,756
1000,496,542,480,277,468,745
1000,463,498,472,218,507,725
1000,512,526,485,275,464,739
1000,500,503,465,259,465,724
1000,481,514,499,249,487,736
1000,480,473,522,235,529,764
1000,532,483,498,259,494,753
1000,506,515,495,260,485,745
1000,514,499,493,251,497,748
1000,511,489,492,258,496,754
1000,499,532,486,271,475,746
1000,525,466,490,244,514,758
1000,486,493,477,243,479,722
1000,489,489,483,242,495,737
1000,491,467,500,232,507,739
1000,525,514,501,258,515,773
1000,468,524,505,242,482,724
1000,495,500,531,251,511,762
1000,481,510,485,262,463,725
1000,521,474,531,236,549,785
1000,518,508,495,254,522,776
1000,500,474,495,232,503,735
1000,488,542,506,266,478,744
1000,496,501,513,236,528,764
1000,507,497,508,263,482,745
1000,498,501,498,249,497,746
1000,528,502,516,265,506,771
1000,511,477,517,237,526,763
1000,502,499,525,251,501,752
1000,495,501,526,259,500,759
1000,479,484,495,228,513,741
1000,482,506,484,252,483,735
1000,468,498,491,231,505,736
1000,525,495,511,271,502,773
1000,474,502,489,238,490,728
1000,523,486,489,252,505,757
1000,502,490,491,256,496,752
1000,480,513,518,239,504,743
1000,508,487,505,254,506,760
1000,516,505,494,267,485,752
1000,501,494,499,250,497,747
1000,493,467,488,228,513,741
1000,504,496,507,259,497,756
1000,516,516,508,270,496,766
1000,531,506,528,268,524,792
1000,478,455,525,221,520,741
1000,494,477,515,250,512,762
1000,478,520,508,238,489,727
1000,481,514,489,246,475,721
1000,475,504,489,224,519,743
1000,509,496,495,256,499,755
1000,503,497,502,247,506,753
1000,476,476,506,227,506,733
1000,491,484,507,235,524,759
1000,506,489,490,237,519,756
1000,496,493,475,245,500,745
1000,480,485,504,232,509,741
1000,498,526,519,258,505,763
1000,513,520,513,267,487,754
1000,517,491,506,259,503,762
1000,486,503,512,229,517,746
1000,503,534,523,260,503,763
1000,481,489,523,244,519,763
1000,491,499,507,250,497,747
1000,507,530,502,274,471,745
1000,511,525,479,265,493,758
1000,513,492,464,241,489,730
1000,503,498,501,254,486,740
1000,520,477,518,265,514,779
1000,480,504,494,240,483,723
1000,488,502,499,257,503,760
1000,507,524,498,268,484,752
1000,487,505,491,236,494,730
1000,506,486,504,248,507,755
1000,484,510,503,240,511,751
1000,485,500,527,245,510,755
1000,486,502,516,244,494,738
1000,488,498,490,252,498,750
1000,507,479,521,246,512,758
1000,501,480,477,235,504,739
1000,499,496,492,263,485,748
1000,487,480,527,232,519,751
1000,507,485,501,253,493,746
1000,496,472,527,225,538,763
1000,493,507,471,249,488,737
1000,481,490,496,234,500,734
1000,469,504,481,230,492,722
1000,503,519,488,260,488,748
1000,483,504,515,227,524,751
1000,504,505,488,258,488,746
1000,513,503,504,260,501,761
1000,527,499,486,276,477,753
1000,504,490,528,250,508,758
1000,503,468,509,233,523,756
1000,507,498,502,274,476,750
1000,498,502,521,248,508,756
1000,486,504,495,249,493,742
1000,505,519,486,252,494,746
1000,493,505,492,250,496,746
1000,493,524,489,268,469,737
1000,487,530,484,269,459,728
1000,493,511,501,246,511,757
1000,522,525,522,256,521,777
1000,500,485,507,248,504,752
1000,516,485,506,232,524,756
1000,474,514,507,242,501,743
1000,495,507,517,247,507,754
1000,493,504,472,249,492,741
1000,483,501,492,241,486,727
1000,465,506,503,231,489,720
1000,494,476,510,245,507,752
1000,485,467,456,214,504,718
1000,502,523,504,273,477,750
1000,520,496,499,262,494,756
1000,472,513,519,249,503,752
1000,493,488,482,237,494,731
1000,499,499,505,250,503,753
1000,498,519,510,257,493,750
1000,504,503,486,264,478,742
1000,511,501,510,262,492,754
1000,493,490,507,231,521,752
1000,502,506,510,246,510,756
1000,464,498,490,235,503,738
1000,508,475,512,243,515,758
1000,486,482,493,222,515,737
1000,478,495,556,229,564,793
1000,489,503,479,249,489,738
1000,483,514,499,258,477,735
1000,496,498,497,247,492,739
1000,476,493,496,225,523,748
1000,521,516,500,276,488,764
1000,519,514,528,275,508,783
1000,498,497,524,249,510,759
1000,501,501,492,251,497,748
1000,506,506,513,245,524,769
1000,477,495,485,227,505,732
1000,510,503,513,239,522,761
1000,495,492,507,244,521,765
1000,504,503,492,245,511,756
1000,507,488,491,237,518,755
1000,501,506,476,269,475,744
1000,506,504,511,273,490,763
1000,493,519,466,255,477,732
1000,490,501,487,238,493,731
1000,490,483,493,241,495,736
1000,503,506,500,250,507,757
1000,501,492,480,247,495,742
1000,499,512,505,263,490,753
1000,514,506,492,261,498,759
1000,517,476,513,241,527,768
1000,498,502,478,252,488,740
1000,501,496,519,235,529,764
1000,497,505,523,256,489,745
1000,516,490,504,264,490,754
1000,522,518,522,276,489,765
1000,531,484,499,252,515,767
1000,518,475,514,244,516,760
1000,486,498,527,256,519,775
1000,491,524,506,264,486,750
1000,502,504,470,250,483,733
1000,502,492,493,264,470,734
1000,473,492,499,234,502,736
1000,500,497,466,252,480,732
1000,481,517,498,257,477,734
1000,484,530,487,247,501,748
1000,504,487,482,238,497,735
1000,514,504,523,259,523,782
1000,491,505,473,245,478,723
1000,504,517,492,265,494,759
1000,505,511,529,253,515,768
1000,491,524,510,250,485,735
1000,530,484,471,253,500,753
1000,467,510,531,222,527,749
1000,493,498,509,231,519,750
1000,527,482,517,241,526,767
1000,506,493,487,257,487,744
1000,479,502,489,227,494,721
1000,520,491,502,259,506,765
1000,509,505,491,270,476,746
1000,476,489,520,229,518,747
1000,491,493,499,241,490,731
1000,504,509,474,258,496,754
1000,493,531,522,245,510,755
1000,519,500,490,285,473,758
1000,493,502,505,255,479,734
1000,504,487,494,237,512,749
1000,470,531,464,252,459,711
1000,498,479,487,240,504,744
1000,492,519,499,265,481,746
1000,498,485,503,240,520,760
1000,501,524,514,262,500,762
1000,494,515,510,264,487,751
1000,512,512,515,261,499,760
1000,525,510,510,270,496,766
1000,517,503,469,251,496,747
1000,512,493,492,245,486,731
1000,499,561,498,293,462,755
1000,507,478,501,246,494,740
1000,496,474,499,236,504,740
1000,491,507,484,239,503,742
1000,493,507,513,254,497,751
1000,476,502,518,230,528,758
1000,521,499,529,246,535,781
1000,479,494,475,223,513,736
1000,497,511,519,244,509,753
1000,478,475,499,225,507,732
1000,489,497,468,256,472,728
1000,500,489,501,242,506,748
1000,488,481,506,232,515,747
1000,526,522,533,273,505,778
1000,509,497,501,269,496,765
1000,489,470,482,226,499,725
1000,502,496,506,260,497,757
1000,485,497,509,236,514,750
1000,510,507,488,246,512,758
1000,504,520,480,260,483,743
1000,524,513,483,266,495,761
1000,487,521,488,257,496,753
1000,514,476,475,230,502,732
1000,545,504,474,268,490,758
1000,512,489,514,252,530,782
1000,495,514,483,259,482,741
1000,505,476,495,224,515,739
1000,494,503,501,255,494,749
1000,501,502,475,247,495,742
1000,488,481,500,233,521,754
1000,471,525,492,248,484,732
1000,507,481,495,244,493,737
1000,499,498,502,244,515,759
1000,508,496,520,263,506,769
1000,512,525,498,266,483,749
1000,508,503,492,255,483,738
1000,481,488,522,223,536,759
1000,494,512,510,255,498,753
1000,501,487,487,244,506,750
1000,479,491,481,225,517,742
1000,483,519,494,256,479,735
1000,509,490,465,233,506,739
1000,511,515,468,266,482,748
1000,496,503,498,240,522,762
1000,484,491,479,236,493,729
1000,499,511,505,263,462,725
1000,500,501,519,248,508,756
1000,528,517,501,265,500,765
1000,469,493,485,233,499,732
1000,516,474,523,259,527,786
1000,501,495,505,258,500,758
1000,466,495,486,224,490,714
1000,521,505,490,260,491,751
1000,488,502,484,232,488,720
1000,489,474,483,233,508,741
1000,511,502,485,260,504,764
1000,520,477,511,240,541,781
1000,494,480,473,249,485,734
1000,509,492,473,249,485,734
1000,477,484,519,241,501,742
1000,531,515,503,273,487,760
1000,493,501,511,253,499,752
1000,515,474,496,238,524,762
1000,509,511,484,268,476,744
1000,488,505,510,263,489,752
1000,482,477,494,228,521,749
1000,491,517,504,252,505,757
1000,529,498,490,251,512,763
1000,506,484,489,253,498,751
1000,501,489,511,259,500,759
1000,484,488,507,245,500,745
1000,482,480,492,238,513,751
1000,497,516,528,256,501,757
1000,482,523,497,245,502,747
1000,516,510,505,262,488,750
1000,464,507,505,229,507,736
1000,515,500,497,272,487,759
1000,509,501,523,254,516,770
1000,501,511,495,256,498,754
1000,520,466,488,240,507,747
1000,516,464,512,232,542,774
1000,501,503,489,260,485,745
1000,494,514,479,258,462,720
1000,481,516,488,241,505,746
1000,486,513,479,259,480,739
1000,494,478,516,248,512,760
1000,500,485,466,251,488,739
1000,492,511,498,250,497,747
1000,504,492,484,245,515,760
1000,521,480,484,256,492,748
1000,495,486,489,253,492,745
1000,494,464,524,219,538,757
1000,470,500,492,235,503,738
1000,486,505,520,236,512,748
1000,495,519,498,252,469,721
1000,470,506,509,232,500,732
1000,514,487,498,254,494,748
1000,500,514,480,248,491,739
1000,499,518,506,257,501,758
1000,523,486,512,247,526,773
1000,502,469,513,230,534,764
1000,497,473,504,244,520,764
1000,480,500,485,252,476,728
1000,488,497,490,243,506,749
1000,513,482,487,252,514,766
1000,490,491,495,249,491,740
1000,496,513,511,260,488,748
1000,491,511,494,242,497,739
1000,503,508,477,256,502,758
1000,519,489,488,256,479,735
1000,515,506,488,251,502,753
1000,504,483,506,251,505,756
1000,508,499,509,256,495,751
1000,512,473,489,236,512,748
1000,528,529,496,278,475,753
1000,508,472,480,260,468,728
1000,508,499,522,249,521,770
1000,505,474,502,233,509,742
1000,503,486,461,250,479,729
1000,505,496,503,248,522,770
1000,479,496,504,238,502,740
1000,490,489,501,241,498,739
1000,503,519,513,275,478,753
1000,498,489,486,245,481,726
1000,469,495,474,246,461,707
1000,511,492,511,252,499,751
1000,475,501,498,225,503,728
1000,477,497,481,230,487,717
1000,471,504,497,246,495,741
1000,519,499,484,251,489,740
1000,503,505,506,251,493,744
1000,502,485,492,243,508,751
1000,499,493,508,246,501,747
1000,484,476,517,221,524,745
1000,484,521,479,246,482,728
1000,500,502,513,246,514,760
1000,507,493,518,248,515,763
1000,508,501,501,243,511,754
1000,539,493,501,256,503,759
1000,530,530,475,280,489,769
1000,530,484,508,255,514,769
1000,520,498,496,269,487,756
1000,489,489,502,259,481,740
1000,486,515,512,259,477,736
1000,521,482,487,243,515,758
1000,507,507,519,263,501,764
1000,484,502,494,255,482,737
1000,492,514,502,246,513,759
1000,486,502,502,242,504,746
1000,483,493,542,236,517,753
1000,494,509,485,252,474,726
1000,521,517,485,274,476,750
1000,505,485,485,234,500,734
1000,497,496,495,231,542,773
1000,506,516,508,274,479,753
1000,512,484,520,251,515,766
1000,507,506,513,255,503,758
1000,490,503,501,243,501,744
1000,509,492,514,254,502,756
1000,486,511,530,242,510,752
1000,499,519,483,259,479,738
1000,492,494,493,260,478,738
1000,510,503,520,247,512,759
1000,489,525,486,250,493,743
1000,497,486,493,246,504,750
1000,512,500,509,269,497,766
1000,515,474,487,240,520,760
1000,475,460,492,220,508,728
1000,491,488,519,244,511,755
1000,482,510,517,245,491,736
1000,504,508,476,254,473,727
1000,485,502,528,242,507,749
1000,494,524,491,262,481,743
1000,520,489,496,256,498,754
1000,495,522,514,277,490,767
1000,503,497,514,254,497,751
1000,511,501,496,272,484,756
1000,534,511,492,262,512,774
1000,495,492,515,240,518,758
1000,521,496,483,258,491,749
1000,488,502,471,245,491,736
1000,475,495,494,239,490,729
1000,488,498,484,247,492,739
1000,489,494,524,237,521,758
1000,493,495,508,249,493,742
1000,521,496,505,267,496,763
1000,472,519,485,229,501,730
1000,502,486,474,249,480,729
1000,501,490,488,261,483,744
1000,519,477,490,257,503,760
1000,469,500,502,233,502,735
1000,492,494,519,236,529,765
1000,481,493,485,258,474,732
1000,505,475,484,250,498,748
1000,487,502,494,241,505,746
1000,487,506,487,260,478,738
1000,471,483,493,212,520,732
1000,502,501,520,249,516,765
1000,505,492,483,252,487,739
1000,502,525,494,266,480,746
1000,484,479,514,237,517,754
1000,488,511,490,254,489,743
1000,461,529,478,246,475,721
1000,496,502,491,248,501,749
1000,490,499,466,248,474,722
1000,497,506,526,252,507,759
1000,493,503,500,240,500,740
1000,505,508,532,257,519,776
1000,484,498,493,250,487,737
1000,498,490,489,247,489,736
1000,486,516,480,246,483,729
1000,500,497,455,246,485,731
1000,534,492,492,259,494,753
1000,489,492,486,246,491,737
1000,490,489,507,242,517,759
1000,513,463,489,228,527,755
1000,481,494,510,244,496,740
1000,502,509,491,263,488,751
1000,513,498,501,253,491,744
1000,506,510,500,273,468,741
1000,505,512,517,261,505,766
1000,504,496,462,245,486,731
1000,478,504,497,249,494,743
1000,476,478,490,230,509,739
1000,479,511,496,257,486,743
1000,507,462,474,243,496,739
1000,493,505,497,249,479,728
1000,494,514,480,258,469,727
1000,517,497,529,251,524,775
1000,513,493,492,265,477,742
1000,495,523,500,270,472,742
1000,489,533,497,263,485,748
1000,513,508,509,264,498,762
1000,487,488,524,235,526,761
1000,514,496,488,249,505,754
1000,481,503,506,255,487,742
1000,510,489,494,269,491,760
1000,505,512,524,273,488,761
1000,490,492,489,233,511,744
1000,478,501,494,234,499,733
1000,477,509,520,233,527,760
1000,491,511,481,247,486,733
1000,486,498,499,246,500,746
1000,531,527,493,285,480,765
1000,515,495,517,257,517,774
1000,507,530,497,275,482,757
1000,511,494,501,262,484,746
1000,511,521,538,251,531,782
1000,474,466,500,218,522,740
1000,511,503,497,267,482,749
1000,503,507,503,267,470,737
1000,506,514,507,251,503,754
1000,493,495,471,232,511,743
1000,516,498,503,263,507,770
1000,498,517,501,260,489,749
1000,514,530,532,275,488,763
1000,475,485,483,227,498,725
1000,504,491,505,244,522,766
1000,523,508,494,265,492,757
1000,506,487,504,250,510,760
1000,487,520,507,250,498,748
1000,500,497,491,252,474,726
1000,512,511,510,261,501,762
1000,500,484,489,240,490,730
1000,501,506,506,242,513,755
1000,495,483,482,233,510,743
1000,479,507,491,242,485,727
1000,499,498,515,252,517,769
1000,486,498,508,245,505,750
1000,493,509,511,253,489,742
1000,495,488,508,244,512,756
1000,499,487,474,231,500,731
1000,485,497,504,241,509,750
1000,481,508,513,246,502,748
1000,526,509,481,261,485,746
1000,487,516,510,245,502,747
1000,494,487,483,234,504,738
1000,480,507,521,251,495,746
1000,506,493,514,252,503,755
1000,502,497,474,253,485,738
1000,490,494,503,240,508,748
1000,487,500,492,241,496,737
1000,530,497,492,272,495,767
1000,471,478,491,226,493,719
1000,487,502,512,241,514,755
1000,486,508,512,243,516,759
1000,498,478,484,246,491,737
1000,485,508,504,241,505,746
1000,488,490,499,232,506,738
1000,507,485,486,241,494,735
1000,545,509,551,282,516,798
1000,495,502,501,253,487,740
1000,522,522,517,278,493,771
1000,502,533,489,261,494,755
1000,485,496,507,240,507,747
1000,486,505,487,252,480,732
1000,492,505,496,247,498,745
1000,507,497,488,264,482,746
1000,521,480,486,258,506,764
1000,476,508,512,235,501,736
1000,507,529,519,264,502,766
1000,506,497,530,253,517,770
1000,493,507,521,260,487,747
1000,518,516,498,267,511,778
1000,524,473,498,261,492,753
1000,477,505,479,236,490,726
1000,515,510,516,268,487,755
1000,487,525,509,246,495,741
1000,500,492,523,248,515,763
1000,525,517,485,271,485,756
1000,490,521,471,266,472,738
1000,528,477,513,253,515,768
1000,510,485,505,245,508,753
1000,512,506,513,258,522,780
1000,511,497,532,244,526,770
1000,491,475,505,238,507,745
1000,497,490,501,240,517,757
1000,487,501,519,250,496,746
1000,515,496,468,250,483,733
1000,502,518,483,264,492,756
1000,503,503,516,247,524,771
1000,469,484,489,224,508,732
1000,533,495,509,264,510,774
1000,485,510,494,245,488,733
1000,523,503,495,276,480,756
1000,514,487,508,243,509,752
1000,479,518,515,241,507,748
1000,479,468,489,225,513,738
1000,481,479,485,241,488,729
1000,491,506,500,264,480,744
1000,497,498,516,238,519,757
1000,482,500,497,244,502,746
1000,501,532,492,271,484,755
1000,456,521,505,245,485,730
1000,494,498,485,244,495,739
1000,501,515,521,261,510,771
1000,516,509,516,281,489,770
1000,477,498,476,230,500,730
1000,514,500,484,265,487,752
1000,497,500,506,253,500,753
1000,502,507,522,265,496,761
1000,532,508,509,281,490,771
1000,490,491,463,233,499,732
1000,530,522,509,278,485,763
1000,485,487,498,234,522,756
1000,530,508,511,278,509,787
1000,484,469,485,219,515,734
1000,484,497,482,236,501,737
1000,491,490,509,227,532,759
1000,512,492,475,259,492,751
1000,492,497,470,241,508,749
1000,499,507,490,240,514,754
1000,514,476,485,243,515,758
1000,523,499,479,262,489,751
1000,496,510,495,244,504,748
1000,477,500,493,241,492,733
1000,496,515,500,241,512,753
1000,502,484,494,235,511,746
1000,492,500,492,250,501,751
1000,489,515,499,262,483,745
1000,505,501,496,236,515,751
1000,486,499,496,237,497,734
1000,505,495,507,239,504,743
1000,504,518,503,254,500,754
1000,485,495,489,229,499,728
1000,508,508,495,261,491,752
1000,499,501,497,246,491,737
1000,526,523,534,277,501,778
1000,485,521,508,263,491,754
1000,514,486,482,250,500,750
1000,512,489,490,238,512,750
1000,496,486,495,246,489,735
1000,519,497,480,262,493,755
1000,503,522,494,250,497,747
1000,472,536,524,269,475,744
1000,505,502,504,265,483,748
1000,506,518,492,278,470,748
1000,484,515,511,240,510,750
1000,492,499,481,244,490,734
1000,484,514,501,242,491,733
1000,504,519,487,248,498,746
1000,484,472,488,238,496,734
1000,501,487,500,244,508,752
1000,487,500,498,243,498,741
1000,516,495,492,253,494,747
1000,512,515,485,254,503,757
1000,496,472,504,238,520,758
1000,503,490,507,242,486,728
1000,490,527,475,251,485,736
1000,495,507,502,245,504,749
1000,482,481,512,235,512,747
1000,525,493,512,254,502,756
1000,466,484,509,224,513,737
1000,488,485,500,238,517,755
1000,486,511,519,251,515,766
1000,509,487,480,242,510,752
1000,487,481,472,231,496,727
1000,517,513,495,269,490,759
1000,523,501,477,245,502,747
1000,487,461,481,226,508,734
1000,486,489,486,238,499,737
1000,521,481,486,249,498,747
1000,499,504,465,241,478,719
1000,487,516,514,237,528,765
1000,503,505,512,252,511,763
1000,488,483,498,241,487,728
1000,515,485,461,246,495,741
1000,505,505,532,254,518,772
1000,487,496,504,236,513,749
1000,501,510,493,251,486,737
1000,489,507,516,249,500,749
1000,507,518,494,276,445,721
1000,497,492,473,258,478,736
1000,476,482,524,232,520,752
1000,507,521,519,267,500,767
1000,507,483,495,241,504,745
1000,521,529,501,279,478,757
1000,510,500,501,246,519,765
1000,505,514,513,256,506,762
1000,517,493,477,271,493,764
1000,491,476,489,233,509,742
1000,513,515,520,284,490,774
1000,535,480,477,258,495,753
1000,510,492,497,253,508,761
1000,504,514,496,248,499,747
1000,490,504,479,226,511,737
1000,511,496,516,247,516,763
1000,523,499,515,279,490,769
1000,513,513,517,268,502,770
1000,482,492,489,217,518,735
1000,519,507,528,272,508,780
1000,492,520,491,250,490,740
1000,495,492,467,236,497,733
1000,499,492,491,244,494,738
1000,519,483,500,249,502,751
1000,473,497,472,231,487,718
1000,504,504,519,245,512,757
1000,498,541,499,271,479,750
1000,494,510,498,241,510,751
1000,473,523,501,230,495,725
1000,493,485,484,245,494,739
1000,489,477,517,232,519,751
1000,487,461,520,235,529,764
1000,502,503,484,244,498,742
1000,487,493,459,245,484,729
1000,518,508,503,264,505,769
1000,509,503,505,260,495,755
1000,503,510,525,255,517,772
1000,514,496,515,264,507,771
1000,515,507,504,273,498,771
1000,488,506,495,266,482,748
1000,509,517,505,273,479,752
1000,510,497,494,269,491,760
1000,500,495,509,240,517,757
1000,502,507,510,257,498,755
1000,491,499,513,257,487,744
1000,499,501,506,245,513,758
1000,471,499,508,234,513,747
1000,506,475,499,226,520,746
1000,492,491,494,230,522,752
1000,513,504,479,263,476,739
1000,491,486,525,246,513,759
1000,522,525,515,258,521,779
1000,497,511,525,254,510,764
1000,506,492,480,241,486,727
1000,494,490,486,242,499,741
1000,489,515,500,265,483,748
1000,515,479,498,243,505,748
1000,519,523,495,272,487,759
1000,492,483,510,247,512,759
1000,513,496,474,249,508,757
1000,491,504,494,251,493,744
1000,472,518,517,259,484,743
1000,482,537,493,255,485,740
1000,499,484,501,236,503,739
1000,504,491,499,253,500,753
1000,486,526,481,263,476,739
1000,491,506,474,235,499,734
1000,489,487,490,232,505,737
1000,499,511,538,250,519,769
1000,512,494,492,257,489,746
1000,510,527,476,254,493,747
1000,477,522,518,236,508,744
1000,491,488,490,243,494,737
1000,522,521,503,272,476,748
1000,462,475,535,229,521,750
1000,491,519,498,261,489,750
1000,520,485,482,255,496,751
1000,502,484,501,246,506,752
1000,516,471,502,241,497,738
1000,486,486,498,236,505,741
1000,521,509,496,260,497,757
1000,510,531,499,265,489,754
1000,497,492,472,241,500,741
1000,510,500,507,248,509,757
1000,487,506,507,259,481,740
1000,510,493,485,239,508,747
1000,507,494,498,258,495,753
1000,516,527,485,276,479,755
1000,526,530,481,293,466,759
1000,498,506,492,261,484,745
1000,485,518,484,235,502,737
1000,521,530,516,277,505,782
1000,502,504,486,258,485,743
1000,469,515,494,245,488,733
1000,507,491,488,242,497,739
1000,467,518,473,249,472,721
1000,499,499,515,256,494,750
1000,540,503,496,269,505,774
1000,519,517,500,269,496,765
1000,504,525,517,266,494,760
1000,510,527,510,260,492,752
1000,517,507,494,270,479,749
1000,490,511,499,246,495,741
1000,511,505,504,245,518,763
1000,499,518,496,254,496,750
1000,512,512,490,255,502,757
1000,477,472,495,227,503,730
1000,498,510,516,251,504,755
1000,495,499,512,238,539,777
1000,499,528,507,272,492,764
1000,480,489,480,224,507,731
1000,500,473,508,239,517,756
1000,498,514,495,258,504,762
1000,502,522,510,264,503,767
1000,479,484,509,232,515,747
1000,526,488,499,256,520,776
1000,490,497,482,237,500,737
1000,504,491,526,245,512,757
1000,505,503,513,243,519,762
1000,508,482,539,258,520,778
1000,502,490,500,252,499,751
1000,500,499,467,269,455,724
1000,507,523,507,267,488,755
1000,503,492,495,257,498,755
1000,485,469,517,229,534,763
1000,481,480,511,242,509,751
1000,511,534,492,271,495,766
1000,501,468,478,232,506,738
1000,515,493,489,253,497,750
1000,511,491,486,264,485,749
1000,518,479,511,250,512,762
1000,522,486,509,257,507,764
1000,495,476,492,229,519,748
1000,490,506,494,255,490,745
1000,510,509,483,267,483,750
1000,503,498,504,246,501,747
1000,494,500,503,252,497,749
1000,480,495,505,238,501,739
1000,503,469,504,243,507,750
1000,502,476,482,239,490,729
1000,535,519,486,279,483,762
1000,504,516,475,250,484,734
1000,496,483,521,252,512,764
1000,493,480,518,237,508,745
1000,527,494,506,253,521,774
1000,493,513,505,243,501,744
1000,488,490,489,222,521,743
1000,513,454,503,226,542,768
1000,499,509,496,247,502,749
1000,521,497,504,260,507,767
1000,480,486,504,224,520,744
1000,487,510,503,244,493,737
1000,492,522,506,265,467,732
1000,523,518,515,279,478,757
1000,511,506,485,261,482,743
1000,482,463,495,215,532,747
1000,489,499,490,247,477,724
1000,495,495,469,252,468,720
1000,503,461,490,242,506,748
1000,499,509,506,246,493,739
1000,487,501,487,233,495,728
1000,522,498,490,265,492,757
1000,507,514,515,268,487,755
1000,501,496,493,243,506,749
1000,517,500,507,275,475,750
1000,504,477,525,238,534,772
1000,477,526,500,251,500,751
1000,523,485,511,245,531,776
1000,486,514,477,245,494,739
1000,525,494,478,272,479,751
1000,498,503,492,251,496,747
1000,511,498,514,251,502,753
1000,488,506,496,251,489,740
1000,509,513,491,262,472,734
1000,498,493,496,245,499,744
1000,497,509,496,252,503,755
1000,503,482,511,242,514,756
1000,486,485,474,245,481,726
1000,512,515,481,266,490,756
1000,493,496,520,242,516,758
1000,512,505,531,243,527,770
1000,499,512,492,251,485,736
1000,513,517,500,260,491,751
1000,503,511,478,255,490,745
1000,534,484,519,256,518,774
1000,508,514,492,260,486,746
1000,522,490,487,258,497,755
1000,499,469,495,235,524,759
1000,520,517,492,269,492,761
1000,505,512,503,252,510,762
1000,499,470,483,238,492,730
1000,493,498,491,245,487,732
1000,508,477,524,246,517,763
1000,479,474,505,228,516,744
1000,509,517,491,259,493,752
1000,498,473,509,230,527,757
1000,469,498,489,239,489,728
1000,494,494,490,233,516,749
1000,508,503,508,256,512,768
1000,489,496,494,253,481,734
1000,501,493,514,251,519,770
1000,499,503,508,274,468,742
1000,512,507,500,258,500,758
1000,516,506,498,267,486,753
1000,498,500,508,248,514,762
1000,517,512,502,253,510,763
1000,482,481,482,237,495,732
1000,483,497,484,231,505,736
1000,485,486,521,246,504,750
1000,507,502,501,268,493,761
1000,497,503,509,257,484,741
1000,497,490,491,235,506,741
1000,453,494,486,235,488,723
1000,508,474,502,236,513,749
1000,489,499,489,239,502,741
1000,493,500,499,245,491,736
1000,488,500,495,256,489,745
1000,506,500,487,259,479,738
1000,501,503,502,262,504,766
1000,488,491,489,243,505,748
1000,517,498,494,253,507,760
1000,521,463,501,243,515,758
1000,511,513,549,261,521,782
1000,490,521,480,258,479,737
1000,491,515,509,247,499,746
1000,492,472,489,231,509,740
1000,519,475,526,239,534,773
1000,493,501,509,246,501,747
1000,492,511,485,253,481,734
1000,502,514,512,260,492,752
1000,494,504,508,247,506,753
1000,519,506,520,259,526,785
1000,511,511,493,257,505,762
1000,498,511,512,254,503,757
1000,509,517,486,258,496,754
1000,489,493,512,250,499,749
1000,495,485,500,250,492,742
1000,503,504,483,252,480,732
1000,478,493,504,243,517,760
1000,493,479,522,238,516,754
1000,469,510,513,251,489,740
1000,509,498,515,240,526,766
1000,497,515,485,248,499,747
1000,487,523,506,265,473,738
1000,492,494,505,240,516,756
1000,494,520,519,243,504,747
1000,489,494,481,247,488,735
1000,494,482,496,244,496,740
1000,504,523,499,268,494,762
1000,473,528,495,246,498,744
1000,482,497,515,237,507,744
1000,531,501,494,266,500,766
1000,485,517,503,239,519,758
1000,530,489,519,247,525,772
1000,501,510,526,258,504,762
1000,508,505,512,261,499,760
1000,478,508,493,251,491,742
1000,491,506,497,248,495,743
1000,475,507,505,230,519,749
1000,510,483,481,245,488,733
1000,508,531,482,270,474,744
1000,502,466,497,225,539,764
1000,472,495,498,243,498,741
1000,514,480,501,240,530,770
1000,502,501,510,256,513,769
1000,519,509,484,261,484,745
1000,482,494,484,228,507,735
1000,460,509,514,235,490,725
1000,506,488,523,255,525,780
1000,486,517,512,246,503,749
1000,475,496,480,241,481,722
1000,503,499,486,247,498,745
1000,503,498,509,247,504,751
1000,509,517,516,256,511,767
1000,474,488,510,235,506,741
1000,513,481,497,248,517,765
1000,486,481,516,234,510,744
1000,506,482,503,245,491,736
1000,494,477,496,233,502,735
1000,478,520,503,248,495,743
1000,508,506,494,252,482,734
1000,510,498,517,235,527,762
1000,475,506,514,248,487,735
1000,505,493,495,236,515,751
1000,511,489,501,249,510,759
1000,517,482,505,240,525,765
1000,498,489,493,244,488,732
1000,523,506,495,273,483,756
1000,494,492,465,242,482,724
1000,515,491,466,250,480,730
1000,493,501,468,244,479,723
1000,470,497,530,235,507,742
1000,519,493,496,248,514,762
1000,477,501,490,239,506,745
1000,498,503,494,248,496,744
1000,507,524,482,273,467,740
1000,503,503,487,249,493,742
1000,495,509,482,246,505,751
1000,503,501,514,253,503,756
1000,500,500,513,243,513,756
1000,499,504,479,256,479,735
1000,511,486,471,241,504,745
1000,492,506,519,240,516,756
1000,476,517,501,248,497,745
1000,507,503,518,263,492,755
1000,505,512,474,257,487,744
1000,512,493,472,236,515,751
1000,467,498,507,240,499,739
1000,503,514,489,257,480,737
1000,498,491,481,240,494,734
1000,506,495,492,244,496,740
1000,508,489,523,243,531,774
1000,488,500,498,255,495,750
1000,505,480,488,245,503,748
1000,507,501,502,271,484,755
1000,503,483,517,236,525,761
1000,490,518,506,256,497,753
1000,514,485,486,231,515,746
1000,486,466,495,216,526,742
1000,498,497,510,256,507,763
1000,506,509,536,265,522,787
1000,496,499,493,250,490,740
1000,512,502,500,266,482,748
1000,473,514,548,241,521,762
1000,494,529,497,256,485,741
1000,503,511,478,253,485,738
1000,506,496,489,262,491,753
1000,476,498,505,230,516,746
1000,537,505,529,261,512,773
1000,476,494,504,225,520,745
1000,500,492,490,254,506,760
1000,492,495,473,242,482,724
1000,514,508,519,256,510,766
1000,488,497,506,246,513,759
1000,495,498,477,237,512,749
1000,501,505,485,268,482,750
1000,520,489,482,248,516,764
1000,488,499,505,235,505,740
1000,500,483,502,244,517,761
1000,510,503,510,271,478,749
1000,489,522,505,260,485,745
1000,494,504,485,245,481,726
1000,515,494,474,255,502,757
1000,524,479,534,241,544,785
1000,494,518,491,253,488,741
1000,487,489,495,239,493,732
1000,512,490,492,259,491,750
1000,478,502,509,240,506,746
1000,504,485,494,244,509,753
1000,518,503,501,266,495,761
1000,477,487,498,224,515,739
1000,498,512,510,267,486,753
1000,489,492,515,236,496,732
1000,492,537,525,270,496,766
1000,489,489,510,231,506,737
1000,493,495,509,248,504,752
1000,506,536,490,273,478,751
1000,511,512,484,260,474,734
1000,499,504,502,256,489,745
1000,512,504,503,253,484,737
1000,516,488,509,259,509,768
1000,487,483,510,235,499,734
1000,528,525,490,278,476,754
1000,512,498,490,262,489,751
1000,492,540,506,257,499,756
1000,517,480,465,257,486,743
1000,490,493,474,234,495,729
1000,500,529,539,263,500,763
1000,486,494,472,241,482,723
1000,509,504,520,254,515,769
1000,511,488,486,250,503,753
1000,479,511,479,244,491,735
1000,476,501,496,253,478,731
1000,487,484,494,241,506,747
1000,514,503,499,260,514,774
1000,501,507,501,251,504,755
1000,477,517,492,243,497,740
1000,506,527,489,271,472,743
1000,503,514,513,267,503,770
1000,496,506,516,254,509,763
1000,503,528,487,261,502,763
1000,500,519,520,253,510,763
1000,487,479,491,227,515,742
1000,497,495,511,240,500,740
1000,507,522,485,260,493,753
1000,490,523,505,245,505,750
1000,494,503,486,251,490,741
1000,496,505,500,256,490,746
1000,504,463,476,228,512,740
1000,492,495,481,252,486,738
1000,497,502,480,259,486,745
1000,520,504,503,268,499,767
1000,508,495,527,248,514,762
1000,502,504,509,266,484,750
1000,504,494,488,250,497,747
1000,487,498,497,238,509,747
1000,496,522,489,269,473,742
1000,509,491,475,247,510,757
1000,502,509,487,256,495,751
1000,517,489,463,253,477,730
1000,494,495,513,243,504,747
1000,495,508,512,252,499,751
1000,504,475,470,250,489,739
1000,467,472,484,238,494,732
1000,493,511,486,239,501,740
1000,517,490,507,266,485,751
1000,524,478,505,260,490,750
1000,499,514,495,246,503,749
1000,513,480,474,243,507,750
1000,514,500,480,261,485,746
1000,516,504,506,264,506,770
1000,520,522,521,272,500,772
1000,515,462,494,248,507,755
1000,483,513,493,242,496,738
1000,519,499,507,265,497,762
1000,513,485,480,246,513,759
1000,466,532,502,246,488,734
1000,500,463,505,238,520,758
1000,503,501,510,247,502,749
1000,490,490,471,239,500,739
1000,469,469,498,221,501,722
1000,485,483,495,241,491,732
1000,502,516,496,263,490,753
1000,510,499,514,252,501,753
1000,532,503,507,271,493,764
1000,497,512,491,255,486,741
1000,480,464,520,210,533,743
1000,521,484,493,239,530,769
1000,500,497,501,245,504,749
1000,503,501,511,247,504,751
1000,494,503,506,234,530,764
1000,477,517,494,246,478,724
1000,509,482,457,243,477,720
1000,504,496,497,245,522,767
1000,524,509,510,261,503,764
1000,485,497,480,245,486,731
1000,504,512,472,255,477,732
1000,525,486,498,251,514,765
1000,505,477,519,236,520,756
1000,491,528,489,250,480,730
1000,480,512,504,258,497,755
1000,528,501,470,259,484,743
1000,495,486,497,235,519,754
1000,483,490,502,240,500,740
1000,494,514,524,256,507,763
1000,491,502,512,244,518,762
1000,472,516,478,243,480,723
1000,501,502,477,262,468,730
1000,472,497,494,242,491,733
1000,478,478,505,229,507,736
1000,501,473,505,235,509,744
1000,511,513,488,272,478,750
1000,493,490,506,242,502,744
1000,494,479,517,242,509,751
1000,467,510,498,238,504,742
1000,506,499,489,256,485,741
1000,498,507,484,242,497,739
1000,527,508,515,261,505,766
1000,488,503,485,239,506,745
1000,476,508,515,237,507,744
1000,508,523,513,271,493,764
1000,490,489,478,233,516,749
1000,503,515,515,260,512,772
1000,507,504,517,274,484,758
1000,489,501,506,236,513,749
1000,531,513,482,257,512,769
1000,495,504,478,266,478,744
1000,495,511,507,273,469,742
1000,473,536,477,274,455,729
1000,470,499,499,237,504,741
1000,491,491,517,248,517,765
1000,508,517,498,263,482,745
1000,503,510,510,253,497,750
1000,499,492,506,245,506,751
1000,493,472,507,247,515,762
1000,504,491,499,241,501,742
1000,518,499,513,260,506,766
1000,491,516,497,259,477,736
1000,511,497,507,263,503,766
1000,489,520,505,248,495,743
1000,519,479,514,239,536,775
1000,512,487,507,244,520,764
1000,540,517,488,258,503,761
1000,479,526,493,265,457,722
1000,505,483,522,247,501,748
1000,508,519,505,251,518,769
1000,495,507,495,251,494,745
1000,461,489,498,220,508,728
1000,495,517,480,256,468,724
1000,507,487,515,252,514,766
1000,486,496,476,227,505,732
1000,507,497,505,260,488,748
1000,502,490,483,252,497,749
1000,473,498,457,243,474,717
1000,483,521,520,250,511,761
1000,506,489,500,238,515,753
1000,476,512,489,235,499,734
1000,535,499,473,275,482,757
1000,521,504,470,268,484,752
1000,495,509,491,250,492,742
1000,517,490,495,273,490,763
1000,500,520,501,248,499,747
1000,499,489,516,241,516,757
1000,515,494,501,257,490,747
1000,493,488,504,244,500,744
1000,480,478,481,226,492,718
1000,507,497,519,255,515,770
1000,488,496,500,235,516,751
1000,508,495,502,261,497,758
1000,475,490,495,239,484,723
1000,477,497,494,238,513,751
1000,504,488,501,247,508,755
1000,527,486,540,251,534,785
1000,507,497,504,261,496,757
1000,485,490,472,242,490,732
1000,501,520,494,264,492,756
1000,490,487,501,243,494,737
1000,470,491,514,234,500,734
1000,487,515,502,244,504,748
1000,493,509,528,255,510,765
1000,494,492,500,234,517,751
1000,494,512,489,265,459,724
1000,487,483,493,246,494,740
1000,500,503,508,248,500,748
1000,498,487,499,243,504,747
1000,508,519,499,278,495,773
1000,482,483,519,246,501,747
1000,474,505,517,246,475,721
1000,516,490,470,254,492,746
1000,504,507,504,271,467,738
1000,506,495,489,243,509,752
1000,505,480,501,254,510,764
1000,481,508,507,253,480,733
1000,517,497,508,250,505,755
1000,475,495,510,234,523,757
1000,492,488,487,232,513,745
1000,460,499,505,230,493,723
1000,483,458,494,219,516,735
1000,503,485,503,255,504,759
1000,500,491,509,237,517,754
1000,498,478,501,225,501,726
1000,502,542,518,273,502,775
1000,488,501,504,247,503,750
1000,502,513,511,251,484,735
1000,506,489,523,249,514,763
1000,510,515,503,272,500,772
1000,507,487,505,235,521,756
1000,509,510,485,250,509,759
1000,520,504,525,276,497,773
1000,497,515,468,257,480,737
1000,501,501,514,248,496,744
1000,492,499,478,249,488,737
1000,493,491,482,247,477,724
1000,501,499,492,246,499,745
1000,494,508,501,273,464,737
1000,487,493,515,240,513,753
1000,528,507,520,259,508,767
1000,527,513,498,266,486,752
1000,467,493,474,228,497,725
1000,475,498,496,224,497,721
1000,524,492,514,258,508,766
1000,497,506,521,264,476,740
1000,513,491,511,251,500,751
1000,538,487,498,274,490,764
1000,482,502,518,245,491,736
1000,505,502,508,245,522,767
1000,489,511,506,250,503,753
1000,494,481,482,241,505,746
1000,502,489,480,249,494,743
1000,483,500,496,248,485,733
1000,503,489,495,262,492,754
1000,487,490,489,243,497,740
1000,527,500,488,277,474,751
1000,505,500,518,252,516,768
1000,512,497,512,251,502,753
1000,511,490,498,249,518,767
1000,518,526,513,274,482,756
1000,508,496,530,268,502,770
1000,504,495,512,255,508,763
1000,506,485,482,241,505,746
1000,506,504,490,266,481,747
1000,485,511,493,252,484,736
1000,505,508,499,258,505,763
1000,496,538,499,260,489,749
1000,499,477,487,234,521,755
1000,524,528,496,285,472,757
1000,526,509,477,270,476,746
1000,464,512,512,243,500,743
1000,490,515,506,253,495,748
1000,500,488,482,240,504,744
1000,497,490,494,256,491,747
1000,511,503,492,254,486,740
1000,506,481,497,251,518,769
1000,483,515,496,249,499,748
1000,503,512,507,251,507,758
1000,502,496,491,251,515,766
1000,471,501,512,240,510,750
1000,496,522,503,257,492,749
1000,498,479,487,234,510,744
1000,508,528,508,265,480,745
1000,497,483,493,248,495,743
1000,491,512,510,249,494,743
1000,494,494,531,242,533,775
1000,515,513,508,269,489,758
1000,507,531,532,271,507,778
1000,498,519,500,249,496,745
1000,502,526,538,249,514,763
1000,488,512,488,244,488,732
1000,511,521,528,263,499,762
1000,518,491,509,257,499,756
1000,505,493,511,249,508,757
1000,506,500,505,262,493,755
1000,458,524,488,253,452,705
1000,471,513,519,246,508,754
1000,496,515,507,254,496,750
1000,514,482,521,256,516,772
1000,506,485,489,233,509,742
1000,494,493,474,244,476,720
1000,514,507,532,264,520,784
1000,505,495,512,265,497,762
1000,511,520,513,266,498,764
1000,518,505,485,262,487,749
1000,497,525,490,249,497,746
1000,496,511,505,261,503,764
1000,498,517,499,264,475,739
1000,503,515,528,256,510,766
1000,511,508,489,256,494,750
1000,482,521,505,241,504,745
1000,534,525,531,282,507,789
1000,521,512,502,277,484,761
1000,484,481,483,231,512,743
1000,496,502,493,242,503,745
1000,475,503,498,243,495,738
1000,525,500,514,267,493,760
1000,496,493,512,248,493,741
1000,502,489,509,250,501,751
1000,480,463,528,211,547,758
1000,525,488,507,241,507,748
1000,501,492,507,250,515,765
1000,510,492,511,268,483,751
1000,511,517,508,262,511,773
1000,508,484,519,250,506,756
1000,492,459,484,224,512,736
1000,502,506,510,255,484,739
1000,515,522,521,266,506,772
1000,501,532,505,267,479,746
1000,497,522,481,264,474,738
1000,500,488,479,249,491,740
1000,515,468,520,237,532,769
1000,510,513,478,263,487,750
1000,510,506,492,257,490,747
1000,484,505,534,245,511,756
1000,520,470,514,237,525,762
1000,493,497,501,246,495,741
1000,511,514,515,256,518,774
1000,480,515,503,241,502,743
1000,516,485,506,245,511,756
1000,496,535,501,272,470,742
1000,459,524,486,237,482,719
1000,522,514,525,282,492,774
1000,487,500,506,232,511,743
1000,486,492,528,229,541,770
1000,515,485,505,247,508,755
1000,483,495,515,240,506,746
1000,541,485,496,250,508,758
1000,487,507,479,242,496,738
1000,527,458,493,247,516,763
1000,514,489,493,252,483,735
1000,477,513,468,236,489,725
1000,480,497,494,231,487,718
1000,490,503,505,270,476,746
1000,515,493,498,260,499,759
1000,499,458,520,245,520,765
1000,509,487,512,247,511,758
1000,491,485,490,244,505,749
1000,522,506,505,269,508,777
1000,495,529,498,254,493,747
1000,508,481,521,251,520,771
1000,510,510,515,264,487,751
1000,477,509,483,244,494,738
1000,504,486,508,249,504,753
1000,539,489,509,273,497,770
1000,495,510,490,262,484,746
1000,522,508,506,267,506,773
1000,487,538,484,259,485,744
1000,483,510,489,248,467,715
1000,472,513,474,241,481,722
1000,531,512,504,263,513,776
1000,494,485,489,234,513,747
1000,513,507,502,259,504,763
1000,498,474,457,229,511,740
1000,489,531,512,262,488,750
1000,526,486,511,243,524,767
1000,495,515,517,245,504,749
1000,484,492,502,231,522,753
1000,498,476,505,223,538,761
1000,515,501,483,263,485,748
1000,500,499,501,247,501,748
1000,504,506,512,256,514,770
1000,510,478,524,233,527,760
1000,510,504,505,250,508,758
1000,498,507,512,243,516,759
1000,460,510,492,233,494,727
1000,512,494,471,255,481,736
1000,512,518,494,262,487,749
1000,494,526,508,253,487,740
1000,477,501,527,236,522,758
1000,508,491,472,262,483,745
1000,511,509,502,259,506,765
1000,492,500,509,235,503,738
1000,507,490,513,235,527,762
1000,510,502,490,255,490,745
1000,507,479,526,245,526,771
1000,479,495,506,223,529,752
1000,523,498,507,244,519,763
1000,499,526,509,267,486,753
1000,503,510,495,253,505,758
1000,520,490,469,252,480,732
1000,506,493,465,257,471,728
1000,516,494,483,256,487,743
1000,505,513,505,262,496,758
1000,495,478,507,244,514,758
1000,492,511,504,252,497,749
1000,484,479,503,229,514,743
1000,490,502,519,250,501,751
1000,512,487,495,262,493,755
1000,481,472,494,229,502,731
1000,493,491,488,242,500,742
1000,477,494,498,240,492,732
1000,516,518,488,256,490,746
1000,482,509,510,250,492,742
1000,498,487,512,248,511,759
1000,512,505,504,253,497,750
1000,509,497,481,254,486,740
1000,488,481,533,250,507,757
1000,500,519,492,242,507,749
1000,494,499,496,235,510,745
1000,502,512,499,253,495,748
1000,503,546,500,288,452,740
1000,518,514,530,273,508,781
1000,519,501,483,259,498,757
1000,512,519,495,273,477,750
1000,535,534,520,284,496,780
1000,515,473,498,233,519,752
1000,509,510,499,259,497,756
1000,491,514,494,247,487,734
1000,513,498,508,257,508,765
1000,464,522,502,237,493,730
1000,486,512,511,258,486,744
1000,501,515,485,262,472,734
1000,500,471,514,234,522,756
1000,523,494,516,257,517,774
1000,508,492,481,250,482,732
1000,477,509,532,240,515,755
1000,458,467,489,208,528,736
1000,495,503,500,240,509,749
1000,533,515,469,274,478,752
1000,487,480,463,229,486,715
1000,509,501,492,257,489,746
1000,494,476,494,234,512,746
1000,524,517,490,280,484,764
1000,497,495,504,253,493,746
1000,497,500,494,247,500,747
1000,506,498,489,244,501,745
1000,483,493,484,240,480,720
1000,491,523,491,252,495,747
1000,489,472,494,234,511,745
1000,469,510,517,236,516,752
1000,524,482,514,256,526,782
1000,477,519,486,248,482,730
1000,510,494,510,266,491,757
1000,510,481,494,245,522,767
1000,471,501,499,239,482,721
1000,526,493,480,257,505,762
1000,506,509,502,270,468,738
1000,533,482,562,253,547,800
1000,502,515,494,255,492,747
1000,477,467,520,221,534,755
1000,499,518,527,270,499,769
1000,508,491,502,263,487,750
1000,507,523,513,255,502,757
1000,499,504,511,243,507,750
1000,519,487,502,252,511,763
1000,482,527,519,255,512,767
1000,522,496,505,266,479,745
1000,497,477,490,239,508,747
1000,514,487,498,257,499,756
1000,486,506,495,250,484,734
1000,526,499,512,266,496,762
1000,499,508,500,244,518,762
1000,487,510,482,241,497,738
1000,477,509,488,240,486,726
1000,525,507,506,262,504,766
1000,486,498,501,245,499,744
1000,496,527,497,247,490,737
1000,469,506,514,240,517,757
1000,514,487,501,257,491,748
1000,525,537,466,283,465,748
1000,499,488,499,247,500,747
1000,534,493,519,267,501,768
1000,492,511,506,244,501,745
1000,497,504,484,255,485,740
1000,498,521,499,268,488,756
1000,536,513,500,280,494,774
1000,505,481,525,251,515,766
1000,490,508,506,240,507,747
1000,495,510,502,248,509,757
1000,508,489,496,252,496,748
1000,510,469,514,237,530,767
1000,506,487,506,239,524,763
1000,497,531,478,251,477,728
1000,489,485,521,232,525,757
1000,483,501,504,248,505,753
1000,521,512,491,269,473,742
1000,512,534,500,275,489,764
1000,496,506,501,262,491,753
1000,488,494,481,255,480,735
1000,519,487,501,250,511,761
1000,508,501,508,251,518,769
1000,458,491,509,215,513,728
1000,504,494,511,250,508,758
1000,527,509,482,264,485,749
1000,487,509,502,253,494,747
1000,490,535,495,261,474,735
1000,498,511,541,259,516,775
1000,503,524,504,261,497,758
1000,493,509,488,244,502,746
1000,499,479,501,246,521,767
1000,511,527,505,269,477,746
1000,485,510,492,244,494,738
1000,506,508,498,268,481,749
1000,527,498,507,242,530,772
1000,510,504,494,272,467,739
1000,496,487,487,240,496,736
1000,492,492,506,244,508,752
1000,510,521,513,271,496,767
1000,508,485,491,254,489,743
1000,503,504,496,246,506,752
1000,462,504,481,248,468,716
1000,526,527,492,272,479,751
1000,494,479,487,241,500,741
1000,495,491,482,245,493,738
1000,499,500,494,240,496,736
1000,505,495,513,260,496,756
1000,489,511,483,252,490,742
1000,491,509,498,252,480,732
1000,504,507,521,250,513,763
1000,522,472,502,253,492,745
1000,485,482,488,235,523,758
1000,515,486,480,260,482,742
1000,480,490,482,234,486,720
1000,485,512,506,244,510,754
1000,472,496,492,233,502,735
1000,510,482,485,240,512,752
1000,493,505,494,247,496,743
1000,508,454,490,221,543,764
1000,534,469,499,260,511,771
1000,488,506,488,246,487,733
1000,530,493,506,269,506,775
1000,491,499,531,249,521,770
1000,515,493,457,262,479,741
1000,513,520,481,270,472,742
1000,491,481,488,235,489,724
1000,487,484,499,230,529,759
1000,485,489,524,246,505,751
1000,501,463,526,231,536,767
1000,500,504,485,232,508,740
1000,487,523,505,248,507,755
1000,496,504,493,238,494,732
1000,503,489,504,250,503,753
1000,512,491,499,256,504,760
1000,515,488,501,241,524,765
1000,497,492,479,246,474,720
1000,479,508,474,245,478,723
1000,507,476,530,241,535,776
1000,489,505,491,255,490,745
1000,498,495,494,241,503,744
1000,465,462,478,209,509,718
1000,511,526,497,273,490,763
1000,525,506,512,264,498,762
1000,477,507,529,234,514,748
1000,471,491,506,244,511,755
1000,512,494,496,255,497,752
1000,511,490,501,246,516,762
1000,484,469,502,234,514,748
1000,502,488,503,238,509,747
1000,513,500,479,256,479,735
1000,503,484,504,238,518,756
1000,507,497,525,232,529,761
1000,512,471,472,233,506,739
1000,520,505,483,261,478,739
1000,493,494,515,239,503,742
1000,508,487,498,248,511,759
1000,475,486,487,228,490,718
1000,485,489,478,232,469,701
1000,501,494,476,248,482,730
1000,515,472,483,237,516,753
1000,518,500,509,247,526,773
1000,470,495,501,237,502,739
1000,499,488,505,255,511,766
1000,491,486,461,240,481,721
1000,494,487,520,236,522,758
1000,500,485,519,239,511,750
1000,499,498,485,252,481,733
1000,502,489,495,248,506,754
1000,503,502,517,267,473,740
1000,468,508,497,233,500,733
1000,465,505,512,230,500,730
1000,523,500,515,253,513,766
1000,508,478,483,234,521,755
1000,498,518,484,267,464,731
1000,507,497,476,243,492,735
1000,473,516,486,235,487,722
1000,503,496,519,242,508,750
1000,496,500,492,256,486,742
1000,518,509,489,265,490,755
1000,490,519,504,262,467,729
1000,498,512,483,250,483,733
1000,492,509,491,253,507,760
1000,505,490,493,243,500,743
1000,488,491,503,252,487,739
1000,483,483,503,219,522,741
1000,511,483,496,252,497,749
1000,511,495,493,255,489,744
1000,514,520,508,259,503,762
1000,499,495,515,257,504,761
1000,529,505,510,263,501,764
1000,481,514,498,237,505,742
1000,511,516,510,259,513,772
1000,520,516,482,264,493,757
1000,529,495,494,256,497,753
1000,505,516,482,252,483,735
1000,497,512,503,258,482,740
1000,472,500,496,246,495,741
1000,473,510,487,244,489,733
1000,512,504,529,255,514,769
1000,487,514,510,228,521,749
1000,466,518,521,236,502,738
1000,480,506,506,243,515,758
1000,485,481,499,235,523,758
1000,472,506,511,238,493,731
1000,482,488,502,239,498,737
1000,500,497,483,257,480,737
1000,505,500,513,244,512,756
1000,498,506,495,260,495,755
1000,503,515,505,266,502,768
1000,504,493,492,254,492,746
1000,499,492,493,246,506,752
1000,516,506,502,254,500,754
1000,524,493,469,266,478,744
1000,515,492,514,251,527,778
1000,522,511,513,278,484,762
1000,509,498,496,259,480,739
1000,515,475,517,253,520,773
1000,472,513,511,248,489,737
1000,482,474,503,233,517,750
1000,478,519,521,261,483,744
1000,497,504,480,240,515,755
1000,490,487,507,238,516,754
1000,493,497,509,249,497,746
1000,507,513,477,260,490,750
1000,490,514,518,252,498,750
1000,511,511,518,257,494,751
1000,502,540,513,263,492,755
1000,491,522,493,240,498,738
1000,504,505,473,253,484,737
1000,495,539,513,256,482,738
1000,492,533,478,248,491,739
1000,485,499,516,230,539,769
1000,478,479,471,235,486,721
1000,523,516,473,271,481,752
1000,488,501,499,247,484,731
1000,498,509,490,258,478,736
1000,501,505,524,247,517,764
1000,503,490,538,250,525,775
1000,533,510,501,270,501,771
1000,518,475,499,262,484,746
1000,502,493,507,250,508,758
1000,510,510,486,263,479,742
1000,464,477,502,235,505,740
1000,470,529,487,237,488,725
1000,502,527,509,260,502,762
1000,505,485,492,255,493,748
1000,507,493,494,245,509,754
1000,512,477,480,242,495,737
1000,508,500,483,256,490,746
1000,504,500,491,253,482,735
1000,501,506,460,257,472,729
1000,477,480,519,236,512,748
1000,488,511,510,242,505,747
1000,497,503,508,247,502,749
1000,446,504,488,239,491,730
1000,503,468,494,223,528,751
1000,473,487,465,234,480,714
1000,496,495,507,230,511,741
1000,488,479,499,244,497,741
1000,471,490,510,223,514,737
1000,531,473,509,252,523,775
1000,495,459,500,230,507,737
1000,503,510,518,255,502,757
1000,516,518,491,285,467,752
1000,510,487,489,258,488,746
1000,494,528,503,261,481,742
1000,459,479,526,226,517,743
1000,502,498,496,249,506,755
1000,485,459,493,219,538,757
1000,483,502,494,246,473,719
1000,485,501,525,252,504,756
1000,515,468,505,236,510,746
1000,494,519,498,252,488,740
1000,496,526,521,258,498,756
1000,509,527,493,260,488,748
1000,506,499,501,263,483,746
1000,493,499,523,239,510,749
1000,499,503,504,246,519,765
1000,485,498,499,228,502,730
1000,498,489,522,244,510,754
1000,501,492,509,258,497,755
1000,496,501,483,236,515,751
1000,497,505,504,243,507,750
1000,507,497,492,250,506,756
1000,510,519,495,263,498,761
1000,494,508,510,238,505,743
1000,493,506,497,256,493,749
1000,500,498,487,256,485,741
1000,505,512,494,249,499,748
1000,500,489,503,252,495,747
1000,493,506,507,253,490,743
1000,489,484,504,238,508,746
1000,494,492,504,249,509,758
1000,473,505,487,241,475,716
1000,500,471,512,251,521,772
1000,509,496,481,253,504,757
1000,502,486,493,245,507,752
1000,501,478,494,235,510,745
1000,495,481,493,251,499,750
1000,508,500,507,257,505,762
1000,474,503,485,241,486,727
1000,485,525,502,248,488,736
1000,505,474,522,236,528,764
1000,520,517,479,272,491,763
1000,512,491,480,247,508,755
1000,500,506,480,244,495,739
1000,496,492,516,246,516,762
1000,515,468,510,238,525,763
1000,513,523,511,260,507,767
1000,491,525,512,256,500,756
1000,486,512,509,235,488,723
1000,489,521,499,253,484,737
1000,504,502,487,244,499,743
1000,503,500,527,248,516,764
1000,504,498,483,255,482,737
1000,512,515,503,280,465,745
1000,493,521,502,260,481,741
1000,474,487,491,225,513,738
1000,472,527,532,248,503,751
1000,504,496,488,245,494,739
1000,499,510,460,264,456,720
1000,493,506,485,246,482,728
1000,482,511,489,245,482,727
1000,470,512,506,241,488,729
1000,477,487,529,232,520,752
1000,502,510,495,252,497,749
1000,490,483,504,229,526,755
1000,497,494,471,239,496,735
1000,507,501,496,245,501,746
1000,491,478,502,241,503,744
1000,517,495,512,249,518,767
1000,509,511,487,275,471,746
1000,524,518,501,280,485,765
1000,501,506,496,252,505,757
1000,504,512,490,264,470,734
1000,497,496,488,253,487,740
1000,512,496,513,241,532,773
1000,497,520,478,254,486,740
1000,527,491,499,258,506,764
1000,511,476,513,237,533,770
1000,525,503,518,267,502,769
1000,473,505,509,249,497,746
1000,525,494,490,268,488,756
1000,508,510,512,259,499,758
1000,505,510,496,253,499,752
1000,467,504,521,228,527,755
1000,524,509,519,269,496,765
1000,521,510,499,259,505,764
1000,491,470,469,226,490,716
1000,523,486,477,258,502,760
1000,481,516,514,237,508,745
1000,486,464,496,232,514,746
1000,479,524,499,256,481,737
1000,492,512,470,247,482,729
1000,477,481,495,238,502,740
1000,498,501,520,243,517,760
1000,500,534,490,263,491,754
1000,485,492,491,250,502,752
1000,493,516,469,248,495,743
1000,492,516,523,250,501,751
1000,505,487,482,264,472,736
1000,505,484,516,236,528,764
1000,505,521,507,246,516,762
1000,488,489,531,228,536,764
1000,491,483,485,232,498,730
1000,494,505,506,255,491,746
1000,500,503,495,261,489,750
1000,483,499,495,238,513,751
1000,487,532,513,254,500,754
1000,500,498,476,252,494,746
1000,494,498,500,241,500,741
1000,503,525,515,270,497,767
1000,490,483,509,253,480,733
1000,504,489,530,257,506,763
1000,470,498,519,230,511,741
1000,465,479,501,224,510,734
1000,462,506,488,231,497,728
1000,507,491,487,245,516,761
1000,486,511,498,250,473,723
1000,531,500,504,272,497,769
1000,495,487,499,232,519,751
1000,512,533,465,272,464,736
1000,471,486,504,234,518,752
1000,508,483,504,257,502,759
1000,474,507,492,247,491,738
1000,497,533,515,268,493,761
1000,511,506,484,257,483,740
1000,517,495,500,247,515,762
1000,492,502,503,245,507,752
1000,507,500,494,232,513,745
1000,487,490,527,237,529,766
1000,506,516,503,261,496,757
1000,493,486,497,241,506,747
1000,492,483,532,240,515,755
1000,468,507,515,214,534,748
1000,496,508,488,257,487,744
1000,509,507,498,266,497,763
1000,506,507,522,254,511,765
1000,479,472,499,233,507,740
1000,496,497,497,247,498,745
1000,490,513,527,252,527,779
1000,500,504,523,252,501,753
1000,502,525,491,257,482,739
1000,499,502,496,260,487,747
1000,515,516,508,275,495,770
1000,492,517,478,249,486,735
1000,493,490,516,238,501,739
1000,494,517,480,260,486,746
1000,499,491,504,249,499,748
1000,493,527,505,245,518,763
1000,511,521,488,273,482,755
1000,513,505,510,268,494,762
1000,483,516,516,259,498,757
1000,490,495,499,238,518,756
1000,517,523,507,266,501,767
1000,505,499,494,263,477,740
1000,518,490,486,256,501,757
1000,498,507,513,254,502,756
1000,500,504,503,265,488,753
1000,515,523,498,274,489,763
1000,497,490,482,247,489,736
1000,476,509,503,244,503,747
1000,493,488,478,233,496,729
1000,486,484,498,239,497,736
1000,481,503,493,233,490,723
1000,503,502,493,245,505,750
1000,507,507,512,264,495,759
1000,509,507,497,255,480,735
1000,492,509,507,263,485,748
1000,524,505,482,272,483,755
1000,511,487,512,236,530,766
1000,517,500,502,264,497,761
1000,484,521,492,255,478,733
1000,504,510,476,264,467,731
1000,531,515,509,266,510,776
1000,517,493,485,263,495,758
1000,508,519,503,281,486,767
1000,475,524,467,246,467,713
1000,515,504,493,253,508,761
1000,505,507,489,244,501,745
1000,510,501,496,245,503,748
1000,512,498,505,254,508,762
1000,524,500,504,260,503,763
1000,537,493,512,265,508,773
1000,492,480,507,238,530,768
1000,501,502,471,253,492,745
1000,506,506,498,242,511,753
1000,492,496,480,237,505,742
1000,499,502,532,253,516,769
1000,507,492,517,251,494,745
1000,508,496,488,259,496,755
1000,479,491,477,235,483,718
1000,509,511,537,265,499,764
1000,533,517,515,269,497,766
1000,494,499,482,251,482,733
1000,512,496,495,274,477,751
1000,495,480,525,228,529,757
1000,498,478,518,238,517,755
1000,507,492,500,238,521,759
1000,484,501,499,258,498,756
1000,503,524,497,271,487,758
1000,532,481,530,248,525,773
1000,470,493,516,237,500,737
1000,490,490,490,235,489,724
1000,509,501,505,251,505,756
1000,492,461,490,224,521,745
1000,523,509,481,264,491,755
1000,493,481,473,238,480,718
1000,492,519,498,261,474,735
1000,500,524,522,256,509,765
1000,487,517,481,252,482,734
1000,515,489,525,257,516,773
1000,501,504,493,259,482,741
1000,518,491,507,252,520,772
1000,545,503,498,268,501,769
1000,504,498,493,254,494,748
1000,510,490,527,249,516,765
1000,520,507,521,263,494,757
1000,490,504,499,251,493,744
1000,479,501,531,244,516,760
1000,493,496,486,246,481,727
1000,492,504,481,243,475,718
1000,512,480,488,253,495,748
1000,508,505,487,262,488,750
1000,519,486,498,256,499,755
1000,509,499,514,250,513,763
1000,497,512,512,258,493,751
1000,508,495,505,255,499,754
1000,476,472,522,219,531,750
1000,496,510,488,245,498,743
1000,537,509,509,273,500,773
1000,467,517,530,236,507,743
1000,493,511,511,257,496,753
1000,507,517,494,262,495,757
1000,475,461,486,228,499,727
1000,492,500,514,248,498,746
1000,513,503,505,263,499,762
1000,509,483,485,240,501,741
1000,480,481,518,233,522,755
1000,500,508,503,247,504,751
1000,481,511,513,237,520,757
1000,519,476,527,256,520,776
1000,520,458,481,230,526,756
1000,492,478,472,223,497,720
1000,513,486,518,250,539,789
1000,502,503,503,259,495,754
1000,494,535,500,268,480,748
1000,488,531,481,249,503,752
1000,484,469,489,223,520,743
1000,450,501,516,228,510,738
1000,500,478,492,230,519,749
1000,519,494,497,249,519,768
1000,497,490,505,242,503,745
1000,485,505,497,241,502,743
1000,460,506,488,229,494,723
1000,507,505,482,244,493,737
1000,491,498,505,238,510,748
1000,484,509,531,259,509,768
1000,496,502,496,245,505,750
1000,473,503,540,240,513,753
1000,479,476,503,214,526,740
1000,492,512,464,253,477,730
1000,519,491,469,254,490,744
1000,488,507,517,260,492,752
1000,494,499,496,234,505,739
1000,474,493,504,260,494,754
1000,470,509,502,237,484,721
1000,503,524,468,269,465,734
1000,477,481,510,218,534,752
1000,493,477,477,230,493,723
1000,510,502,508,259,500,759
1000,474,480,483,238,485,723
1000,495,472,500,248,489,737
1000,508,523,494,272,483,755
1000,498,475,502,246,496,742
1000,502,480,502,234,529,763
1000,518,490,522,247,533,780
1000,491,506,515,253,494,747
1000,481,487,483,227,501,728
1000,504,478,499,245,511,756
1000,530,529,514,281,485,766
1000,496,492,538,233,546,779
1000,499,490,493,241,514,755
1000,513,512,526,274,496,770
1000,499,516,508,266,489,755
1000,492,496,498,232,513,745
1000,490,498,496,249,500,749
1000,519,496,484,262,481,743
1000,514,470,485,250,499,749
1000,515,492,490,240,509,749
1000,483,488,512,240,498,738
1000,474,512,494,234,493,727
1000,481,503,503,236,506,742
1000,513,462,520,246,515,761
1000,479,541,503,271,478,749
1000,517,503,513,276,491,767
1000,495,503,504,243,504,747
1000,510,499,492,255,509,764
1000,490,522,511,249,490,739
1000,494,536,489,263,468,731
1000,499,478,506,241,501,742
1000,535,510,505,279,481,760
1000,512,520,487,270,473,743
1000,518,521,498,281,475,756
1000,493,516,499,247,503,750
1000,472,506,483,242,493,735
1000,492,487,497,236,512,748
1000,467,485,497,223,502,725
1000,519,513,493,254,505,759
1000,525,513,533,279,515,794
1000,496,526,515,259,495,754
1000,509,489,498,248,496,744
1000,528,503,489,274,498,772
1000,514,482,497,225,536,761
1000,478,475,496,220,519,739
1000,494,502,487,243,494,737
1000,504,494,484,254,484,738
1000,468,511,501,233,509,742
1000,493,499,520,252,491,743
1000,511,498,510,256,514,770
1000,506,489,499,246,508,754
1000,476,497,470,241,487,728
1000,476,497,507,233,499,732
1000,495,537,511,264,485,749
1000,484,494,494,230,507,737
1000,491,482,474,237,492,729
1000,514,513,494,268,478,746
1000,483,527,483,263,472,735
1000,483,506,461,238,489,727
1000,480,516,509,258,478,736
1000,512,518,525,262,507,769
1000,524,503,493,268,491,759
1000,525,493,515,263,508,771
1000,480,503,510,248,501,749
1000,501,489,504,238,506,744
1000,483,520,492,259,479,738
1000,503,493,510,241,503,744
1000,511,477,520,252,521,773
1000,506,492,491,252,500,752
1000,517,524,490,273,487,760
1000,500,507,505,254,488,742
1000,498,509,497,257,491,748
1000,508,468,498,253,492,745
1000,515,516,523,264,502,766
1000,497,513,486,258,491,749
1000,508,512,472,259,494,753
1000,485,476,507,216,531,747
1000,488,518,521,259,499,758
1000,476,486,473,231,470,701
1000,522,513,485,270,480,750
1000,480,509,502,234,500,734
1000,513,512,506,273,489,762
1000,549,501,484,279,495,774
1000,477,486,487,232,508,740
1000,508,482,494,251,495,746
1000,507,495,504,238,514,752
1000,499,507,544,247,522,769
1000,504,513,472,248,508,756
1000,516,524,507,270,494,764
1000,526,505,502,269,492,761
1000,473,493,521,237,519,756
1000,471,518,491,241,500,741
1000,501,512,506,267,492,759
1000,481,502,509,240,502,742
1000,500,503,507,257,503,760
1000,482,506,491,249,496,745
1000,513,525,515,259,505,764
1000,515,502,491,254,487,741
1000,510,509,509,260,508,768
1000,499,516,510,246,510,756
1000,500,490,499,232,518,750
1000,493,517,501,245,519,764
1000,494,523,510,269,486,755
1000,515,491,507,246,523,769
1000,484,499,502,239,506,745
1000,494,486,486,243,502,745
1000,478,492,518,244,480,724
1000,495,487,500,254,498,752
1000,490,504,516,233,517,750
1000,488,486,494,247,485,732
1000,511,487,530,253,520,773
1000,490,498,482,241,503,744
1000,473,501,494,254,491,745
1000,506,526,510,280,483,763
1000,488,504,466,256,443,699
1000,481,468,486,228,511,739
1000,518,504,511,258,495,753
1000,483,500,503,246,502,748
1000,508,491,523,256,503,759
1000,517,498,513,250,502,752
1000,508,519,510,258,506,764
1000,495,473,513,240,525,765
1000,490,492,495,224,513,737
1000,519,503,533,272,502,774
1000,497,488,486,238,508,746
1000,493,461,494,217,524,741
1000,505,474,514,218,539,757
1000,507,494,537,240,540,780
1000,483,502,471,247,476,723
1000,515,493,520,253,524,777
1000,475,530,511,257,490,747
1000,510,488,503,247,508,755
1000,495,472,503,232,524,756
1000,514,503,521,253,530,783
1000,497,514,530,247,517,764
1000,457,537,486,248,483,731
1000,483,508,504,241,508,749
1000,489,478,506,220,536,756
1000,495,464,487,225,518,743
1000,505,514,475,247,493,740
1000,510,488,502,237,537,774
1000,494,479,515,233,511,744
1000,501,505,502,252,494,746
1000,489,488,512,237,506,743
1000,484,468,491,227,514,741
1000,494,513,480,251,484,735
1000,492,508,503,246,496,742
1000,493,504,490,241,498,739
1000,484,488,501,239,505,744
1000,492,477,492,242,508,750
1000,493,481,495,243,519,762
1000,493,493,501,237,507,744
1000,472,504,482,239,487,726
1000,484,500,499,253,488,741
1000,496,482,485,240,505,745
1000,488,498,484,251,491,742
1000,491,515,517,249,510,759
1000,533,482,486,248,515,763
1000,512,518,508,270,487,757
1000,472,497,514,246,478,724
1000,505,529,500,254,493,747
1000,489,502,522,242,522,764
1000,482,511,521,247,514,761
1000,507,488,524,249,518,767
1000,510,535,504,282,473,755
1000,499,511,487,257,483,740
1000,472,535,489,261,466,727
1000,492,504,492,243,507,750
1000,487,491,494,236,498,734
1000,515,491,490,254,497,751
1000,522,505,494,272,472,744
1000,486,513,491,264,487,751
1000,506,494,515,251,514,765
1000,487,486,513,245,507,752
1000,477,510,489,241,507,748
1000,514,478,468,253,491,744
1000,480,506,506,234,523,757
1000,496,520,504,267,478,745
1000,500,502,504,249,497,746
1000,467,507,497,238,495,733
1000,488,498,477,244,488,732
1000,513,514,490,271,480,751
1000,510,493,484,249,491,740
1000,512,470,482,233,529,762
1000,495,503,517,250,510,760
1000,480,505,481,241,476,717
1000,513,523,492,283,469,752
1000,515,530,515,275,482,757
1000,485,486,490,237,512,749
1000,500,492,480,257,499,756
1000,485,514,495,231,497,728
1000,454,481,483,208,497,705
1000,498,492,511,247,495,742
1000,518,500,524,254,524,778
1000,521,479,499,260,501,761
1000,521,459,507,247,510,757
1000,500,507,499,246,495,741
1000,480,492,470,244,473,717
1000,524,510,497,261,503,764
1000,502,527,503,265,485,750
1000,492,549,511,279,464,743
1000,505,466,497,250,501,751
1000,510,491,547,256,515,771
1000,472,517,513,243,499,742
1000,522,522,507,271,495,766
1000,512,507,511,256,516,772
1000,513,507,487,264,495,759
1000,515,500,510,274,488,762
1000,487,501,507,234,514,748
1000,523,496,530,261,524,785
1000,498,509,489,258,488,746
1000,474,508,489,243,502,745
1000,517,504,525,264,510,774
1000,501,482,493,253,487,740
1000,512,491,511,253,512,765
1000,516,500,469,259,463,722
1000,486,494,460,227,481,708
1000,503,483,477,233,502,735
1000,511,503,527,266,520,786
1000,508,511,467,255,484,739
1000,495,510,515,270,493,763
1000,517,509,504,268,483,751
1000,491,517,497,277,468,745
1000,515,500,495,262,490,752
1000,504,495,511,252,505,757
1000,488,506,487,255,481,736
1000,469,532,479,249,461,710
1000,511,490,522,267,498,765
1000,475,482,489,227,500,727
1000,501,480,475,244,492,736
1000,488,508,505,246,506,752
1000,491,497,519,252,489,741
1000,489,487,506,235,516,751
1000,469,486,526,220,524,744
1000,486,467,529,237,519,756
1000,486,490,504,228,507,735
1000,486,512,509,248,507,755
1000,483,491,490,250,486,736
1000,482,519,496,240,509,749
1000,504,496,466,254,488,742
1000,499,494,491,244,510,754
1000,521,499,477,260,492,752
1000,485,521,508,245,505,750
1000,479,520,493,251,487,738
1000,503,478,509,236,518,754
1000,535,476,498,260,500,760
1000,511,490,486,265,509,774
1000,514,492,522,260,511,771
1000,495,488,485,244,495,739
1000,514,538,487,278,463,741
1000,488,482,473,237,505,742
1000,505,502,506,253,509,762
1000,518,535,491,283,475,758
1000,507,496,478,254,492,746
1000,494,512,507,260,500,760
1000,481,484,494,241,497,738
1000,503,529,497,257,488,745
1000,499,502,523,257,503,760
1000,455,489,519,229,508,737
1000,485,504,531,250,515,765
1000,479,492,499,246,499,745
1000,505,481,485,236,497,733
1000,512,505,496,257,510,767
1000,508,496,491,256,493,749
1000,526,501,503,266,483,749
1000,485,497,507,233,514,747
1000,502,504,492,247,504,751
1000,509,477,515,252,520,772
1000,500,508,494,254,492,746
1000,510,498,516,261,498,759
1000,480,503,498,239,487,726
1000,466,484,497,227,506,733
1000,487,509,502,243,493,736
1000,485,505,509,253,500,753
1000,494,487,525,242,523,765
1000,481,500,501,252,497,749
1000,521,496,515,233,540,773
1000,504,497,512,248,513,761
1000,516,486,495,250,527,777
1000,502,499,502,251,501,752
1000,501,504,537,252,520,772
1000,503,508,503,252,494,746
1000,527,499,501,268,500,768
1000,493,493,516,238,506,744
1000,501,492,494,253,503,756
1000,488,517,461,252,481,733
1000,492,513,508,257,494,751
1000,501,515,518,260,506,766
1000,495,511,484,251,493,744
1000,492,499,520,247,517,764
1000,489,524,519,250,498,748
1000,465,502,504,234,500,734
1000,516,500,514,252,508,760
1000,498,486,502,252,500,752
1000,505,504,518,254,516,770
1000,489,497,482,253,475,728
1000,493,485,503,227,517,744
1000,518,502,476,265,491,756
1000,488,499,502,227,519,746
1000,552,506,528,276,520,796
1000,505,491,524,260,521,781
1000,508,477,504,247,524,771
1000,506,501,493,253,487,740
1000,485,497,496,231,518,749
1000,496,523,541,258,517,775
1000,477,494,529,220,539,759
1000,485,463,493,222,531,753
1000,494,513,485,243,489,732
1000,503,506,509,255,499,754
1000,506,480,502,244,507,751
1000,506,523,468,262,477,739
1000,538,490,473,281,463,744
1000,512,508,500,269,484,753
1000,513,464,501,245,528,773
1000,478,496,512,235,515,750
1000,503,501,495,250,484,734
1000,488,497,514,243,511,754
1000,483,484,518,244,512,756
1000,475,482,509,228,514,742
1000,490,495,484,246,496,742
1000,483,490,486,240,489,729
1000,498,481,503,243,510,753
1000,481,505,488,259,485,744
1000,524,480,515,253,517,770
1000,529,535,482,286,459,745
1000,511,529,495,261,491,752
1000,486,501,506,243,504,747
1000,508,479,498,252,493,745
1000,519,505,513,256,512,768
1000,469,504,491,241,504,745
1000,492,515,511,256,493,749
1000,505,505,521,273,499,772
1000,494,485,500,242,505,747
1000,497,482,499,243,506,749
1000,501,491,495,241,493,734
1000,512,531,503,275,481,756
1000,518,493,502,268,500,768
1000,503,485,498,245,501,746
1000,522,517,490,270,487,757
1000,517,516,492,261,499,760
1000,501,517,505,264,487,751
1000,478,497,538,236,535,771
1000,501,469,531,240,529,769
1000,491,481,515,246,509,755
1000,510,501,512,247,524,771
1000,504,475,523,239,522,761
1000,508,526,483,266,475,741
1000,489,475,491,240,495,735
1000,505,500,488,248,501,749
1000,478,489,497,232,507,739
1000,497,473,478,221,505,726
1000,514,501,463,260,484,744
1000,519,528,503,260,500,760
1000,506,487,516,249,505,754
1000,521,508,499,254,507,761
1000,475,501,506,241,500,741
1000,526,492,500,262,501,763
1000,497,512,513,262,493,755
1000,512,543,482,273,480,753
1000,482,503,514,233,517,750
1000,511,540,511,264,499,763
1000,507,487,487,245,501,746
1000,505,525,493,252,483,735
1000,482,477,483,227,504,731
1000,482,509,497,252,473,725
1000,499,482,492,242,504,746
1000,496,525,470,265,474,739
1000,510,474,513,248,529,777
1000,505,503,499,246,509,755
1000,510,495,515,256,505,761
1000,501,518,516,254,504,758
1000,511,481,478,258,481,739
1000,510,480,521,244,512,756
1000,500,494,505,249,497,746
1000,518,524,491,272,473,745
1000,483,517,480,259,459,718
1000,481,476,491,234,514,748
1000,491,486,475,234,499,733
1000,491,525,513,256,496,752
1000,484,518,505,241,517,758
1000,477,498,499,249,487,736
1000,496,506,472,250,481,731
1000,481,509,512,250,494,744
1000,494,504,479,245,500,745
1000,494,508,496,259,479,738
1000,468,492,500,239,494,733
1000,514,505,536,259,513,772
1000,516,514,500,271,476,747
1000,503,519,472,265,486,751
1000,478,479,500,229,503,732
1000,490,489,508,250,512,762
1000,478,485,502,231,507,738
1000,494,487,487,239,498,737
1000,516,478,488,244,497,741
1000,491,489,494,233,506,739
1000,487,508,504,255,499,754
1000,488,500,505,248,499,747
1000,506,496,483,247,496,743
1000,528,508,482,275,491,766
1000,503,510,532,258,504,762
1000,483,499,501,242,504,746
1000,513,496,473,258,483,741
1000,486,497,512,249,493,742
1000,516,511,491,274,474,748
1000,526,473,514,246,532,778
1000,492,480,478,245,508,753
1000,483,512,493,244,483,727
1000,519,513,516,266,500,766
1000,494,514,494,259,487,746
1000,497,491,520,246,515,761
1000,481,526,495,248,498,746
1000,507,508,507,254,493,747
1000,482,505,508,248,498,746
1000,504,495,513,241,507,748
1000,485,495,516,229,518,747
1000,484,472,470,245,489,734
1000,467,525,496,242,479,721
1000,531,503,493,270,497,767
1000,503,491,497,247,495,742
1000,511,507,527,267,511,778
1000,493,495,480,250,487,737
1000,498,496,513,235,530,765
1000,517,502,505,261,506,767
1000,485,504,512,239,497,736
1000,485,493,487,236,495,731
1000,518,496,524,265,510,775
1000,492,489,507,235,498,733
1000,508,509,497,256,488,744
1000,498,495,499,244,505,749
1000,519,486,493,238,536,774
1000,486,500,484,227,501,728
1000,511,499,502,252,512,764
1000,517,506,473,262,486,748
1000,522,501,495,250,503,753
1000,508,505,535,259,520,779
1000,523,518,502,263,505,768
1000,489,536,494,262,462,724
1000,516,484,503,245,515,760
1000,495,496,494,245,506,751
1000,485,495,507,238,507,745
1000,513,522,516,273,494,767
1000,498,499,497,240,516,756
1000,500,526,503,247,510,757
1000,493,504,496,247,480,727
1000,516,476,501,254,502,756
1000,502,534,516,262,500,762
1000,524,507,503,267,498,765
1000,521,508,477,265,483,748
1000,494,506,469,251,486,737
1000,462,502,482,229,483,712
1000,515,483,494,244,518,762
1000,490,474,511,235,505,740
1000,475,507,507,242,492,734
1000,490,483,522,236,522,758
1000,476,497,494,224,515,739
1000,498,493,525,240,501,741
1000,484,468,483,212,507,719
1000,502,503,474,237,512,749
1000,481,496,521,246,515,761
1000,497,522,517,246,515,761
1000,486,512,517,258,497,755
1000,488,501,519,241,519,760
1000,501,500,501,253,486,739
1000,514,515,509,270,506,776
1000,516,469,466,252,492,744
1000,480,509,489,232,508,740
1000,508,515,510,267,493,760
1000,479,482,512,243,504,747
1000,535,526,482,281,476,757
1000,500,507,510,258,503,761
1000,513,502,519,260,506,766
1000,523,483,463,260,482,742
1000,514,513,485,278,477,755
1000,494,487,501,226,541,767
1000,503,504,500,254,499,753
1000,504,502,488,257,485,742
1000,486,501,510,243,509,752
1000,504,495,499,248,518,766
1000,503,499,493,255,483,738
1000,500,500,516,249,516,765
1000,498,525,502,250,507,757
1000,495,481,516,241,510,751
1000,489,497,466,243,468,711
1000,519,518,476,265,480,745
1000,462,512,490,237,491,728
1000,509,476,508,242,522,764
1000,490,497,492,250,495,745
1000,523,496,501,255,508,763
1000,495,480,524,232,526,758
1000,493,507,491,251,483,734
1000,506,500,493,256,496,752
1000,501,488,490,258,494,752
1000,478,507,493,244,499,743
1000,508,504,512,257,518,775
1000,488,534,489,247,498,745
1000,510,508,496,245,508,753
1000,500,511,493,251,496,747
1000,498,478,478,232,504,736
1000,505,511,479,244,502,746
1000,495,506,488,247,490,737
1000,505,481,492,246,507,753
1000,491,508,472,246,472,718
1000,504,495,495,260,500,760
1000,537,500,537,267,492,759
1000,502,507,486,258,485,743
1000,514,507,502,256,494,750
1000,499,506,491,239,504,743
1000,494,528,487,254,497,751
1000,489,510,468,260,475,735
1000,505,506,481,252,508,760
1000,494,515,483,244,497,741
1000,500,513,533,258,508,766
1000,507,486,508,262,490,752
1000,491,516,506,258,492,750
1000,502,497,483,245,484,729
1000,493,517,512,254,498,752
1000,494,476,508,225,516,741
1000,510,491,517,259,502,761
1000,492,513,526,255,495,750
1000,532,484,485,250,519,769
1000,528,486,559,259,541,800
1000,485,501,498,248,501,749
1000,531,496,489,251,522,773
1000,475,491,529,228,529,757
1000,517,501,497,272,484,756
1000,501,529,484,252,493,745
1000,494,498,500,248,500,748
1000,484,496,513,239,520,759
1000,496,515,505,253,473,726
1000,484,504,487,233,505,738
1000,493,507,494,251,463,714
1000,483,512,514,265,484,749
1000,524,520,514,287,479,766
1000,500,520,495,253,487,740
1000,505,512,489,270,479,749
1000,508,510,527,235,521,756
1000,494,485,493,250,498,748
1000,448,503,487,226,497,723
1000,493,484,493,242,492,734
1000,482,505,484,242,486,728
1000,512,532,490,276,465,741
1000,502,518,534,266,514,780
1000,489,475,537,227,528,755
1000,511,522,493,260,498,758
1000,507,489,500,260,494,754
1000,479,501,515,252,488,740
1000,508,519,507,247,524,771
1000,502,508,498,269,482,751
1000,486,497,533,233,523,756
1000,484,493,511,237,507,744
1000,522,481,513,251,528,779
1000,497,523,520,252,503,755
1000,520,507,501,281,496,777
1000,498,482,523,248,503,751
1000,486,498,497,248,486,734
1000,489,540,480,257,466,723
1000,504,495,499,238,507,745
1000,495,515,509,254,510,764
1000,518,489,490,252,501,753
1000,509,501,485,262,496,758
1000,529,495,487,263,486,749
1000,539,476,486,256,515,771
1000,508,506,479,254,496,750
1000,483,509,510,240,508,748
1000,514,483,485,257,494,751
1000,510,516,491,262,472,734
1000,480,533,498,267,473,740
1000,459,516,527,245,505,750
1000,526,494,498,263,508,771
1000,515,488,494,256,496,752
1000,453,483,514,225,521,746
1000,465,500,514,215,524,739
1000,490,522,530,264,500,764
1000,502,508,493,265,479,744
1000,523,508,497,270,480,750
1000,473,512,504,242,498,740
1000,476,507,500,251,489,740
1000,479,499,494,253,473,726
1000,521,490,501,263,490,753
1000,530,517,525,262,513,775
1000,494,510,519,264,497,761
1000,491,463,505,230,510,740
1000,488,468,507,228,518,746
1000,475,480,497,214,514,728
1000,486,490,498,247,505,752
1000,465,486,501,217,527,744
1000,501,514,510,249,518,767
1000,505,516,488,245,503,748
1000,481,493,504,247,495,742
1000,499,503,490,254,503,757
1000,490,512,530,258,495,753
1000,490,507,507,243,517,760
1000,525,519,487,265,493,758
1000,498,516,504,253,500,753
1000,491,479,515,227,521,748
1000,511,480,510,247,519,766
1000,491,500,520,256,501,757
1000,506,494,508,249,516,765
1000,509,520,507,264,480,744
1000,469,490,490,229,493,722
1000,494,517,518,245,512,757
1000,493,494,481,251,499,750
1000,526,472,498,253,518,771
1000,514,492,489,255,499,754
1000,516,498,532,252,517,769
1000,510,491,517,259,506,765
1000,486,512,514,257,511,768
1000,490,503,514,246,523,769
1000,509,463,482,243,499,742
1000,513,507,456,253,485,738
1000,510,511,516,247,507,754
1000,492,499,509,248,487,735
1000,524,509,527,276,511,787
1000,484,494,513,230,516,746
1000,514,527,498,261,489,750
1000,496,502,502,254,497,751
1000,510,494,501,248,514,762
1000,493,491,480,241,502,743
1000,493,499,505,240,513,753
1000,476,509,518,240,501,741
1000,511,498,470,256,481,737
1000,494,534,495,265,473,738
1000,501,520,489,262,471,733
1000,521,505,492,257,497,754
1000,501,496,525,241,519,760
1000,482,493,483,232,504,736
1000,505,481,503,241,509,750
1000,503,504,509,258,497,755
1000,501,484,511,254,504,758
1000,507,498,496,255,495,750
1000,531,509,484,268,485,753
1000,524,513,503,282,472,754
1000,484,540,502,245,506,751
1000,484,529,472,247,472,719
1000,491,488,534,236,532,768
1000,498,481,476,253,485,738
1000,483,528,507,258,483,741
1000,492,492,493,224,506,730
1000,514,511,500,272,493,765
1000,494,526,475,267,456,723
1000,512,497,483,259,489,748
1000,520,499,472,270,489,759
1000,537,520,497,283,485,768
1000,517,501,502,258,509,767
1000,514,522,515,269,502,771
1000,493,502,494,238,511,749
1000,537,508,481,265,486,751
1000,497,496,490,250,503,753
1000,532,483,501,253,508,761
1000,526,499,515,259,513,772
1000,520,502,500,258,510,768
1000,488,509,477,251,497,748
1000,496,498,500,246,516,762
1000,502,509,514,284,465,749
1000,502,494,508,249,502,751
1000,497,490,535,231,538,769
1000,521,499,505,258,495,753
1000,493,494,467,242,480,722
1000,511,484,530,253,518,771
1000,500,522,489,257,485,742
1000,469,529,502,247,481,728
1000,508,493,514,248,521,769
1000,487,508,501,250,489,739
1000,496,522,501,249,505,754
1000,512,471,511,220,548,768
1000,534,506,476,262,499,761
1000,529,488,533,262,515,777
1000,500,510,525,272,495,767
1000,509,490,501,240,518,758
1000,523,517,489,277,482,759
1000,492,492,492,256,502,758
1000,495,497,527,248,517,765
1000,498,485,515,231,519,750
1000,498,502,528,256,498,754
1000,519,500,465,252,495,747
1000,487,514,537,253,504,757
1000,525,502,487,266,484,750
1000,503,484,500,231,519,750
1000,470,491,462,227,494,721
1000,525,495,513,265,501,766
1000,522,486,483,246,518,764
1000,482,495,497,241,495,736
1000,483,525,507,250,493,743
1000,494,495,488,238,498,736
1000,536,529,503,288,489,777
1000,482,496,519,245,494,739
1000,494,485,500,250,486,736
1000,492,507,509,260,483,743
1000,489,525,469,256,482,738
1000,510,502,517,268,479,747
1000,463,499,516,234,498,732
1000,481,496,497,249,482,731
1000,512,525,485,263,486,749
1000,520,520,464,272,470,742
1000,509,487,497,267,485,752
1000,515,513,483,266,481,747
1000,479,489,509,224,539,763
1000,555,508,506,284,494,778
1000,473,498,514,227,516,743
1000,471,489,510,230,523,753
1000,485,499,498,234,503,737
1000,499,509,520,256,489,745
1000,499,502,490,245,497,742
1000,509,489,501,256,489,745
1000,504,482,508,231,523,754
1000,523,466,508,238,518,756
1000,487,496,487,240,501,741
1000,493,494,500,242,505,747
1000,498,511,501,258,494,752
1000,503,486,507,239,522,761
1000,501,489,491,247,509,756
1000,486,494,521,234,516,750
1000,470,516,528,252,496,748
1000,481,510,503,248,496,744
1000,480,511,544,251,517,768
1000,524,507,493,269,493,762
1000,474,508,506,245,484,729
1000,472,514,495,242,489,731
1000,501,488,527,249,515,764
1000,506,513,486,254,496,750
1000,521,493,522,247,536,783
1000,499,506,497,250,500,750
1000,476,489,507,238,507,745
1000,480,511,503,242,485,727
1000,496,507,523,243,510,753
1000,517,490,504,249,505,754
1000,532,487,515,252,516,768
1000,493,506,515,253,488,741
1000,508,514,498,275,483,758
1000,492,503,472,261,476,737
1000,489,481,514,234,505,739
1000,525,523,520,264,504,768
1000,496,505,499,247,505,752
1000,516,522,494,276,485,761
1000,499,509,484,261,474,735
1000,491,512,507,261,465,726
1000,498,529,496,266,492,758
1000,508,513,498,263,489,752
1000,518,509,512,258,523,781
1000,506,491,507,258,506,764
1000,501,485,504,251,505,756
1000,500,504,510,243,500,743
1000,474,525,513,255,485,740
1000,506,501,476,228,505,733
1000,502,486,492,246,503,749
1000,510,491,505,245,518,763
1000,503,495,511,254,495,749
1000,493,496,522,229,540,769
1000,487,521,502,259,478,737
1000,482,488,499,230,487,717
1000,520,486,472,241,510,751
1000,523,483,492,254,496,750
1000,517,495,486,261,490,751
1000,492,497,479,257,474,731
1000,477,482,508,228,518,746
1000,503,483,529,256,497,753
1000,475,499,499,234,514,748
1000,506,494,507,251,504,755
1000,515,503,483,262,484,746
1000,483,499,503,247,491,738
1000,500,520,506,273,477,750
1000,490,515,502,233,519,752
1000,503,513,510,240,525,765
1000,509,519,481,269,470,739
1000,487,509,502,247,489,736
1000,503,517,495,253,491,744
1000,479,512,488,234,482,716
1000,524,516,501,262,497,759
1000,535,510,531,272,515,787
1000,479,483,478,221,508,729
1000,496,505,508,255,508,763
1000,505,488,498,247,499,746
1000,503,475,495,239,504,743
1000,514,468,512,238,512,750
1000,492,504,482,246,491,737
1000,510,494,492,259,511,770
1000,489,508,497,249,488,737
1000,480,511,480,254,468,722
1000,480,494,527,241,511,752
1000,500,508,485,251,479,730
1000,525,468,489,246,518,764
1000,504,503,475,250,485,735
1000,496,499,478,234,501,735
1000,511,481,519,243,505,748
1000,474,457,486,221,503,724
1000,491,494,507,236,520,756
1000,534,493,540,267,524,791
1000,518,514,503,253,516,769
1000,520,508,464,271,484,755
1000,519,493,511,259,509,768
1000,498,545,519,290,479,769
1000,518,519,511,274,503,777
1000,500,477,506,228,522,750
1000,509,497,485,242,503,745
1000,492,505,503,247,499,746
1000,489,512,478,250,475,725
1000,514,489,486,247,507,754
1000,488,433,505,213,547,760
1000,502,510,512,263,490,753
1000,501,510,471,250,484,734
1000,496,519,511,253,492,745
1000,504,531,482,267,461,728
1000,513,500,502,250,515,765
1000,488,490,506,237,505,742
1000,511,507,501,259,476,735
1000,506,532,523,274,491,765
1000,489,503,516,239,508,747
1000,528,512,502,261,500,761
1000,502,488,496,250,492,742
1000,475,462,491,213,518,731
1000,506,493,499,248,499,747
1000,497,512,471,255,477,732
1000,517,526,507,273,486,759
1000,525,521,535,270,508,778
1000,491,492,503,243,511,754
1000,502,493,502,243,512,755
1000,519,514,478,268,477,745
1000,509,486,464,243,482,725
1000,515,512,494,262,496,758
1000,524,505,505,273,483,756
1000,510,489,500,253,515,768
1000,500,474,476,234,508,742
1000,519,494,488,261,488,749
1000,538,498,491,265,501,766
1000,499,493,516,237,516,753
1000,492,482,505,228,518,746
1000,510,496,524,249,512,761
1000,506,504,477,244,503,747
1000,490,498,502,239,503,742
1000,525,484,492,250,497,747
1000,524,534,507,284,469,753
1000,497,531,512,275,494,769
1000,502,529,492,264,483,747
1000,481,505,500,251,500,751
1000,524,515,518,270,479,749
1000,499,484,500,244,502,746
1000,516,490,485,241,511,752
1000,500,503,484,238,508,746
1000,509,500,480,260,483,743
1000,510,497,522,251,519,770
1000,518,482,467,259,479,738
1000,477,489,525,233,523,756
1000,505,523,477,246,505,751
1000,478,522,530,247,518,765
1000,479,501,494,223,507,730
1000,504,498,504,249,512,761
1000,494,512,480,250,480,730
1000,523,506,485,274,461,735
1000,498,500,459,248,486,734
1000,505,525,493,262,485,747
1000,486,492,497,242,501,743
1000,511,502,510,262,495,757
1000,500,480,506,235,511,746
1000,489,502,468,234,485,719
1000,500,505,498,265,492,757
1000,499,496,523,254,495,749
1000,485,502,489,243,490,733
1000,479,512,525,245,526,771
1000,495,512,524,256,503,759
1000,502,509,491,251,484,735
1000,497,481,486,232,506,738
1000,481,479,500,228,513,741
1000,488,502,486,257,475,732
1000,515,491,509,259,500,759
1000,492,483,508,234,507,741
1000,498,502,497,252,490,742
1000,491,494,487,241,496,737
1000,484,512,491,251,497,748
1000,507,521,499,270,473,743
1000,494,494,514,244,500,744
1000,517,501,525,257,514,771
1000,482,491,504,226,514,740
1000,488,510,513,248,518,766
1000,464,499,489,243,494,737
1000,502,511,494,270,484,754
1000,515,507,522,275,486,761
1000,515,499,513,264,497,761
1000,534,496,484,265,509,774
1000,519,520,526,273,504,777
1000,509,495,508,265,500,765
1000,500,496,511,250,495,745
1000,521,483,474,257,475,732
1000,502,489,498,248,492,740
1000,486,523,529,261,490,751
1000,478,490,491,242,486,728
1000,503,482,479,255,482,737
1000,474,511,493,239,488,727
1000,513,482,518,239,529,768
1000,508,479,517,249,517,766
1000,516,520,506,267,488,755
1000,509,491,512,244,510,754
1000,530,520,491,266,487,753
1000,492,507,472,247,495,742
1000,468,518,502,238,499,737
1000,508,484,494,251,505,756
1000,521,490,503,258,504,762
1000,506,494,493,256,495,751
1000,481,474,486,222,509,731
1000,521,515,505,287,490,777
1000,484,518,486,253,478,731
1000,538,492,509,269,502,771
1000,510,491,514,247,520,767
1000,502,491,488,250,480,730
1000,509,483,472,254,479,733
1000,490,498,497,246,491,737
1000,490,479,507,231,511,742
1000,490,525,517,248,514,762
1000,499,505,503,260,483,743
1000,524,502,504,251,519,770
1000,517,510,477,261,484,745
1000,510,479,493,243,511,754
1000,517,520,495,268,484,752
1000,488,503,492,239,495,734
1000,507,462,497,235,519,754
1000,464,498,503,239,491,730
1000,522,497,504,259,516,775
1000,492,493,494,248,489,737
1000,481,515,492,252,485,737
1000,492,491,509,247,498,745
1000,490,505,494,243,518,761
1000,542,501,494,271,507,778
1000,520,500,488,262,495,757
1000,506,512,473,259,489,748
1000,490,502,483,234,504,738
1000,489,518,558,246,521,767
1000,494,515,512,243,514,757
1000,493,494,524,248,502,750
1000,523,489,519,258,509,767
1000,506,500,531,265,506,771
1000,491,496,503,254,496,750
1000,506,494,479,256,487,743
1000,491,508,507,236,511,747
1000,481,513,495,254,494,748
1000,497,512,516,251,500,751
1000,513,499,496,280,475,755
1000,502,491,521,253,515,768
1000,489,510,487,250,496,746
1000,463,520,483,216,510,726
1000,504,502,482,260,492,752
1000,480,517,518,255,507,762
1000,495,518,526,259,508,767
1000,522,486,466,255,498,753
1000,495,517,501,266,486,752
1000,535,496,525,257,524,781
1000,505,501,503,260,494,754
1000,489,474,501,238,502,740
1000,499,499,502,247,502,749
1000,497,513,488,249,484,733
1000,506,486,529,247,518,765
1000,489,508,511,244,507,751
1000,502,480,513,244,524,768
1000,507,494,487,235,517,752
1000,527,497,508,261,513,774
1000,489,492,520,239,517,756
1000,488,495,493,238,503,741
1000,513,525,486,278,466,744
1000,500,478,504,233,517,750
1000,494,502,497,261,486,747
1000,514,451,515,239,512,751
1000,506,479,496,228,530,758
1000,514,497,502,253,512,765
1000,505,506,527,255,511,766
1000,499,461,496,239,510,749
1000,531,502,524,261,518,779
1000,495,497,478,235,499,734
1000,487,498,488,240,511,751
1000,502,494,497,245,509,754
1000,494,494,487,243,500,743
1000,512,483,522,254,529,783
1000,478,513,493,234,499,733
1000,513,504,496,269,490,759
1000,480,506,522,252,498,750
1000,509,514,487,271,473,744
1000,498,498,483,245,506,751
1000,506,521,486,263,486,749
1000,517,507,525,245,533,778
1000,500,508,486,269,484,753
1000,520,501,481,264,479,743
1000,476,521,526,248,500,748
1000,488,540,485,251,488,739
1000,503,506,489,253,487,740
1000,510,521,499,287,464,751
1000,511,489,485,253,493,746
1000,488,467,517,233,537,770
1000,508,539,502,277,479,756
1000,513,477,486,244,514,758
1000,500,515,492,251,500,751
1000,512,472,480,231,520,751
1000,515,487,530,261,505,766
1000,492,502,485,237,483,720
1000,487,501,485,234,504,738
1000,502,500,483,238,503,741
1000,495,508,525,250,509,759
1000,491,490,485,224,506,730
1000,520,528,488,275,491,766
1000,500,476,498,240,497,737
1000,504,488,512,231,533,764
1000,475,485,510,229,510,739
1000,518,505,490,264,479,743
1000,482,508,513,266,482,748
1000,500,472,500,222,522,744
1000,506,508,505,265,501,766
1000,500,493,489,251,496,747
1000,519,502,486,259,490,749
1000,523,497,536,251,527,778
1000,489,466,488,222,515,737
1000,509,513,515,256,498,754
1000,499,521,503,264,483,747
1000,491,516,470,263,467,730
1000,502,508,494,255,504,759
1000,499,509,489,242,499,741
1000,502,509,489,266,472,738
1000,486,474,516,238,519,757
1000,506,498,487,239,506,745
1000,515,512,474,274,485,759
1000,517,504,499,264,501,765
1000,485,526,509,248,494,742
1000,526,507,509,274,503,777
1000,496,507,497,250,499,749
1000,504,512,535,269,495,764
1000,512,531,524,260,513,773
1000,503,506,515,239,521,760
1000,477,468,493,209,516,725
1000,528,525,515,280,499,779
1000,477,478,486,225,496,721
1000,503,473,509,223,539,762
1000,480,536,503,264,470,734
1000,490,493,522,252,516,768
1000,494,513,507,260,493,753
1000,506,504,527,247,527,774
1000,472,534,500,254,486,740
1000,493,498,508,244,512,756
1000,516,512,493,258,498,756
1000,494,508,515,245,519,764
1000,496,506,497,258,475,733
1000,506,503,509,257,502,759
1000,507,500,517,264,498,762
1000,511,527,467,279,445,724
1000,497,507,519,254,507,761
1000,484,517,508,247,489,736
1000,494,515,509,248,503,751
1000,488,504,476,239,479,718
1000,474,519,466,243,466,709
1000,507,491,508,247,517,764
1000,513,481,515,249,514,763
1000,506,481,519,251,513,764
1000,480,500,471,238,494,732
1000,511,484,492,252,494,746
1000,516,483,504,240,526,766
1000,513,508,514,251,515,766
1000,506,522,488,267,468,735
1000,485,492,512,262,480,742
1000,520,524,503,258,509,767
1000,514,520,503,261,493,754
1000,492,501,532,237,520,757
1000,478,489,485,221,509,730
1000,490,523,486,272,443,715
1000,554,498,520,276,516,792
1000,515,495,514,254,508,762
1000,510,505,488,261,488,749
1000,503,499,489,252,491,743
1000,525,495,498,266,496,762
1000,485,480,499,240,494,734
1000,520,480,503,240,519,759
1000,502,484,512,239,521,760
1000,503,510,508,240,522,762
1000,495,507,512,245,489,734
1000,492,488,478,233,494,727
1000,471,497,482,251,465,716
1000,486,476,497,235,509,744
1000,497,502,506,260,484,744
1000,498,494,504,266,493,759
1000,503,494,519,242,527,769
1000,499,490,503,241,508,749
1000,485,493,498,231,530,761
1000,514,496,487,254,491,745
1000,509,488,487,255,506,761
1000,525,465,505,251,518,769
1000,498,488,524,245,516,761
1000,513,492,514,253,493,746
1000,506,519,513,271,489,760
1000,511,494,510,264,517,781
1000,495,490,505,240,517,757
1000,540,496,523,265,520,785
1000,472,505,508,246,484,730
1000,487,495,511,235,508,743
1000,518,494,523,259,506,765
1000,507,503,484,264,480,744
1000,496,481,512,225,534,759
1000,480,501,497,234,507,741
1000,523,481,496,254,507,761
1000,498,514,500,260,490,750
1000,519,512,533,273,496,769
1000,518,504,499,248,504,752
1000,485,490,494,224,517,741
1000,495,524,488,247,488,735
1000,511,490,521,255,514,769
1000,494,491,537,257,511,768
1000,510,497,489,257,484,741
1000,507,486,523,257,509,766
1000,525,508,481,277,475,752
1000,496,497,522,254,501,755
1000,499,490,486,236,496,732
1000,511,488,497,237,520,757
1000,472,492,514,220,528,748
1000,515,514,503,261,509,770
1000,507,527,514,275,484,759
1000,501,482,507,247,502,749
1000,486,495,500,243,499,742
1000,496,530,496,265,484,749
1000,501,517,494,256,489,745
1000,498,513,517,261,493,754
1000,519,483,496,258,518,776
1000,503,476,489,234,519,753
1000,486,506,509,232,511,743
1000,469,496,510,245,498,743
1000,487,507,500,266,472,738
1000,514,527,462,275,461,736
1000,485,503,496,244,495,739
1000,482,530,495,250,489,739
1000,503,477,502,245,517,762
1000,508,517,493,268,472,740
1000,521,482,461,267,472,739
1000,497,493,510,245,519,764
1000,511,507,486,263,501,764
1000,511,499,458,258,476,734
1000,525,495,499,260,496,756
1000,477,521,497,264,469,733
1000,522,506,513,277,511,788
1000,503,498,531,255,515,770
1000,486,500,515,249,495,744
1000,528,538,515,284,493,777
1000,522,509,487,268,485,753
1000,493,510,509,254,495,749
1000,510,493,493,268,484,752
1000,497,533,480,266,464,730
1000,492,493,460,232,511,743
1000,513,506,472,257,471,728
1000,507,488,475,256,486,742
1000,496,509,498,254,515,769
1000,510,495,492,239,514,753
1000,469,502,469,231,473,704
1000,457,506,494,231,495,726
1000,501,481,518,249,505,754
1000,514,505,494,272,489,761
1000,448,505,487,244,466,710
1000,458,488,484,232,491,723
1000,483,498,523,248,499,747
1000,505,494,504,263,484,747
1000,519,477,531,245,530,775
1000,501,464,525,238,529,767
1000,542,504,511,276,507,783
1000,496,516,462,240,484,724
1000,511,502,500,267,492,759
1000,500,504,506,248,519,767
1000,492,530,499,259,501,760
1000,478,495,499,250,485,735
1000,475,482,509,230,518,748
1000,516,471,504,253,520,773
1000,481,532,487,256,454,710
1000,497,497,479,255,496,751
1000,478,476,491,239,496,735
1000,507,528,517,276,489,765
1000,499,510,492,242,515,757
1000,502,505,522,262,499,761
1000,511,488,499,254,508,762
1000,511,507,502,252,500,752
1000,519,501,509,271,496,767
1000,488,471,524,243,519,762
1000,503,527,495,261,488,749
1000,496,483,531,243,527,770
1000,468,526,517,236,511,747
1000,512,506,540,256,527,783
1000,493,468,497,227,524,751
1000,512,517,506,247,509,756
1000,489,509,505,247,502,749
1000,517,509,512,274,481,755
1000,516,503,480,253,496,749
1000,474,471,500,221,510,731
1000,508,534,480,264,485,749
1000,494,512,499,260,499,759
1000,493,496,482,235,500,735
1000,511,491,492,250,508,758
1000,507,511,496,264,486,750
1000,489,489,512,238,529,767
1000,502,496,487,235,503,738
1000,521,535,499,276,486,762
1000,462,503,510,224,510,734
1000,538,493,523,268,512,780
1000,500,500,522,243,517,760
1000,483,479,497,225,513,738
1000,518,495,498,259,493,752
1000,514,510,516,256,518,774
1000,538,505,465,275,476,751
1000,501,501,523,261,506,767
1000,498,478,488,241,504,745
1000,496,480,493,235,515,750
1000,480,473,508,231,510,741
1000,529,509,499,259,496,755
1000,507,480,486,227,509,736
1000,517,497,489,267,502,769
1000,499,479,477,235,504,739
1000,493,502,501,263,482,745
1000,505,499,494,237,519,756
1000,498,493,517,243,513,756
1000,502,486,496,250,494,744
1000,492,477,506,228,525,753
1000,533,476,481,235,518,753
1000,514,496,510,249,509,758
1000,502,504,511,256,504,760
1000,510,507,504,268,487,755
1000,530,479,512,252,518,770
1000,492,512,505,248,497,745
1000,503,488,526,242,529,771
1000,459,491,462,227,475,702
1000,494,516,509,253,497,750
1000,491,514,498,255,498,753
1000,484,513,503,251,493,744
1000,504,496,507,255,507,762
1000,477,492,498,231,503,734
1000,487,504,489,262,480,742
1000,505,489,502,255,492,747
1000,518,519,504,268,501,769
1000,493,493,518,239,534,773
1000,503,499,501,239,514,753
1000,503,490,497,249,505,754
1000,500,489,510,244,514,758
1000,516,495,477,253,486,739
1000,534,478,514,270,506,776
1000,522,489,495,251,510,761
1000,494,471,504,233,518,751
1000,505,490,494,250,497,747
1000,518,482,474,243,506,749
1000,505,481,492,236,499,735
1000,531,512,508,275,500,775
1000,502,487,481,249,492,741
1000,504,484,490,251,488,739
1000,473,505,507,230,509,739
1000,508,529,510,271,487,758
1000,514,521,507,277,489,766
1000,508,524,469,256,495,751
1000,498,505,499,268,475,743
1000,506,502,499,243,506,749
1000,509,499,504,252,494,746
1000,501,506,479,262,470,732
1000,523,494,498,264,503,767
1000,510,495,496,244,497,741
1000,506,502,501,248,507,755
1000,511,503,510,254,500,754
1000,487,492,519,237,512,749
1000,497,488,502,249,490,739
1000,516,528,523,268,486,754
1000,517,488,502,245,509,754
1000,481,488,495,247,502,749
1000,504,526,503,254,504,758
1000,522,500,486,265,483,748
1000,481,509,514,242,511,753
1000,488,497,495,233,495,728
1000,488,478,514,230,519,749
1000,491,504,512,232,534,766
1000,470,511,517,249,489,738
1000,497,496,492,251,500,751
1000,502,497,471,255,468,723
1000,491,489,498,239,497,736
1000,504,504,503,249,505,754
1000,470,514,491,241,501,742
1000,496,505,525,253,517,770
1000,469,504,516,239,495,734
1000,486,502,504,245,497,742
1000,473,456,504,223,510,733
1000,473,503,491,242,493,735
1000,503,485,486,247,500,747
1000,488,494,476,246,482,728
1000,498,518,485,247,492,739
1000,489,486,487,233,500,733
1000,496,509,515,254,508,762
1000,492,465,488,233,509,742
1000,512,499,507,252,495,747
1000,500,500,495,251,513,764
1000,490,517,514,255,493,748
1000,466,517,523,228,533,761
1000,508,497,502,259,494,753
1000,484,472,477,231,492,723
1000,503,521,499,263,504,767
1000,495,503,514,248,501,749
1000,511,471,522,229,539,768
1000,507,488,516,249,515,764
1000,512,494,526,258,520,778
1000,483,478,471,227,492,719
1000,491,491,513,239,527,766
1000,499,496,501,267,469,736
1000,506,477,512,241,511,752
1000,481,521,511,255,496,751
1000,513,475,510,260,516,776
1000,490,521,506,247,506,753
1000,508,517,492,272,473,745
1000,503,481,509,234,502,736
1000,502,518,518,261,514,775
1000,521,510,502,256,519,775
1000,509,463,523,245,524,769
1000,482,505,480,240,490,730
1000,520,514,488,257,494,751
1000,489,495,510,258,491,749
1000,507,487,520,251,509,760
1000,477,517,464,248,477,725
1000,487,508,515,257,489,746
1000,512,504,466,264,476,740
1000,498,516,498,245,487,732
1000,499,497,517,246,505,751
1000,500,514,491,260,499,759
1000,478,508,498,252,482,734
1000,473,488,481,226,493,719
1000,477,505,488,240,488,728
1000,494,499,503,249,503,752
1000,518,500,497,271,494,765
1000,518,507,474,273,474,747
1000,479,495,505,241,503,744
1000,522,488,482,259,489,748
1000,493,516,490,244,501,745
1000,513,484,523,259,516,775
1000,517,516,492,257,489,746
1000,481,524,498,250,479,729
1000,496,517,471,267,461,728
1000,482,493,532,244,501,745
1000,503,507,474,259,490,749
1000,484,525,487,254,484,738
1000,488,533,499,249,491,740
1000,530,471,507,249,524,773
1000,477,479,484,214,513,727
1000,500,498,504,240,526,766
1000,511,529,518,279,477,756
1000,485,521,493,267,464,731
1000,465,508,504,231,498,729
1000,533,531,543,291,509,800
1000,502,519,488,264,477,741
1000,504,507,487,256,492,748
1000,514,503,484,256,496,752
1000,508,513,480,256,476,732
1000,519,494,496,251,516,767
1000,496,491,491,250,483,733
1000,493,506,464,249,487,736
1000,525,502,485,263,484,747
1000,494,523,510,261,484,745
1000,516,498,518,260,498,758
1000,485,468,505,231,517,748
1000,493,483,508,234,511,745
1000,504,491,495,229,513,742
1000,501,498,492,254,486,740
1000,491,505,494,248,496,744
1000,494,474,517,229,529,758
1000,490,501,478,243,483,726
1000,529,511,481,261,503,764
1000,533,494,501,280,482,762
1000,512,508,467,261,485,746
1000,500,494,523,248,503,751
1000,486,481,519,225,522,747
1000,503,503,516,245,510,755
1000,495,508,494,255,491,746
1000,478,522,508,241,508,749
1000,515,492,497,263,488,751
1000,473,502,518,232,518,750
1000,509,510,476,257,484,741
1000,526,501,531,268,506,774
1000,522,485,497,260,492,752
1000,486,509,526,257,498,755
1000,484,508,491,251,494,745
1000,507,515,510,262,503,765
1000,504,486,483,225,511,736
1000,523,521,516,274,487,761
1000,494,492,528,235,540,775
1000,494,481,513,251,496,747
1000,504,508,542,259,514,773
1000,512,484,479,245,510,755
1000,490,526,490,256,483,739
1000,472,501,506,256,469,725
1000,517,514,494,274,485,759
1000,487,485,504,236,504,740
1000,513,484,498,258,501,759
1000,509,514,496,251,488,739
1000,488,495,498,237,509,746
1000,509,446,507,216,531,747
1000,500,507,499,261,485,746
1000,507,501,496,261,479,740
1000,524,509,510,273,497,770
1000,484,515,486,241,515,756
1000,511,482,491,255,485,740
1000,493,477,507,242,498,740
1000,471,453,518,213,531,744
1000,512,525,491,257,492,749
1000,501,524,474,262,488,750
1000,510,516,490,272,491,763
1000,515,491,498,251,505,756
1000,472,507,477,255,476,731
1000,489,505,506,231,520,751
1000,510,508,500,256,512,768
1000,502,495,495,234,512,746
1000,474,514,517,233,534,767
1000,479,501,508,247,495,742
1000,497,461,463,236,493,729
1000,493,503,507,247,512,759
1000,500,500,501,236,527,763
1000,517,473,503,243,520,763
1000,505,497,503,251,497,748
1000,490,495,473,252,481,733
1000,494,496,510,245,509,754
1000,486,495,504,231,525,756
1000,511,502,508,249,504,753
1000,499,495,519,234,515,749
1000,479,462,520,215,535,750
1000,478,517,510,240,512,752
1000,513,503,494,264,488,752
1000,522,480,462,265,478,743
1000,468,499,481,241,475,716
1000,522,508,488,259,487,746
1000,526,503,483,261,487,748
1000,499,509,486,260,491,751
1000,514,501,522,248,518,766
1000,467,474,481,233,492,725
1000,499,493,496,239,511,750
1000,507,509,505,243,511,754
1000,519,510,501,266,476,742
1000,502,511,494,252,493,745
1000,491,477,503,226,520,746
1000,519,506,508,263,487,750
1000,472,523,473,245,473,718
1000,496,484,473,241,489,730
1000,501,468,488,243,513,756
1000,521,496,505,256,498,754
1000,481,499,475,233,492,725
1000,517,497,480,260,494,754
1000,472,468,518,219,519,738
1000,474,473,529,222,528,750
1000,481,533,501,249,495,744
1000,514,499,497,251,511,762
1000,511,502,482,256,480,736
1000,505,486,518,251,514,765
1000,497,470,519,232,526,758
1000,509,488,494,251,503,754
1000,469,500,500,234,509,743
1000,489,468,482,242,500,742
1000,523,496,492,270,489,759
1000,525,484,512,255,522,777
1000,505,489,499,255,490,745
1000,522,511,495,273,492,765
1000,459,492,473,226,477,703
1000,473,504,522,241,499,740
1000,505,496,496,239,508,747
1000,498,493,497,239,516,755
1000,500,485,500,245,497,742
1000,496,505,537,257,503,760
1000,501,492,503,242,500,742
1000,465,480,536,226,518,744
1000,517,492,507,246,513,759
1000,515,531,502,272,488,760
1000,516,493,507,257,502,759
1000,517,517,491,258,481,739
1000,488,505,489,245,496,741
1000,478,480,496,228,507,735
1000,504,504,465,249,489,738
1000,486,502,532,249,516,765
1000,521,474,491,261,489,750
1000,503,464,489,222,538,760
1000,532,500,501,256,510,766
1000,501,523,482,272,460,732
1000,512,476,463,249,489,738
1000,497,508,459,247,482,729
1000,507,490,498,258,498,756
1000,525,501,478,262,489,751
1000,503,512,485,243,509,752
1000,506,508,514,251,512,763
1000,510,507,470,266,475,741
1000,522,515,496,269,499,768
1000,491,514,485,241,501,742
1000,502,504,521,232,534,766
1000,540,504,449,266,475,741
1000,511,487,516,251,513,764
1000,502,500,496,241,517,758
1000,516,503,497,268,489,757
1000,509,506,506,257,488,745
1000,472,518,484,241,473,714
1000,510,557,498,286,462,748
1000,505,484,515,240,504,744
1000,516,511,505,277,482,759
1000,529,500,485,272,496,768
1000,505,485,491,231,516,747
1000,509,502,485,263,476,739
1000,487,510,497,263,476,739
1000,481,470,489,227,500,727
1000,476,494,505,232,510,742
1000,489,497,510,239,507,746
1000,517,496,499,253,506,759
1000,525,495,494,264,489,753
1000,504,516,494,263,487,750
1000,497,505,526,232,525,757
1000,515,502,502,262,491,753
1000,488,508,526,241,514,755
1000,512,512,514,263,499,762
1000,481,489,530,245,518,763
1000,469,498,506,237,499,736
1000,503,497,476,246,489,735
1000,490,508,515,246,527,773
1000,484,527,487,264,469,733
1000,488,495,474,231,503,734
1000,490,505,498,248,493,741
1000,507,475,510,248,504,752
1000,495,497,493,242,500,742
1000,490,470,520,223,533,756
1000,524,507,482,265,496,761
1000,480,494,506,248,498,746
1000,496,508,505,251,491,742
1000,519,506,508,254,513,767
1000,499,488,494,247,513,760
1000,509,504,519,255,519,774
1000,503,509,502,259,492,751
1000,529,472,486,264,513,777
1000,524,522,508,271,498,769
1000,491,497,521,240,512,752
1000,509,512,497,257,502,759
1000,509,525,480,264,477,741
1000,495,524,520,250,523,773
1000,499,495,484,240,506,746
1000,492,489,491,238,486,724
1000,522,500,474,257,494,751
1000,493,504,515,246,507,753
1000,503,507,533,252,522,774
1000,493,462,499,235,510,745
1000,509,488,504,263,489,752
1000,494,507,537,263,495,758
1000,495,496,493,241,508,749
1000,497,517,533,247,514,761
1000,484,515,504,256,482,738
1000,473,485,508,224,517,741
1000,487,493,513,252,508,760
1000,494,500,504,232,526,758
1000,505,509,497,261,487,748
1000,506,509,490,254,489,743
1000,522,491,491,246,512,758
1000,495,477,484,233,507,740
1000,486,528,503,263,472,735
1000,491,508,513,238,507,745
1000,502,483,502,243,515,758
1000,522,518,502,268,491,759
1000,538,494,467,251,520,771
1000,470,517,543,251,511,762
1000,505,507,505,280,472,752
1000,483,518,520,253,511,764
1000,509,483,502,262,501,763
1000,494,502,505,254,499,753
1000,509,478,494,240,494,734
1000,485,514,482,250,493,743
1000,523,479,494,257,500,757
1000,494,505,511,251,491,742
1000,503,468,531,235,524,759
1000,496,493,510,252,493,745
1000,512,491,499,252,492,744
1000,501,486,507,248,498,746
1000,507,532,469,268,469,737
1000,481,507,513,236,511,747
1000,506,504,486,254,492,746
1000,497,501,517,255,501,756
1000,468,491,480,220,479,699
1000,520,500,551,259,528,787
1000,515,502,513,262,494,756
1000,497,504,480,246,500,746
1000,495,484,517,247,503,750
1000,527,508,468,275,478,753
1000,512,491,475,244,514,758
1000,500,502,502,247,499,746
1000,520,518,506,268,505,773
1000,473,491,524,238,499,737
1000,530,523,509,279,499,778
1000,502,462,486,227,522,749
1000,498,498,482,260,483,743
1000,494,513,510,256,504,760
1000,520,525,521,269,499,768
1000,530,512,487,263,499,762
1000,507,505,497,251,497,748
1000,533,499,492,263,497,760
1000,492,481,495,246,500,746
1000,501,515,488,253,482,735
1000,497,464,519,237,518,755
1000,518,521,514,277,489,766
1000,521,505,482,265,472,737
1000,476,506,524,241,509,750
1000,488,490,494,237,500,737
1000,513,469,515,230,529,759
1000,494,506,481,243,480,723
1000,524,486,507,264,497,761
1000,499,519,500,260,483,743
1000,503,482,507,236,519,755
1000,483,503,486,250,500,750
1000,485,501,503,258,503,761
1000,509,530,476,270,481,751
1000,503,488,502,258,502,760
1000,489,507,494,254,493,747
1000,518,498,502,243,525,768
1000,512,486,489,248,501,749
1000,504,502,498,249,501,750
1000,491,520,513,260,490,750
1000,513,506,489,262,479,741
1000,470,489,488,229,503,732
1000,474,480,512,232,506,738
1000,511,494,512,247,527,774
1000,527,510,491,271,486,757
1000,482,508,495,249,486,735
1000,497,474,512,249,513,762
1000,471,494,501,232,484,716
1000,475,482,485,226,512,738
1000,482,498,497,248,492,740
1000,507,473,487,233,518,751
1000,507,521,468,259,490,749
1000,511,513,510,271,496,767
1000,468,493,500,231,518,749
1000,504,515,526,256,505,761
1000,495,489,495,244,516,760
1000,527,479,513,240,530,770
1000,508,495,493,238,513,751
1000,485,504,480,256,487,743
1000,517,511,516,261,504,765
1000,525,522,482,284,465,749
1000,509,510,465,274,463,737
1000,488,488,530,233,518,751
1000,484,488,504,257,491,748
1000,514,518,505,259,515,774
1000,501,495,472,239,515,754
1000,492,501,496,234,521,755
1000,534,499,503,273,489,762
1000,488,487,519,252,507,759
1000,499,508,508,269,486,755
1000,526,517,517,271,504,775
1000,525,503,526,259,514,773
1000,492,523,529,250,520,770
1000,499,502,522,253,499,752
1000,480,498,512,238,511,749
1000,506,494,503,244,507,751
1000,475,495,498,229,512,741
1000,499,511,489,256,487,743
1000,489,533,502,264,488,752
1000,502,512,490,252,498,750
1000,478,517,502,246,501,747
1000,523,495,477,253,485,738
1000,519,482,510,250,520,770
1000,535,512,486,274,487,761
1000,490,481,495,217,537,754
1000,508,519,491,266,479,745
1000,503,522,494,272,485,757
1000,508,489,524,247,520,767
1000,530,484,490,256,504,760
1000,514,496,506,240,533,773
1000,496,505,502,253,498,751
1000,499,508,522,250,507,757
1000,524,503,517,260,516,776
1000,485,494,504,224,518,742
1000,496,497,501,255,491,746
1000,503,474,486,226,539,765
1000,498,487,517,235,518,753
1000,524,496,477,244,501,745
1000,483,509,527,246,513,759
1000,493,502,516,241,529,770
1000,544,526,503,277,503,780
1000,488,501,518,253,491,744
1000,487,507,514,240,510,750
1000,513,471,531,250,512,762
1000,496,499,506,256,494,750
1000,512,490,511,248,507,755
1000,513,511,511,250,508,758
1000,495,499,471,245,486,731
1000,505,501,520,260,491,751
1000,491,504,492,236,515,751
1000,509,491,492,257,498,755
1000,515,480,508,246,535,781
1000,499,510,544,267,501,768
1000,506,503,503,257,498,755
1000,505,469,496,240,519,759
1000,486,487,505,241,499,740
1000,524,469,498,251,511,762
1000,464,469,499,221,523,744
1000,519,522,487,277,474,751
1000,514,521,500,270,487,757
1000,517,533,480,273,490,763
1000,499,487,509,235,521,756
1000,492,493,535,240,509,749
1000,477,484,506,236,500,736
1000,512,508,531,253,512,765
1000,519,493,517,272,487,759
1000,483,496,483,231,496,727
1000,473,500,500,246,491,737
1000,490,502,527,256,496,752
1000,481,489,495,239,515,754
1000,521,474,502,240,527,767
1000,494,515,512,263,500,763
1000,500,490,512,242,504,746
1000,483,527,488,252,482,734
1000,488,506,492,243,498,741
1000,519,497,527,254,514,768
1000,509,510,509,277,490,767
1000,469,487,518,233,505,738
1000,488,485,514,231,530,761
1000,515,498,479,253,493,746
1000,523,477,476,256,503,759
1000,492,492,517,243,508,751
1000,510,506,485,267,481,748
1000,506,513,555,266,514,780
1000,496,494,493,246,498,744
1000,512,505,491,269,485,754
1000,490,497,492,243,508,751
1000,519,488,482,256,487,743
1000,475,464,508,210,544,754
1000,509,528,497,268,495,763
1000,502,490,473,268,469,737
1000,485,506,471,259,471,730
1000,495,512,507,253,506,759
1000,502,497,494,247,495,742
1000,493,509,496,266,474,740
1000,523,478,510,242,550,792
1000,506,498,482,257,493,750
1000,491,499,472,241,482,723
1000,485,496,492,251,481,732
1000,478,489,489,243,491,734
1000,504,500,478,272,471,743
1000,484,496,459,246,466,712
1000,499,514,500,253,504,757
1000,500,517,516,268,479,747
1000,496,499,492,244,500,744
1000,485,516,528,257,507,764
1000,458,491,477,227,494,721
1000,481,499,474,258,460,718
1000,491,516,537,261,507,768
1000,484,506,471,238,488,726
1000,507,489,525,232,531,763
1000,531,483,480,247,492,739
1000,492,513,513,253,511,764
1000,482,508,472,245,473,718
1000,513,547,496,291,463,754
1000,502,510,484,269,477,746
1000,518,486,499,247,501,748
1000,512,445,494,233,503,736
1000,494,504,494,237,518,755
1000,504,502,508,261,501,762
1000,511,494,505,258,515,773
1000,492,482,519,229,520,749
1000,532,510,520,276,502,778
1000,513,540,514,284,469,753
1000,501,513,518,251,517,768
1000,493,487,452,245,469,714
1000,504,489,498,227,525,752
1000,517,493,502,249,524,773
1000,493,505,510,237,520,757
1000,494,541,510,281,454,735
1000,498,486,508,252,504,756
1000,490,512,510,241,504,745
1000,482,500,497,239,494,733
1000,502,500,492,255,500,755
1000,490,468,538,230,536,766
1000,487,504,503,249,498,747
1000,495,483,527,246,517,763
1000,522,511,500,261,502,763
1000,505,481,499,248,488,736
1000,508,513,492,262,492,754
1000,489,513,483,260,482,742
1000,486,512,510,251,500,751
1000,508,523,501,276,469,745
1000,477,502,486,240,490,730
1000,493,499,513,249,516,765
1000,489,488,522,246,521,767
1000,505,511,501,245,496,741
1000,526,490,485,259,490,749
1000,471,491,521,239,512,751
1000,507,482,485,248,507,755
1000,511,518,483,272,491,763
1000,481,470,506,226,505,731
1000,506,492,506,251,505,756
1000,495,480,503,230,513,743
1000,470,483,490,228,484,712
1000,499,498,469,254,476,730
1000,510,510,505,261,502,763
1000,518,526,524,272,504,776
1000,498,507,521,253,501,754
1000,518,509,497,254,503,757
1000,488,485,510,244,499,743
1000,487,502,481,248,472,720
1000,490,506,508,264,494,758
1000,529,501,513,262,506,768
1000,501,477,529,230,544,774
1000,508,499,496,253,494,747
1000,524,496,514,261,501,762
1000,485,502,511,235,501,736
1000,513,476,500,248,511,759
1000,511,454,483,231,520,751
1000,488,497,506,226,517,743
1000,497,471,467,228,512,740
1000,480,499,517,234,512,746
1000,497,508,493,257,485,742
1000,500,479,486,228,515,743
1000,492,502,483,245,492,737
1000,506,491,494,236,507,743
1000,513,501,527,256,514,770
1000,525,486,517,249,518,767
1000,487,486,497,227,523,750
1000,528,520,520,267,505,772
1000,487,475,517,223,527,750
1000,499,495,511,248,518,766
1000,493,536,492,263,484,747
1000,509,510,494,243,505,748
1000,533,483,479,254,500,754
1000,486,502,527,246,517,763
1000,474,504,473,219,508,727
1000,478,486,471,230,493,723
1000,507,500,503,258,478,736
1000,461,467,467,203,512,715
1000,492,506,493,253,492,745
1000,496,514,507,248,503,751
1000,503,500,499,227,529,756
1000,509,504,488,249,501,750
1000,501,485,480,245,505,750
1000,482,508,468,234,488,722
1000,528,484,511,249,517,766
1000,531,504,481,261,485,746
1000,517,520,491,268,473,741
1000,482,476,517,224,524,748
1000,507,531,500,282,485,767
1000,506,490,527,247,529,776
1000,509,514,489,254,495,749
1000,504,511,507,250,508,758
1000,515,521,505,272,507,779
1000,513,474,505,240,513,753
1000,511,511,498,275,472,747
1000,515,530,504,263,505,768
1000,497,486,491,241,503,744
1000,500,502,492,254,479,733
1000,490,508,530,256,509,765
1000,491,506,485,257,503,760
1000,477,509,515,231,524,755
1000,519,524,512,283,473,756
1000,493,496,509,242,508,750
1000,480,488,500,234,498,732
1000,500,500,497,258,484,742
1000,469,507,499,239,491,730
1000,503,473,497,245,509,754
1000,523,487,496,253,508,761
1000,479,529,493,245,499,744
1000,483,517,538,236,507,743
1000,485,502,516,251,520,771
1000,497,497,475,239,499,738
1000,487,509,536,248,515,763
1000,511,489,512,255,498,753
1000,468,482,505,225,480,705
1000,468,503,507,247,480,727
1000,492,507,488,261,472,733
1000,519,506,523,264,511,775
1000,495,508,508,252,492,744
1000,509,513,481,261,506,767
1000,501,503,500,248,512,760
1000,509,499,481,251,494,745
1000,488,503,482,246,486,732
1000,496,495,499,241,503,744
1000,505,485,493,243,490,733
1000,501,521,511,255,499,754
1000,513,505,463,255,485,740
1000,492,496,498,247,514,761
1000,496,509,485,249,493,742
1000,514,495,500,244,519,763
1000,496,472,495,234,508,742
1000,520,512,484,256,500,756
1000,508,528,476,266,463,729
1000,493,519,506,263,465,728
1000,488,481,513,230,520,750
1000,515,508,504,264,502,766
1000,513,499,521,253,520,773
1000,493,500,514,229,529,758
1000,516,502,492,245,520,765
1000,506,491,511,264,489,753
1000,469,477,490,222,507,729
1000,517,493,537,247,533,780
1000,483,491,503,247,493,740
1000,497,473,495,237,510,747
1000,505,476,510,239,520,759
1000,502,489,513,242,514,756
1000,509,495,506,247,512,759
1000,516,471,518,239,538,777
1000,492,486,494,242,504,746
1000,516,506,469,256,480,736
1000,487,494,524,250,514,764
1000,508,509,504,234,522,756
1000,488,484,504,238,507,745
1000,501,521,510,270,476,746
1000,494,497,509,246,515,761
1000,493,481,511,226,520,746
1000,496,509,502,250,512,762
1000,509,506,493,268,479,747
1000,505,517,517,261,510,771
1000,508,487,493,238,506,744
1000,495,499,484,248,474,722
1000,500,486,490,240,503,743
1000,502,497,481,247,483,730
1000,511,490,493,255,502,757
1000,537,509,476,275,480,755
1000,513,479,512,247,514,761
1000,495,488,519,251,515,766
1000,488,459,486,239,513,752
1000,503,520,519,271,477,748
1000,508,507,495,263,500,763
1000,495,512,515,259,511,770
1000,520,527,500,262,507,769
1000,546,494,477,295,478,773
1000,480,481,503,234,508,742
1000,531,520,479,276,489,765
1000,511,513,523,262,503,765
1000,508,506,525,245,517,762
1000,499,515,508,263,494,757
1000,510,478,494,244,510,754
1000,501,511,500,252,487,739
1000,491,500,500,252,480,732
1000,483,505,492,242,496,738
1000,520,509,489,259,510,769
1000,495,495,493,245,504,749
1000,510,496,490,269,488,757
1000,494,483,543,251,514,765
1000,494,509,506,250,490,740
1000,521,509,481,282,485,767
1000,504,497,508,245,508,753
1000,524,508,509,253,507,760
1000,519,512,493,255,500,755
1000,506,487,483,248,494,742
1000,503,501,514,248,521,769
1000,531,492,500,268,489,757
1000,526,513,497,267,501,768
1000,532,539,501,280,471,751
1000,479,496,503,234,504,738
1000,494,528,503,251,499,750
1000,489,484,497,245,493,738
1000,504,471,517,231,541,772
1000,489,521,496,258,486,744
1000,477,514,483,242,478,720
1000,494,484,512,244,503,747
1000,515,487,489,262,491,753
1000,505,497,521,245,513,758
1000,516,487,497,249,506,755
1000,488,485,548,229,529,758
1000,498,510,479,251,499,750
1000,510,478,480,240,501,741
1000,499,495,481,258,483,741
1000,499,475,496,227,534,761
1000,511,489,498,248,514,762
1000,463,500,509,239,498,737
1000,495,494,501,242,510,752
1000,516,493,504,259,512,771
1000,517,488,502,252,498,750
1000,518,495,525,276,498,774
1000,508,509,502,260,492,752
1000,497,493,497,247,494,741
1000,535,522,496,280,486,766
1000,497,505,477,272,464,736
1000,509,511,519,268,514,782
1000,507,510,512,246,521,767
1000,527,502,491,257,514,771
1000,504,496,489,250,503,753
1000,469,507,489,237,500,737
1000,511,511,526,266,500,766
1000,515,502,499,267,479,746
1000,481,506,487,245,489,734
1000,489,513,494,254,480,734
1000,522,529,495,279,477,756
1000,484,490,510,239,512,751
1000,501,497,518,248,512,760
1000,519,525,487,269,479,748
1000,479,480,474,229,506,735
1000,504,499,482,260,485,745
1000,492,523,517,252,510,762
1000,517,507,478,252,502,754
1000,499,504,516,252,505,757
1000,499,509,508,268,485,753
1000,488,519,502,256,483,739
1000,515,509,463,255,481,736
1000,494,521,503,256,500,756
1000,530,508,498,257,514,771
1000,506,508,501,256,503,759
1000,505,507,499,262,499,761
1000,501,489,503,249,508,757
1000,510,514,493,279,473,752
1000,483,494,511,225,520,745
1000,461,501,481,236,484,720
1000,483,500,505,251,493,744
1000,519,503,509,262,505,767
1000,485,511,485,249,497,746
1000,505,510,477,267,480,747
1000,487,491,504,254,492,746
1000,509,479,494,246,506,752
1000,525,479,503,258,496,754
1000,472,507,502,242,496,738
1000,514,483,503,247,525,772
1000,504,474,542,232,535,767
1000,499,519,495,255,492,747
1000,498,483,502,234,519,753
1000,492,481,493,240,509,749
1000,490,529,513,264,480,744
1000,531,504,496,277,493,770
1000,513,481,521,245,517,762
1000,498,503,506,239,499,738
1000,475,514,480,242,495,737
1000,493,489,495,237,508,745
1000,490,522,520,263,495,758
1000,514,505,526,267,496,763
1000,479,489,492,222,509,731
1000,508,520,472,271,478,749
1000,497,491,493,252,500,752
1000,509,491,513,247,520,767
1000,511,498,504,259,487,746
1000,529,501,481,278,482,760
1000,505,499,504,252,496,748
1000,514,521,482,265,496,761
1000,494,482,468,233,502,735
1000,495,469,486,249,498,747
1000,500,492,530,251,523,774
1000,506,516,500,266,501,767
1000,522,505,503,274,491,765
1000,488,511,499,241,495,736
1000,506,518,519,267,507,774
1000,511,491,505,259,502,761
1000,500,513,498,256,490,746
1000,503,525,480,263,469,732
1000,506,500,501,262,481,743
1000,510,478,483,244,506,750
1000,517,505,496,269,488,757
1000,522,551,481,301,455,756
1000,494,492,486,246,487,733
1000,475,495,502,241,498,739
1000,487,507,515,239,508,747
1000,505,508,484,258,477,735
1000,519,516,502,275,475,750
1000,510,455,485,235,517,752
1000,519,506,499,265,490,755
1000,499,472,491,218,533,751
1000,500,496,510,247,509,756
1000,493,519,514,247,515,762
1000,497,479,500,223,520,743
1000,522,510,487,272,496,768
1000,500,483,502,241,505,746
1000,526,515,489,276,482,758
1000,505,534,513,262,522,784
1000,504,509,479,257,487,744
1000,506,482,481,236,511,747
1000,502,491,513,261,497,758
1000,538,487,499,265,508,773
1000,489,495,510,244,493,737
1000,492,495,521,234,502,736
1000,533,503,484,262,491,753
1000,509,490,508,257,495,752
1000,500,513,495,265,477,742
1000,459,503,500,249,476,725
1000,489,480,509,237,511,748
1000,491,506,492,263,471,734
1000,480,506,491,240,489,729
1000,510,522,494,264,486,750
1000,500,495,504,234,512,746
1000,481,525,472,242,491,733
1000,492,489,500,236,506,742
1000,480,485,515,220,505,725
1000,472,522,498,247,478,725
1000,487,495,493,232,512,744
1000,522,492,531,262,492,754
1000,527,499,508,257,513,770
1000,507,519,506,245,507,752
1000,519,476,529,245,527,772
1000,486,475,498,232,518,750
1000,517,502,480,259,507,766
1000,490,505,498,249,492,741
1000,493,502,483,263,479,742
1000,497,508,494,254,500,754
1000,483,527,495,257,482,739
1000,493,507,499,243,507,750
1000,495,496,519,243,508,751
1000,520,514,508,254,498,752
1000,477,506,476,251,474,725
1000,511,501,482,258,478,736
1000,498,483,516,240,518,758
1000,506,493,515,255,500,755
1000,485,479,495,230,502,732
1000,472,493,466,229,484,713
1000,512,482,493,241,502,743
1000,493,521,488,261,481,742
1000,471,465,483,206,511,717
1000,500,461,508,234,518,752
1000,526,493,490,245,510,755
1000,502,464,506,242,511,753
1000,490,471,507,220,518,738
1000,500,479,504,233,510,743
1000,482,510,479,241,489,730
1000,465,503,508,229,521,750
1000,501,488,506,231,531,762
1000,500,502,493,244,503,747
1000,534,494,496,267,486,753
1000,478,509,475,261,460,721
1000,527,499,515,272,495,767
1000,504,524,497,274,477,751
1000,508,499,517,254,508,762
1000,528,493,489,265,497,762
1000,505,484,534,252,519,771
1000,528,508,513,270,492,762
1000,511,494,500,247,513,760
1000,496,515,495,253,483,736
1000,500,520,505,262,496,758
1000,518,507,487,271,473,744
1000,497,488,490,246,502,748
1000,498,509,499,267,473,740
1000,498,501,530,237,531,768
1000,501,497,508,251,499,750
1000,481,493,509,227,509,736
1000,479,512,489,240,497,737
1000,503,487,471,246,508,754
1000,513,505,518,254,508,762
1000,484,489,490,235,496,731
1000,515,508,512,256,491,747
1000,512,522,481,270,471,741
1000,507,477,494,238,521,759
1000,478,508,510,246,496,742
1000,503,522,501,269,479,748
1000,507,484,523,253,507,760
1000,482,494,499,235,499,734
1000,478,504,536,247,518,765
1000,498,516,522,259,512,771
1000,498,478,485,237,496,733
1000,498,526,503,267,472,739
1000,527,480,514,254,523,777
1000,510,479,515,255,485,740
1000,509,489,521,261,508,769
1000,517,502,498,267,485,752
1000,511,520,522,278,480,758
1000,504,504,515,256,498,754
1000,509,492,524,249,506,755
1000,541,496,480,261,506,767
1000,491,515,485,266,480,746
1000,465,468,500,235,504,739
1000,477,473,531,243,519,762
1000,492,508,515,236,513,749
1000,527,472,479,230,521,751
1000,470,502,480,231,487,718
1000,517,516,515,258,508,766
1000,490,504,515,256,507,763
1000,492,508,519,252,508,760
1000,516,523,505,264,492,756
1000,504,484,520,251,504,755
1000,508,525,495,276,483,759
1000,494,505,498,254,477,731
1000,504,506,510,252,502,754
1000,480,524,505,256,491,747
1000,493,488,518,233,514,747
1000,496,490,500,231,524,755
1000,505,533,509,260,508,768
1000,489,514,500,244,493,737
1000,498,498,502,244,503,747
1000,485,463,508,206,535,741
1000,476,514,509,250,485,735
1000,527,489,520,255,518,773
1000,496,510,504,251,499,750
1000,498,491,484,239,500,739
1000,501,496,518,249,520,769
1000,498,504,522,245,519,764
1000,501,499,506,240,512,752
1000,502,493,525,251,519,770
1000,529,494,524,275,505,780
1000,485,493,504,232,515,747
1000,514,497,484,241,520,761
1000,508,507,466,238,506,744
1000,488,510,498,256,478,734
1000,506,518,499,260,503,763
1000,469,478,517,240,491,731
1000,482,495,508,236,516,752
1000,483,530,513,266,474,740
1000,516,500,491,259,492,751
1000,496,504,503,220,538,758
1000,465,499,476,234,499,733
1000,488,487,518,247,497,744
1000,479,496,496,245,490,735
1000,495,535,508,270,494,764
1000,488,490,490,251,482,733
1000,517,492,490,263,487,750
1000,500,509,514,251,510,761
1000,536,505,522,268,514,782
1000,492,512,478,243,491,734
1000,494,505,522,250,522,772
1000,489,502,518,249,500,749
1000,483,534,488,263,482,745
1000,487,502,498,243,509,752
1000,508,509,502,263,485,748
1000,507,508,494,266,471,737
1000,485,510,483,238,494,732
1000,494,514,502,259,480,739
1000,500,507,495,236,500,736
1000,530,485,462,269,473,742
1000,479,489,533,237,519,756
1000,511,500,495,256,502,758
1000,476,489,513,246,492,738
1000,504,494,492,247,498,745
1000,482,499,502,225,514,739
1000,506,492,479,258,490,748
1000,518,510,512,264,502,766
1000,486,472,481,226,510,736
1000,496,520,494,246,518,764
1000,527,472,508,256,511,767
1000,479,496,503,245,495,740
1000,516,480,490,250,491,741
1000,516,479,521,228,533,761
1000,474,496,491,235,504,739
1000,466,481,498,222,513,735
1000,500,525,513,271,490,761
1000,497,518,511,259,495,754
1000,508,505,492,257,508,765
1000,491,513,500,261,485,746
1000,481,491,515,246,512,758
1000,471,514,499,236,499,735
1000,477,475,517,232,529,761
1000,489,492,483,229,506,735
1000,487,480,487,233,499,732
1000,487,474,493,239,512,751
1000,494,494,502,246,496,742
1000,522,512,514,263,482,745
1000,513,522,496,276,481,757
1000,461,514,463,250,463,713
1000,490,543,515,267,466,733
1000,502,486,527,247,513,760
1000,518,505,495,259,492,751
1000,480,498,481,238,478,716
1000,502,497,512,255,494,749
1000,498,515,494,254,483,737
1000,508,487,508,238,514,752
1000,499,492,511,242,519,761
1000,504,524,498,269,470,739
1000,493,486,482,257,474,731
1000,510,483,531,252,510,762
1000,541,508,506,281,491,772
1000,524,468,485,240,521,761
1000,495,495,495,238,519,757
1000,509,503,506,249,518,767
1000,527,496,516,272,499,771
1000,477,481,457,221,481,702
1000,479,483,486,224,503,727
1000,519,503,504,253,506,759
1000,497,491,495,234,521,755
1000,496,490,481,250,489,739
1000,501,493,494,250,489,739
1000,476,496,510,239,519,758
1000,495,511,495,259,489,748
1000,478,490,483,244,476,720
1000,496,473,474,239,495,734
1000,502,521,498,272,473,745
1000,508,502,479,263,469,732
1000,497,508,489,263,477,740
1000,469,497,512,238,509,747
1000,524,514,491,268,495,763
1000,515,505,516,260,511,771
1000,465,500,498,244,481,725
1000,517,486,545,261,519,780
1000,506,512,490,262,481,743
1000,491,466,504,222,520,742
1000,509,490,510,248,511,759
1000,522,489,529,251,525,776
1000,524,491,502,264,489,753
1000,495,485,494,242,483,725
1000,505,500,485,253,486,739
1000,484,503,495,241,508,749
1000,492,514,500,254,497,751
1000,486,495,491,223,521,744
1000,519,480,485,251,496,747
1000,459,511,486,230,495,725
1000,488,516,490,247,481,728
1000,481,489,523,238,520,758
1000,506,497,535,239,534,773
1000,479,486,492,229,511,740
1000,513,491,515,254,508,762
1000,483,513,498,252,500,752
1000,518,500,500,260,506,766
1000,527,494,508,260,505,765
1000,496,510,484,259,482,741
1000,494,501,507,261,486,747
1000,480,528,503,251,488,739
1000,517,550,476,283,459,742
1000,498,493,493,260,497,757
1000,479,494,491,233,499,732
1000,500,505,496,253,499,752
1000,477,498,505,240,493,733
1000,507,507,511,250,522,772
1000,524,504,515,268,504,772
1000,495,499,495,243,498,741
1000,495,478,503,238,506,744
1000,493,511,476,261,466,727
1000,521,484,501,257,496,753
1000,514,499,513,241,518,759
1000,505,513,484,241,513,754
1000,499,484,466,234,505,739
1000,494,487,496,258,497,755
1000,500,513,500,263,483,746
1000,509,500,493,263,478,741
1000,493,493,523,246,515,761
1000,475,508,534,232,513,745
1000,511,492,494,251,494,745
1000,494,507,495,256,471,727
1000,487,488,485,236,510,746
1000,501,507,499,260,484,744
1000,507,468,529,234,534,768
1000,504,513,535,260,518,778
1000,471,497,503,237,509,746
1000,496,473,511,224,524,748
1000,499,485,490,245,508,753
1000,520,475,498,253,498,751
1000,501,516,477,262,492,754
1000,497,518,518,253,499,752
1000,483,489,488,243,501,744
1000,506,490,523,249,514,763
1000,508,488,469,234,520,754
1000,504,482,482,230,522,752
1000,488,477,487,240,495,735
1000,513,506,484,254,490,744
1000,510,502,489,252,511,763
1000,484,498,488,245,487,732
1000,520,466,484,246,489,735
1000,511,512,511,269,485,754
1000,526,508,496,262,501,763
1000,512,530,495,268,491,759
1000,506,487,505,241,516,757
1000,503,499,508,248,512,760
1000,484,481,549,238,528,766
1000,508,468,510,241,527,768
1000,480,491,508,241,510,751
1000,499,480,488,250,487,737
1000,457,515,503,236,503,739
1000,506,522,497,273,479,752
1000,508,497,512,265,481,746
1000,501,500,510,237,514,751
1000,478,508,516,236,512,748
1000,496,481,516,243,530,773
1000,496,506,486,248,496,744
1000,511,485,508,252,502,754
1000,514,520,482,270,471,741
1000,493,474,503,237,515,752
1000,511,485,532,242,532,774
1000,494,509,510,259,489,748
1000,478,495,530,227,532,759
1000,524,487,490,251,494,745
1000,515,507,499,265,480,745
1000,524,486,507,261,512,773
1000,499,505,492,252,494,746
1000,482,505,482,238,503,741
1000,520,482,504,245,530,775
1000,480,472,481,213,518,731
1000,488,481,473,241,496,737
1000,496,514,479,249,503,752
1000,516,511,535,268,499,767
1000,506,492,509,260,491,751
1000,457,488,489,219,512,731
1000,499,496,482,239,509,748
1000,498,514,509,258,500,758
1000,500,538,482,263,490,753
1000,495,497,500,249,486,735
1000,485,504,511,245,509,754
1000,478,496,479,232,494,726
1000,473,485,503,234,503,737
1000,502,503,503,241,517,758
1000,538,495,481,268,495,763
1000,489,496,515,247,493,740
1000,490,493,489,250,484,734
1000,491,496,519,247,495,742
1000,503,487,510,249,500,749
1000,495,502,467,251,470,721
1000,500,477,492,241,493,734
1000,497,474,508,234,510,744
1000,513,513,466,269,488,757
1000,478,503,522,241,506,747
1000,500,495,511,250,517,767
1000,498,504,500,262,480,742
1000,492,477,514,247,500,747
1000,502,492,517,251,502,753
1000,486,493,514,237,524,761
1000,520,503,517,262,506,768
1000,529,494,500,251,518,769
1000,504,491,502,259,496,755
1000,491,489,510,236,521,757
1000,515,512,494,271,480,751
1000,503,507,485,268,469,737
1000,504,505,497,263,483,746
1000,496,494,512,239,517,756
1000,489,482,480,241,487,728
1000,513,462,515,239,532,771
1000,464,490,509,238,486,724
1000,479,487,490,232,498,730
1000,471,509,485,258,464,722
1000,494,540,474,276,452,728
1000,522,517,509,275,498,773
1000,486,500,466,246,490,736
1000,535,512,479,269,485,754
1000,512,517,500,278,470,748
1000,490,505,480,266,457,723
1000,525,482,501,251,500,751
1000,500,491,511,242,501,743
1000,485,507,541,255,524,779
1000,498,495,503,246,505,751
1000,508,527,488,266,487,753
1000,483,501,498,239,488,727
1000,503,499,505,254,498,752
1000,488,492,515,244,509,753
1000,476,508,514,233,517,750
1000,517,525,515,251,503,754
1000,466,513,505,241,495,736
1000,479,495,480,237,489,726
1000,460,484,505,211,515,726
1000,498,500,486,254,478,732
1000,507,500,484,261,486,747
1000,516,494,503,262,496,758
1000,491,500,484,262,467,729
1000,521,487,513,257,509,766
1000,521,487,531,258,503,761
1000,474,491,488,238,485,723
1000,498,513,485,252,496,748
1000,499,495,452,246,478,724
1000,487,526,513,256,500,756
1000,517,478,505,248,510,758
1000,489,489,501,235,503,738
1000,484,503,509,241,497,738
1000,508,507,511,258,520,778
1000,494,475,506,231,513,744
1000,513,523,484,268,465,733
1000,495,519,506,253,496,749
1000,499,504,488,254,493,747
1000,489,495,519,254,517,771
1000,525,488,496,255,505,760
1000,502,495,500,249,491,740
1000,499,502,491,249,485,734
1000,465,510,491,239,484,723
1000,509,491,497,245,520,765
1000,482,501,490,237,495,732
1000,474,506,466,227,501,728
1000,463,503,494,231,496,727
1000,497,509,509,264,482,746
1000,513,496,505,241,518,759
1000,521,475,491,247,516,763
1000,510,514,468,255,489,744
1000,503,505,503,266,487,753
1000,523,522,513,266,491,757
1000,497,496,501,241,505,746
1000,460,482,503,219,511,730
1000,489,512,538,249,515,764
1000,508,525,501,280,463,743
1000,501,505,561,251,528,779
1000,514,501,494,252,502,754
1000,473,497,535,227,524,751
1000,505,480,509,247,511,758
1000,529,502,507,274,486,760
1000,465,503,515,239,498,737
1000,519,501,521,257,499,756
1000,496,490,488,252,477,729
1000,477,535,525,242,497,739
1000,492,534,517,265,481,746
1000,496,475,531,236,517,753
1000,486,516,504,244,499,743
1000,455,476,521,217,532,749
1000,484,515,546,244,506,750
1000,536,527,496,282,471,753
1000,503,520,506,252,492,744
1000,510,528,519,267,492,759
1000,522,498,501,254,494,748
1000,488,507,502,260,479,739
1000,484,493,495,235,518,753
1000,514,515,484,262,495,757
1000,498,490,470,246,500,746
1000,512,467,490,237,513,750
1000,479,486,502,235,496,731
1000,474,505,507,232,505,737
1000,524,498,538,259,528,787
1000,483,502,512,239,512,751
1000,497,511,502,252,513,765
1000,520,496,526,247,519,766
1000,492,495,512,242,514,756
1000,506,504,488,267,492,759
1000,484,553,508,270,476,746
1000,505,511,502,258,490,748
1000,469,509,509,244,491,735
1000,512,484,473,244,498,742
1000,536,494,492,263,497,760
1000,506,524,506,260,491,751
1000,499,496,504,254,488,742
1000,523,511,511,270,506,776
1000,464,464,485,216,515,731
1000,502,496,498,237,513,750
1000,483,523,492,254,480,734
1000,519,521,518,278,481,759
1000,504,513,498,254,489,743
1000,509,492,468,246,496,742
1000,499,514,482,258,480,738
1000,506,497,508,261,497,758
1000,512,482,514,242,521,763
1000,526,475,499,251,514,765
1000,512,513,483,279,463,742
1000,503,501,484,257,493,750
1000,503,493,494,247,509,756
1000,518,477,502,243,517,760
1000,494,507,500,243,515,758
1000,513,502,478,260,488,748
1000,477,515,496,240,483,723
1000,490,494,469,244,483,727
1000,516,502,520,254,520,774
1000,501,501,491,254,488,742
1000,488,511,504,241,506,747
1000,495,509,511,254,497,751
1000,514,509,493,261,485,746
1000,479,508,470,243,482,725
1000,510,504,500,254,502,756
1000,496,528,494,276,469,745
1000,533,502,534,267,510,777
1000,508,502,506,244,507,751
1000,508,493,524,239,523,762
1000,508,506,503,265,477,742
1000,481,463,503,210,538,748
1000,471,463,529,208,549,757
1000,490,469,501,232,507,739
1000,498,504,497,260,483,743
1000,498,500,493,250,512,762
1000,505,475,494,228,528,756
1000,507,489,529,254,528,782
1000,498,504,508,252,489,741
1000,506,513,498,267,486,753
1000,496,521,498,262,512,774
1000,478,491,503,227,498,725
1000,482,493,481,236,490,726
1000,507,533,469,272,454,726
1000,526,494,491,259,492,751
1000,457,501,507,241,492,733
1000,514,502,523,269,493,762
1000,524,481,485,251,504,755
1000,502,499,490,259,490,749
1000,495,480,509,230,514,744
1000,525,507,518,268,497,765
1000,487,487,489,233,501,734
1000,489,487,510,235,522,757
1000,499,505,486,254,490,744
1000,502,498,504,244,498,742
1000,513,517,496,257,500,757
1000,528,502,511,247,529,776
1000,507,521,466,260,482,742
1000,486,509,504,246,486,732
1000,505,531,487,272,480,752
1000,456,532,547,246,498,744
1000,496,511,502,259,488,747
1000,498,497,487,248,459,707
1000,473,471,477,227,501,728
1000,514,499,504,249,521,770
1000,514,484,487,253,495,748
1000,508,482,506,243,515,758
1000,517,495,503,251,495,746
1000,483,458,494,218,525,743
1000,445,489,484,211,508,719
1000,488,518,468,249,469,718
1000,544,471,503,255,524,779
1000,505,481,496,232,531,763
1000,494,515,494,241,492,733
1000,511,491,483,235,514,749
1000,501,485,486,232,516,748
1000,504,474,504,248,495,743
1000,504,506,517,258,492,750
1000,488,504,505,254,499,753
1000,473,511,488,234,505,739
1000,506,485,523,253,523,776
1000,472,493,548,210,548,758
1000,501,493,455,248,485,733
1000,506,537,471,272,458,730
1000,504,471,505,247,506,753
1000,507,509,474,252,503,755
1000,513,478,493,251,512,763
1000,496,486,481,240,498,738
1000,511,489,501,258,496,754
1000,497,519,475,256,476,732
1000,487,508,493,254,481,735
1000,523,510,480,268,479,747
1000,512,476,497,243,522,765
1000,505,489,507,252,508,760
1000,504,491,525,242,515,757
1000,519,482,505,258,518,776
1000,497,505,504,240,514,754
1000,527,495,480,265,497,762
1000,493,474,511,244,504,748
1000,502,483,514,241,521,762
1000,490,500,505,252,502,754
1000,515,463,493,237,511,748
1000,514,510,497,248,508,756
1000,486,505,487,232,496,728
1000,481,480,487,225,498,723
1000,496,516,512,241,501,742
1000,490,512,490,239,500,739
1000,491,488,485,240,500,740
1000,489,501,485,243,490,733
1000,501,461,501,235,507,742
1000,497,523,490,277,464,741
1000,532,476,491,258,493,751
1000,493,486,498,226,519,745
1000,517,490,494,240,524,764
1000,503,500,481,256,500,756
1000,519,506,494,251,500,751
1000,500,501,482,242,495,737
1000,493,488,507,235,513,748
1000,506,492,496,249,499,748
1000,487,503,521,252,500,752
1000,479,487,499,247,509,756
1000,474,527,493,252,477,729
1000,481,515,514,256,485,741
1000,483,501,514,244,506,750
1000,507,477,499,247,519,766
1000,492,504,505,254,491,745
1000,509,494,470,271,463,734
1000,491,498,501,235,507,742
1000,509,483,491,244,512,756
1000,504,485,489,235,507,742
1000,491,466,493,233,506,739
1000,484,506,488,242,501,743
1000,514,518,498,265,483,748
1000,508,496,498,242,511,753
1000,558,523,504,291,483,774
1000,503,492,506,242,507,749
1000,490,512,498,245,508,753
1000,509,515,466,273,460,733
1000,478,509,488,222,528,750
1000,506,490,509,248,502,750
1000,489,470,516,241,518,759
1000,482,525,495,257,485,742
1000,511,488,488,255,493,748
1000,515,507,491,265,499,764
1000,501,487,473,237,490,727
1000,517,528,484,263,482,745
1000,499,525,502,250,496,746
1000,503,505,500,270,480,750
1000,498,496,492,256,479,735
1000,486,488,489,240,490,730
1000,511,510,496,263,490,753
1000,483,531,488,259,477,736
1000,484,505,474,256,464,720
1000,492,485,523,226,516,742
1000,505,491,487,244,501,745
1000,504,487,525,254,501,755
1000,517,488,510,256,509,765
1000,503,489,515,249,513,762
1000,502,485,488,243,500,743
1000,510,508,491,263,472,735
1000,487,483,509,226,532,758
1000,492,505,517,255,505,760
1000,501,497,503,241,506,747
1000,486,495,484,242,493,735
1000,484,487,485,240,495,735
1000,489,467,514,245,520,765
1000,513,507,507,256,505,761
1000,513,511,487,254,512,766
1000,492,512,506,245,490,735
1000,508,499,498,252,502,754
1000,501,510,497,249,502,751
1000,507,533,492,274,472,746
1000,505,510,527,268,489,757
1000,520,495,493,253,507,760
1000,510,510,516,261,505,766
1000,488,516,516,252,503,755
1000,509,504,503,252,508,760
1000,486,488,517,228,507,735
1000,502,529,495,268,464,732
1000,467,497,478,239,481,720
1000,493,500,519,263,492,755
1000,496,490,508,242,533,775
1000,509,495,506,254,499,753
1000,500,511,488,247,497,744
1000,503,502,514,263,496,759
1000,512,486,506,249,519,768
1000,509,489,502,244,511,755
1000,505,507,495,251,504,755
1000,524,482,490,246,513,759
1000,494,501,506,244,499,743
1000,527,517,510,264,508,772
1000,495,521,522,254,508,762
1000,500,464,504,234,524,758
1000,518,487,487,244,519,763
1000,515,496,497,265,488,753
1000,495,505,502,243,498,741
1000,486,479,502,237,510,747
1000,490,492,500,239,506,745
1000,500,512,515,269,493,762
1000,496,495,504,256,496,752
1000,456,486,535,209,530,739
1000,482,518,509,249,484,733
1000,516,506,515,261,490,751
1000,518,500,481,246,498,744
1000,481,483,493,226,524,750
1000,520,498,461,260,471,731
1000,517,518,510,270,490,760
1000,495,498,492,242,512,754
1000,448,510,510,215,522,737
1000,515,495,519,244,525,769
1000,482,483,468,222,502,724
1000,484,492,506,234,505,739
1000,499,509,513,251,488,739
1000,496,488,504,258,499,757
1000,516,465,478,246,495,741
1000,514,525,511,280,507,787
1000,476,496,488,250,498,748
1000,488,483,484,240,499,739
1000,514,511,495,254,500,754
1000,489,511,497,251,478,729
1000,505,500,517,254,499,753
1000,479,510,511,238,512,750
1000,505,537,506,267,492,759
1000,511,509,470,266,490,756
1000,503,483,477,224,521,745
1000,512,508,509,260,499,759
1000,486,509,489,239,492,731
1000,498,514,491,266,476,742
1000,523,488,526,261,525,786
1000,505,490,487,255,490,745
1000,513,514,516,258,505,763
1000,501,483,516,244,512,756
1000,486,497,494,247,495,742
1000,485,520,509,255,495,750
1000,474,514,500,255,473,728
1000,499,520,469,259,474,733
1000,490,482,504,249,508,757
1000,492,459,515,224,546,770
1000,502,509,489,256,500,756
1000,486,525,477,255,479,734
1000,493,506,523,251,521,772
1000,506,489,513,253,490,743
1000,474,500,527,223,521,744
1000,482,508,506,243,489,732
1000,508,506,499,267,483,750
1000,514,476,472,251,493,744
1000,483,519,485,266,478,744
1000,494,518,486,266,472,738
1000,475,520,505,238,494,732
1000,493,485,497,235,515,750
1000,499,477,485,241,496,737
1000,505,515,501,263,493,756
1000,530,462,473,248,514,762
1000,507,506,505,265,490,755
1000,492,514,480,258,467,725
1000,509,504,498,253,510,763
1000,503,490,503,242,508,750
1000,499,491,516,251,503,754
1000,502,485,493,251,503,754
1000,485,486,498,230,502,732
1000,487,469,520,214,538,752
1000,512,467,492,235,522,757
1000,487,548,481,258,473,731
1000,512,487,470,251,483,734
1000,513,495,483,256,507,763
1000,498,500,513,253,508,761
1000,469,501,495,243,489,732
1000,491,476,478,215,513,728
1000,498,479,482,243,492,735
1000,476,493,496,230,498,728
1000,514,471,514,247,517,764
1000,477,513,498,240,514,754
1000,519,486,494,263,501,764
1000,535,490,488,262,479,741
1000,511,486,501,256,494,750
1000,482,510,523,255,473,728
1000,477,506,474,247,483,730
1000,480,506,525,236,516,752
1000,524,485,501,260,517,777
1000,490,502,522,244,519,763
1000,518,500,497,259,500,759
1000,492,482,462,231,478,709
1000,489,533,507,263,473,736
1000,502,519,515,252,500,752
1000,506,513,513,255,519,774
1000,503,501,460,249,481,730
1000,515,460,458,234,502,736
1000,490,484,503,222,518,740
1000,521,526,471,275,472,747
1000,506,515,501,266,501,767
1000,518,506,507,264,500,764
1000,511,502,479,258,470,728
1000,490,519,500,251,487,738
1000,463,517,510,247,472,719
1000,504,485,499,228,512,740
1000,494,497,513,246,507,753
1000,495,507,485,244,504,748
1000,526,514,515,266,498,764
1000,477,505,494,240,489,729
1000,469,497,498,228,505,733
1000,513,508,486,261,482,743
1000,496,486,503,242,521,763
1000,483,494,508,225,516,741
1000,490,484,480,236,493,729
1000,511,506,493,256,490,746
1000,518,499,489,257,488,745
1000,474,505,521,235,512,747
1000,482,485,501,236,512,748
1000,528,483,492,267,493,760
1000,501,512,485,253,478,731
1000,493,513,483,243,499,742
1000,495,507,447,251,464,715
1000,518,491,522,254,518,772
1000,483,509,513,247,502,749
1000,533,484,501,260,509,769
1000,494,503,489,242,488,730
1000,486,492,532,242,505,747
1000,520,494,482,258,496,754
1000,510,496,498,260,509,769
1000,469,484,521,236,512,748
1000,513,504,511,266,502,768
1000,486,505,469,251,468,719
1000,495,515,523,248,507,755
1000,489,503,521,253,499,752
1000,519,509,536,258,513,771
1000,526,510,489,285,473,758
1000,503,481,489,253,505,758
1000,487,505,514,241,519,760
1000,493,522,498,250,496,746
1000,503,476,485,245,490,735
1000,512,500,509,260,506,766
1000,484,513,484,252,476,728
1000,490,482,493,241,494,735
1000,479,501,521,237,512,749
1000,480,498,521,230,521,751
1000,496,496,485,248,506,754
1000,472,476,468,217,517,734
1000,486,485,494,237,498,735
1000,474,502,475,236,497,733
1000,512,516,493,270,464,734
1000,508,485,541,254,529,783
1000,498,508,499,260,479,739
1000,481,510,487,252,482,734
1000,509,524,506,263,505,768
1000,492,512,494,239,505,744
1000,480,516,512,248,499,747
1000,494,527,505,262,494,756
1000,482,492,510,247,495,742
1000,469,485,501,224,510,734
1000,486,499,470,248,483,731
1000,533,487,516,255,501,756
1000,494,509,464,248,470,718
1000,504,489,471,245,487,732
1000,517,489,483,249,498,747
1000,526,504,486,276,474,750
1000,510,493,521,252,510,762
1000,488,486,480,227,517,744
1000,502,490,505,238,514,752
1000,510,517,510,268,489,757
1000,509,509,528,257,500,757
1000,500,500,492,253,489,742
1000,503,492,507,253,492,745
1000,485,470,477,234,492,726
1000,504,517,480,258,480,738
1000,519,520,507,265,515,780
1000,512,490,499,263,492,755
1000,496,498,477,253,480,733
1000,512,482,503,250,506,756
1000,491,510,474,245,485,730
1000,500,496,475,244,477,721
1000,526,480,518,258,509,767
1000,510,498,464,256,469,725
1000,493,505,551,248,518,766
1000,492,500,512,249,499,748
1000,523,475,507,248,516,764
1000,491,512,483,254,481,735
1000,522,498,505,262,508,770
1000,486,500,518,252,506,758
1000,514,524,482,266,486,752
1000,513,495,470,243,500,743
1000,495,483,518,228,529,757
1000,500,507,521,262,505,767
1000,500,517,483,244,494,738
1000,496,478,507,217,551,768
1000,509,498,506,257,508,765
1000,513,482,520,248,519,767
1000,499,517,486,257,492,749
1000,494,505,482,242,495,737
1000,515,528,496,274,481,755
1000,532,478,507,250,512,762
1000,497,501,479,236,488,724
1000,504,506,491,246,507,753
1000,484,513,521,253,509,762
1000,499,496,491,247,497,744
1000,499,476,533,249,512,761
1000,500,510,507,272,473,745
1000,481,504,534,230,521,751
1000,506,505,486,265,485,750
1000,518,496,474,250,505,755
1000,504,495,485,241,505,746
1000,495,521,503,244,495,739
1000,495,493,522,232,528,760
1000,505,505,488,259,481,740
1000,515,506,500,251,515,766
1000,513,487,473,254,493,747
1000,503,488,489,230,501,731
1000,495,520,496,261,490,751
1000,517,508,490,257,497,754
1000,502,501,514,258,498,756
1000,515,505,500,253,502,755
1000,495,489,499,238,507,745
1000,498,497,492,245,498,743
1000,496,482,499,234,519,753
1000,502,475,507,250,507,757
1000,478,493,486,238,493,731
1000,516,484,508,263,497,760
1000,501,503,467,267,467,734
1000,499,486,489,240,498,738
1000,525,514,475,279,481,760
1000,525,451,493,234,519,753
1000,523,535,490,279,477,756
1000,495,511,478,242,491,733
1000,523,511,485,271,484,755
1000,508,466,469,245,498,743
1000,482,506,497,225,501,726
1000,527,484,521,263,523,786
1000,536,509,507,253,519,772
1000,517,481,496,264,486,750
1000,502,497,511,239,518,757
1000,530,507,489,277,486,763
1000,488,498,510,262,492,754
1000,504,490,496,250,492,742
1000,495,489,486,232,521,753
1000,483,516,493,239,495,734
1000,491,528,506,264,488,752
1000,510,532,512,270,495,765
1000,479,492,487,235,499,734
1000,499,500,508,236,514,750
1000,506,522,493,281,468,749
1000,521,491,493,260,501,761
1000,485,518,523,241,507,748
1000,511,515,500,263,477,740
1000,515,500,485,257,505,762
1000,506,506,504,261,492,753
1000,492,493,525,243,501,744
1000,476,499,504,241,491,732
1000,511,499,519,246,531,777
1000,485,506,505,243,507,750
1000,482,474,506,219,528,747
1000,492,484,496,237,511,748
1000,515,511,512,255,514,769
1000,480,521,498,250,482,732
1000,532,481,500,258,517,775
1000,507,501,508,247,518,765
1000,505,506,512,251,495,746
1000,455,481,505,219,512,731
1000,484,475,492,225,524,749
1000,497,498,511,250,505,755
1000,478,515,505,241,495,736
1000,487,509,486,242,498,740
1000,524,493,493,254,490,744
1000,508,480,491,251,518,769
1000,495,499,492,253,481,734
1000,479,486,498,248,505,753
1000,493,519,487,256,469,725
1000,537,499,524,277,500,777
1000,474,516,510,241,502,743
1000,536,496,501,260,506,766
1000,483,493,511,242,514,756
1000,473,494,468,239,491,730
1000,492,485,503,238,498,736
1000,486,464,478,227,498,725
1000,487,492,515,234,525,759
1000,507,496,519,257,503,760
1000,504,520,476,255,492,747
1000,490,482,508,244,505,749
1000,512,522,538,274,505,779
1000,500,485,519,242,502,744
1000,479,509,492,246,507,753
1000,510,498,481,251,503,754
1000,519,516,481,268,499,767
1000,503,488,512,241,512,753
1000,516,503,511,261,502,763
1000,520,484,506,245,505,750
1000,509,514,464,263,471,734
1000,514,486,488,248,520,768
1000,528,518,511,286,489,775
1000,498,491,499,233,521,754
1000,533,507,479,267,482,749
1000,500,457,495,226,525,751
1000,503,516,498,264,486,750
1000,508,504,479,262,472,734
1000,515,523,505,270,501,771
1000,517,516,519,254,515,769
1000,512,522,526,260,514,774
1000,491,530,486,262,468,730
1000,525,522,501,288,470,758
1000,494,500,484,238,491,729
1000,507,521,494,271,472,743
1000,513,495,500,239,514,753
1000,487,510,492,263,472,735
1000,493,490,500,234,518,752
1000,505,480,508,239,523,762
1000,503,491,510,247,516,763
1000,497,499,495,249,481,730
1000,509,492,471,250,480,730
1000,488,494,513,240,520,760
1000,493,502,507,256,490,746
1000,482,492,510,228,516,744
1000,501,501,518,257,509,766
1000,497,489,508,231,515,746
1000,503,500,510,267,482,749
1000,511,496,528,243,524,767
1000,501,466,482,236,504,740
1000,490,504,501,243,516,759
1000,493,489,491,252,498,750
1000,518,501,505,254,502,756
1000,502,487,503,244,504,748
1000,513,499,488,256,496,752
1000,503,501,500,258,485,743
1000,528,525,528,286,489,775
1000,510,488,475,270,470,740
1000,471,512,484,236,493,729
1000,506,492,500,262,487,749
1000,498,518,511,247,487,734
1000,494,460,480,231,512,743
1000,500,496,530,251,514,765
1000,491,496,516,238,508,746
1000,497,512,488,254,484,738
1000,517,524,502,264,488,752
1000,505,490,501,237,524,761
1000,477,505,493,244,483,727
1000,517,482,510,243,516,759
1000,506,528,511,260,492,752
1000,487,501,484,256,488,744
1000,494,478,500,245,510,755
1000,512,481,511,246,520,766
1000,506,491,507,250,518,768
1000,503,504,486,258,484,742
1000,523,480,513,248,520,768
1000,514,507,520,267,500,767
1000,480,509,511,251,498,749
1000,520,508,494,275,487,762
1000,497,479,516,241,512,753
1000,489,507,493,255,469,724
1000,497,495,500,250,499,749
1000,500,508,496,262,479,741
1000,504,485,511,245,514,759
1000,499,500,495,250,505,755
1000,488,491,493,242,503,745
1000,501,505,494,250,497,747
1000,492,472,534,226,551,777
1000,506,517,516,277,481,758
1000,501,543,500,265,479,744
1000,495,491,492,240,515,755
1000,506,496,499,249,502,751
1000,499,500,520,246,500,746
1000,489,514,484,249,493,742
1000,498,501,530,253,521,774
1000,499,457,494,226,512,738
1000,468,500,510,241,499,740
1000,500,529,504,254,513,767
1000,483,504,479,228,506,734
1000,501,490,475,243,484,727
1000,500,523,505,266,478,744
1000,527,502,497,262,490,752
1000,498,481,479,234,501,735
1000,535,520,476,285,460,745
1000,511,496,503,253,497,750
1000,532,514,519,270,491,761
1000,487,476,510,228,526,754
1000,515,504,488,273,487,760
1000,510,484,505,245,531,776
1000,521,520,499,263,499,762
1000,504,482,489,249,505,754
1000,498,508,506,255,496,751
1000,509,506,502,266,477,743
1000,508,492,505,239,512,751
1000,471,509,508,251,473,724
1000,471,497,503,245,500,745
1000,490,501,483,252,497,749
1000,496,469,495,228,514,742
1000,508,492,497,253,501,754
1000,479,523,507,253,496,749
1000,497,494,491,236,488,724
1000,496,477,492,233,533,766
1000,493,471,469,239,506,745
1000,497,492,504,250,504,754
1000,541,512,494,291,479,770
1000,480,535,521,266,485,751
1000,483,511,489,249,497,746
1000,508,517,524,275,495,770
1000,507,508,524,259,516,775
1000,498,511,509,247,503,750
1000,515,514,483,266,480,746
1000,488,500,501,246,489,735
1000,507,520,487,247,494,741
1000,488,512,499,258,490,748
1000,498,520,482,256,471,727
1000,491,501,514,243,514,757
1000,525,479,478,246,505,751
1000,496,504,519,251,500,751
1000,497,500,521,254,508,762
1000,507,480,487,243,494,737
1000,489,511,519,247,499,746
1000,479,498,509,229,520,749
1000,494,503,503,248,510,758
1000,513,512,511,252,514,766
1000,511,482,505,248,517,765
1000,502,502,483,249,497,746
1000,507,495,506,247,498,745
1000,508,501,501,267,480,747
1000,493,500,496,251,483,734
1000,501,496,488,252,500,752
1000,530,487,485,261,486,747
1000,548,522,500,287,482,769
1000,502,511,519,265,492,757
1000,489,462,471,236,493,729
1000,516,515,500,260,502,762
1000,494,485,513,224,526,750
1000,529,495,491,255,492,747
1000,494,503,481,234,508,742
1000,495,505,513,252,507,759
1000,492,508,519,250,507,757
1000,485,498,512,227,511,738
1000,499,515,485,253,502,755
1000,491,501,533,251,503,754
1000,511,506,496,261,500,761
1000,500,491,504,242,517,759
1000,492,512,475,262,466,728
1000,490,500,510,245,508,753
1000,517,502,516,256,518,774
1000,501,500,501,255,512,767
1000,482,480,530,229,536,765
1000,545,527,484,304,465,769
1000,492,514,527,253,502,755
1000,500,507,507,262,491,753
1000,506,531,526,269,501,770
1000,503,490,483,246,493,739
1000,489,510,474,240,476,716
1000,469,501,501,243,496,739
1000,496,508,500,251,500,751
1000,524,495,512,245,522,767
1000,491,528,485,247,496,743
1000,510,509,511,269,483,752
1000,501,509,494,254,494,748
1000,521,497,502,264,505,769
1000,519,484,489,257,505,762
1000,487,512,530,243,514,757
1000,481,504,514,253,487,740
1000,484,512,518,256,488,744
1000,497,501,489,260,473,733
1000,501,481,525,236,531,767
1000,510,513,492,252,512,764
1000,477,490,514,236,515,751
1000,493,520,509,250,497,747
1000,495,471,492,234,508,742
1000,511,507,508,271,482,753
1000,485,480,519,242,510,752
1000,500,494,515,235,516,751
1000,522,477,491,235,531,766
1000,500,500,478,243,494,737
1000,529,492,496,268,502,770
1000,506,453,509,222,522,744
1000,514,465,473,233,517,750
1000,496,460,512,231,525,756
1000,505,514,459,269,453,722
1000,489,530,506,261,478,739
1000,473,496,490,235,495,730
1000,497,475,511,239,521,760
1000,504,522,483,275,470,745
1000,497,514,487,257,484,741
1000,483,475,504,232,527,759
1000,506,498,484,248,507,755
1000,537,484,481,259,508,767
1000,488,495,524,239,519,758
1000,506,480,511,244,516,760
1000,487,492,496,229,516,745
1000,478,494,503,245,491,736
1000,494,553,476,261,492,753
1000,505,507,510,249,512,761
1000,498,502,469,243,502,745
1000,511,496,491,255,499,754
1000,486,508,497,255,474,729
1000,490,496,507,242,494,736
1000,492,520,491,253,493,746
1000,530,506,490,277,482,759
1000,496,498,480,246,494,740
1000,495,528,492,267,484,751
1000,495,496,470,251,464,715
1000,495,518,503,253,489,742
1000,467,522,504,246,486,732
1000,488,454,488,221,511,732
1000,513,495,482,247,509,756
1000,476,494,489,242,482,724
1000,529,471,467,254,483,737
1000,504,509,492,253,483,736
1000,497,453,462,235,491,726
1000,510,478,504,233,512,745
1000,534,484,519,265,498,763
1000,489,492,513,242,497,739
1000,501,507,519,249,521,770
1000,503,505,507,262,503,765
1000,506,518,488,256,494,750
1000,502,489,499,235,518,753
1000,517,501,506,262,510,772
1000,491,511,489,264,477,741
1000,502,519,492,248,505,753
1000,499,497,533,256,515,771
1000,501,503,504,255,489,744
1000,489,499,492,258,477,735
1000,505,509,508,252,494,746
1000,491,476,521,235,525,760
1000,522,493,499,239,500,739
1000,514,463,500,237,510,747
1000,502,485,501,252,497,749
1000,497,475,508,234,519,753
1000,533,500,471,266,489,755
1000,503,484,497,249,513,762
1000,487,501,494,254,477,731
1000,535,525,509,283,489,772
1000,497,510,489,245,491,736
1000,489,504,490,260,486,746
1000,489,515,521,252,500,752
1000,524,494,497,251,509,760
1000,515,505,468,272,470,742
1000,473,490,501,230,518,748
1000,511,500,499,258,492,750
1000,512,475,493,235,516,751
1000,507,531,455,282,454,736
1000,523,491,484,261,482,743
1000,484,476,517,237,507,744
1000,497,506,487,259,472,731
1000,512,501,534,254,524,778
1000,490,503,513,230,519,749
1000,491,497,515,240,515,755
1000,491,533,475,248,483,731
1000,503,496,500,258,478,736
1000,493,500,498,231,510,741
1000,522,485,484,253,503,756
1000,501,512,509,258,486,744
1000,485,482,522,244,508,752
1000,492,522,522,259,496,755
1000,503,497,509,252,497,749
1000,527,521,489,292,459,751
1000,510,505,501,258,485,743
1000,488,533,518,262,492,754
1000,518,512,509,264,502,766
1000,490,492,479,250,473,723
1000,495,511,471,255,486,741
1000,499,486,489,247,506,753
1000,510,490,518,244,523,767
1000,496,499,479,240,496,736
1000,486,512,481,241,484,725
1000,475,510,490,240,491,731
1000,507,484,485,255,491,746
1000,495,518,495,267,483,750
1000,505,494,505,266,488,754
1000,493,531,504,257,496,753
1000,520,533,504,266,499,765
1000,498,494,501,254,501,755
1000,492,469,511,225,532,757
1000,512,493,492,251,505,756
1000,497,491,514,246,512,758
1000,509,483,494,239,515,754
1000,493,500,488,256,487,743
1000,516,491,501,262,492,754
1000,511,475,499,243,509,752
1000,504,494,508,238,522,760
1000,502,511,485,253,480,733
1000,527,477,508,262,492,754
1000,505,474,514,232,523,755
1000,515,501,507,250,501,751
1000,518,493,497,255,494,749
1000,490,511,502,248,486,734
1000,504,481,521,232,543,775
1000,506,490,494,251,499,750
1000,497,511,527,263,490,753
1000,480,500,515,250,499,749
1000,514,497,495,245,510,755
1000,510,517,534,256,510,766
1000,526,492,497,256,504,760
1000,509,485,480,243,518,761
1000,505,494,495,234,513,747
1000,485,494,523,246,508,754
1000,490,487,490,236,507,743
1000,477,508,488,242,480,722
1000,475,512,499,244,489,733
1000,515,495,488,253,499,752
1000,496,487,495,245,507,752
1000,494,502,484,239,509,748
1000,500,499,527,232,530,762
1000,499,493,511,240,526,766
1000,475,511,491,244,495,739
1000,482,516,469,250,479,729
1000,504,504,520,247,511,758
1000,478,507,460,249,482,731
1000,496,472,521,232,535,767
1000,515,541,466,286,460,746
1000,496,490,479,231,512,743
1000,547,532,500,281,499,780
1000,502,520,491,257,482,739
1000,511,480,529,250,522,772
1000,486,519,499,250,498,748
1000,499,491,488,239,506,745
1000,513,494,509,260,501,761
1000,489,502,503,234,512,746
1000,511,517,529,258,512,770
1000,468,527,501,253,477,730
1000,504,506,507,259,491,750
1000,491,491,508,239,504,743
1000,478,525,487,255,470,725
1000,477,502,482,241,492,733
1000,482,473,489,219,522,741
1000,485,505,502,235,509,744
1000,492,508,475,249,481,730
1000,496,525,498,246,497,743
1000,502,510,493,266,487,753
1000,505,500,477,257,479,736
1000,502,488,501,247,522,769
1000,493,516,489,258,487,745
1000,528,484,509,260,511,771
1000,510,492,515,247,513,760
1000,498,497,503,248,507,755
1000,484,510,519,244,517,761
1000,533,497,515,268,502,770
1000,502,490,521,244,531,775
1000,488,501,513,239,494,733
1000,523,507,506,275,497,772
1000,505,505,471,256,488,744
1000,497,466,483,240,491,731
1000,511,503,508,252,514,766
1000,508,503,499,255,495,750
1000,503,488,476,242,491,733
1000,486,492,511,245,514,759
1000,519,494,511,254,497,751
1000,488,491,502,243,491,734
1000,519,522,468,278,490,768
1000,500,530,525,268,498,766
1000,510,517,499,275,483,758
1000,488,533,510,250,489,739
1000,521,493,488,264,493,757
1000,503,509,470,248,503,751
1000,488,528,506,241,512,753
1000,518,529,477,266,486,752
1000,474,513,508,243,501,744
1000,507,474,504,227,524,751
1000,480,523,500,246,488,734
1000,493,494,508,258,492,750
1000,504,495,493,244,518,762
1000,474,500,474,240,473,713
1000,490,526,517,263,504,767
1000,477,519,524,247,502,749
1000,495,490,515,244,517,761
1000,476,509,479,249,455,704
1000,512,487,497,258,491,749
1000,507,510,503,248,502,750
1000,505,507,483,239,522,761
1000,511,511,514,265,497,762
1000,510,512,497,264,496,760
1000,504,487,480,246,486,732
1000,498,499,471,233,505,738
1000,507,505,507,243,512,755
1000,512,512,493,266,489,755
1000,524,502,486,267,478,745
1000,527,517,472,267,490,757
1000,526,468,518,247,519,766
1000,477,472,498,214,527,741
1000,500,487,495,244,499,743
1000,501,517,497,269,488,757
1000,469,498,512,236,520,756
1000,496,487,463,231,496,727
1000,500,513,488,254,494,748
1000,494,515,511,252,509,761
1000,500,504,490,239,507,746
1000,500,479,504,227,527,754
1000,500,477,513,225,536,761
1000,488,469,480,229,497,726
1000,497,501,516,256,502,758
1000,476,494,481,226,507,733
1000,497,513,502,260,494,754
1000,490,492,495,232,494,726
1000,505,506,497,267,498,765
1000,522,513,487,271,486,757
1000,498,470,488,247,495,742
1000,512,499,490,247,508,755
1000,529,493,494,267,496,763
1000,489,471,500,249,494,743
1000,495,502,504,245,511,756
1000,502,489,501,244,500,744
1000,478,472,472,232,498,730
1000,485,481,508,225,530,755
1000,490,490,507,232,519,751
1000,495,509,504,253,503,756
1000,516,475,487,244,500,744
1000,513,524,534,256,507,763
1000,491,480,516,233,508,741
1000,519,488,516,256,513,769
1000,497,499,519,251,513,764
1000,492,496,518,244,498,742
1000,511,475,496,242,520,762
1000,505,502,518,261,488,749
1000,482,524,504,254,477,731
1000,546,498,514,263,527,790
1000,529,499,491,264,487,751
1000,501,478,485,252,485,737
1000,519,516,499,272,482,754
1000,508,478,469,238,500,738
1000,490,482,510,251,496,747
1000,513,498,523,251,516,767
1000,510,508,463,251,496,747
1000,498,530,463,263,467,730
1000,506,504,526,266,500,766
1000,490,514,502,269,475,744
1000,512,510,502,267,493,760
1000,463,517,462,246,465,711
1000,505,512,488,261,495,756
1000,511,509,496,270,483,753
1000,498,528,480,250,491,741
1000,506,489,529,256,503,759
1000,505,511,499,246,507,753
1000,503,501,498,256,484,740
1000,500,505,484,249,496,745
1000,490,492,495,247,506,753
1000,497,492,477,258,491,749
1000,504,455,511,225,535,760
1000,488,501,503,234,520,754
1000,494,512,543,241,529,770
1000,505,488,479,250,488,738
1000,500,485,517,245,510,755
1000,491,504,494,261,480,741
1000,496,493,524,239,511,750
1000,478,501,489,239,505,744
1000,491,496,497,238,512,750
1000,491,493,507,246,486,732
1000,472,505,515,240,499,739
1000,520,484,463,244,506,750
1000,513,488,513,246,518,764
1000,519,514,497,264,491,755
1000,537,485,505,273,499,772
1000,511,491,506,258,482,740
1000,523,519,490,277,480,757
1000,521,504,470,279,455,734
1000,488,492,493,228,511,739
1000,507,506,479,237,499,736
1000,512,497,517,257,507,764
1000,498,484,504,240,516,756
1000,518,505,488,254,509,763
1000,477,508,501,251,476,727
1000,536,494,496,266,509,775
1000,472,495,523,237,527,764
1000,491,486,513,237,515,752
1000,482,500,497,234,501,735
1000,501,523,513,263,502,765
1000,505,482,527,253,509,762
1000,507,487,492,237,500,737
1000,481,506,484,242,499,741
1000,503,486,491,242,521,763
1000,514,489,511,254,501,755
1000,489,485,478,223,511,734
1000,507,540,515,277,470,747
1000,529,521,529,275,498,773
1000,493,465,503,223,526,749
1000,512,476,487,240,505,745
1000,490,473,473,226,500,726
1000,486,516,507,249,497,746
1000,497,513,523,254,506,760
1000,478,511,491,234,492,726
1000,528,506,473,262,483,745
1000,513,503,486,252,514,766
1000,484,494,512,235,505,740
1000,472,488,477,209,518,727
1000,500,512,498,255,491,746
1000,485,503,514,246,512,758
1000,519,510,507,253,519,772
1000,510,503,516,267,495,762
1000,499,519,549,248,528,776
1000,479,504,494,240,491,731
1000,480,481,508,249,478,727
1000,498,491,509,240,509,749
1000,510,498,508,274,479,753
1000,514,487,477,246,496,742
1000,495,481,510,233,515,748
1000,501,513,513,252,501,753
1000,495,515,535,273,494,767
1000,525,501,489,262,493,755
1000,521,515,503,266,496,762
1000,506,475,510,236,538,774
1000,519,485,514,244,509,753
1000,494,499,514,242,502,744
1000,501,534,501,265,482,747
1000,531,508,506,252,513,765
1000,517,502,506,266,504,770
1000,512,495,480,255,503,758
1000,515,505,529,268,504,772
1000,517,511,506,243,523,766
1000,498,512,521,242,514,756
1000,486,501,509,241,488,729
1000,480,485,489,224,514,738
1000,493,516,505,266,489,755
1000,503,507,507,255,500,755
1000,502,518,484,261,474,735
1000,517,507,502,270,473,743
1000,503,500,522,242,534,776
1000,499,532,519,267,493,760
1000,471,489,527,215,540,755
1000,501,543,536,274,495,769
1000,495,478,510,233,505,738
1000,504,472,509,224,536,760
1000,493,497,506,254,502,756
1000,496,516,500,266,474,740
1000,498,519,513,266,479,745
1000,502,514,506,251,500,751
1000,488,505,500,265,488,753
1000,507,521,507,262,492,754
1000,495,486,504,245,492,737
1000,514,499,503,252,507,759
1000,509,529,501,274,480,754
1000,497,511,491,265,479,744
1000,497,480,500,226,532,758
1000,474,500,520,244,496,740
1000,532,492,481,266,486,752
1000,488,487,480,245,482,727
1000,480,488,485,222,514,736
1000,518,521,489,268,491,759
1000,491,478,468,227,509,736
1000,507,484,518,246,511,757
1000,521,518,513,278,485,763
1000,541,506,524,262,508,770
1000,539,489,510,269,503,772
1000,499,524,501,264,490,754
1000,497,514,506,250,489,739
1000,511,504,484,262,485,747
1000,510,492,509,230,538,768
1000,493,513,489,254,491,745
1000,496,500,510,236,507,743
1000,493,483,513,238,518,756
1000,515,513,508,267,504,771
1000,507,519,519,261,508,769
1000,475,496,499,242,492,734
1000,509,508,498,247,509,756
1000,484,503,522,239,521,760
1000,516,501,522,261,508,769
1000,498,488,500,242,513,755
1000,489,513,471,248,470,718
1000,492,477,508,227,517,744
1000,472,508,502,238,500,738
1000,490,541,495,270,475,745
1000,516,500,487,255,492,747
1000,480,524,528,250,507,757
1000,484,486,496,239,499,738
1000,499,511,520,254,502,756
1000,505,503,524,249,516,765
1000,477,514,498,247,484,731
1000,490,539,523,268,482,750
1000,481,482,498,239,513,752
1000,501,524,504,253,498,751
1000,519,506,522,272,499,771
1000,503,482,498,252,475,727
1000,503,516,495,255,473,728
1000,480,515,505,247,501,748
1000,522,493,502,266,505,771
1000,525,504,529,258,506,764
1000,513,480,509,247,513,760
1000,500,494,497,253,490,743
1000,494,469,481,232,511,743
1000,502,522,507,265,498,763
1000,488,504,491,243,494,737
1000,500,464,496,230,522,752
1000,484,486,501,241,492,733
1000,508,516,500,271,479,750
1000,510,502,505,257,496,753
1000,504,499,491,241,498,739
1000,480,476,506,228,524,752
1000,528,503,504,262,509,771
1000,505,489,520,245,524,769
1000,479,478,507,229,508,737
1000,508,488,505,252,507,759
1000,523,498,484,269,488,757
1000,496,509,510,232,527,759
1000,518,501,499,272,488,760
1000,498,484,499,242,515,757
1000,491,475,501,248,492,740
1000,491,511,500,254,499,753
1000,500,490,493,251,482,733
1000,528,485,508,252,520,772
1000,499,516,525,259,503,762
1000,500,487,513,241,512,753
1000,502,493,500,243,503,746
1000,495,484,482,239,493,732
1000,514,499,487,244,499,743
1000,518,472,486,252,499,751
1000,524,503,526,258,515,773
1000,529,488,508,255,518,773
1000,507,491,478,253,494,747
1000,506,504,480,240,489,729
1000,522,510,505,266,506,772
1000,480,491,493,233,505,738
1000,505,494,490,253,508,761
1000,500,505,492,264,483,747
1000,496,500,510,244,510,754
1000,505,487,484,238,512,750
1000,524,479,505,249,517,766
1000,499,477,495,233,516,749
1000,489,481,505,242,499,741
1000,481,507,491,241,500,741
1000,498,505,502,254,518,772
1000,482,490,497,231,502,733
1000,502,512,500,266,494,760
1000,513,496,502,264,477,741
1000,492,525,476,258,477,735
1000,502,497,475,252,483,735
1000,472,493,484,218,502,720
1000,486,514,484,244,498,742
1000,495,501,513,248,506,754
1000,491,496,507,259,496,755
1000,506,513,518,265,480,745
1000,485,470,513,238,502,740
1000,487,491,502,254,478,732
1000,514,476,511,238,524,762
1000,491,496,515,239,505,744
1000,478,529,498,268,480,748
1000,519,506,488,252,513,765
1000,481,540,488,269,461,730
1000,499,509,492,250,495,745
1000,495,484,491,226,516,742
1000,508,487,497,246,496,742
1000,502,482,471,244,504,748
1000,511,499,513,252,522,774
1000,481,511,516,230,525,755
1000,498,514,514,251,501,752
1000,502,520,505,262,503,765
1000,507,471,488,224,530,754
1000,500,483,482,231,510,741
1000,494,511,501,259,485,744
1000,487,519,500,248,496,744
1000,494,518,518,258,501,759
1000,480,506,508,232,514,746
1000,483,493,478,240,482,722
1000,475,501,526,236,516,752
1000,516,500,511,271,487,758
1000,511,502,503,264,483,747
1000,519,522,508,265,504,769
1000,486,512,509,245,492,737
1000,477,523,485,250,486,736
1000,502,491,501,243,509,752
1000,507,492,506,259,501,760
1000,510,506,493,259,489,748
1000,516,483,500,249,526,775
1000,502,497,498,252,491,743
1000,505,500,528,249,531,780
1000,534,490,504,254,509,763
1000,503,532,523,270,495,765
1000,473,480,521,232,519,751
1000,483,485,509,237,504,741
1000,490,486,483,246,490,736
1000,483,516,478,238,490,728
1000,527,493,496,259,512,771
1000,479,483,486,237,490,727
1000,493,502,498,264,485,749
1000,467,489,489,224,509,733
1000,510,469,493,232,531,763
1000,517,501,523,264,503,767
1000,522,483,490,233,524,757
1000,482,509,498,240,507,747
1000,515,559,493,286,479,765
1000,505,498,479,241,496,737
1000,512,517,501,254,509,763
1000,498,508,493,255,499,754
1000,526,471,494,245,516,761
1000,490,508,506,252,498,750
1000,477,518,510,254,489,743
1000,479,491,513,235,494,729
1000,506,455,509,233,520,753
1000,483,506,525,248,513,761
1000,509,479,474,246,479,725
1000,487,512,504,232,503,735
1000,499,511,518,260,489,749
1000,536,523,500,282,478,760
1000,468,527,509,237,502,739
1000,493,504,506,250,503,753
1000,488,505,505,247,489,736
1000,515,479,505,261,489,750
1000,523,524,508,270,506,776
1000,491,495,489,226,512,738
1000,506,490,519,266,478,744
1000,523,503,532,257,518,775
1000,498,537,485,251,470,721
1000,502,491,518,239,524,763
1000,501,499,530,254,518,772
1000,481,523,486,251,486,737
1000,515,529,500,268,477,745
1000,502,505,496,243,517,760
1000,510,487,460,239,504,743
1000,497,506,516,246,515,761
1000,496,495,509,242,512,754
1000,501,502,496,232,496,728
1000,512,499,504,258,512,770
1000,489,515,534,251,511,762
1000,525,513,502,272,481,753
1000,503,523,495,261,475,736
1000,526,485,492,260,500,760
1000,492,495,515,244,503,747
1000,478,505,485,241,488,729
1000,529,523,481,283,471,754
1000,486,483,480,234,484,718
1000,509,481,512,258,510,768
1000,503,515,502,253,498,751
1000,503,518,476,268,483,751
1000,516,501,493,264,498,762
1000,519,507,520,278,493,771
1000,526,485,498,269,500,769
1000,505,484,484,244,499,743
1000,519,520,503,282,473,755
1000,491,523,489,270,471,741
1000,494,498,513,249,498,747
1000,494,515,505,251,498,749
1000,508,488,473,253,489,742
1000,477,478,500,236,506,742
1000,520,500,494,261,511,772
1000,501,517,479,256,481,737
1000,510,500,478,262,474,736
1000,510,530,530,260,505,765
1000,495,473,527,233,519,752
1000,505,503,477,244,493,737
1000,489,492,477,232,506,738
1000,493,509,476,248,476,724
1000,511,502,491,263,494,757
1000,497,488,493,238,490,728
1000,513,511,512,263,499,762
1000,492,485,497,247,498,745
1000,516,496,506,253,493,746
1000,472,508,483,242,482,724
1000,520,470,511,247,514,761
1000,504,482,501,249,503,752
1000,497,486,501,234,503,737
1000,505,485,491,239,522,761
1000,492,502,499,237,497,734
1000,506,529,514,275,471,746
1000,497,528,525,273,493,766
1000,482,518,507,255,497,752
1000,462,498,528,230,521,751
1000,484,514,511,248,496,744
1000,513,492,488,260,466,726
1000,484,498,503,245,498,743
1000,480,487,509,225,525,750
1000,495,483,498,239,515,754
1000,508,510,479,258,474,732
1000,523,513,492,259,497,756
1000,524,502,507,261,506,767
1000,495,493,466,237,503,740
1000,486,513,474,244,458,702
1000,502,523,506,271,504,775
1000,521,523,491,279,473,752
1000,495,503,515,256,497,753
1000,494,508,544,264,500,764
1000,494,492,487,240,504,744
1000,498,487,501,237,501,738
1000,499,534,516,262,493,755
1000,492,475,477,232,494,726
1000,494,499,492,252,488,740
1000,501,486,506,245,511,756
1000,490,501,490,230,507,737
1000,481,516,507,255,501,756
1000,476,499,511,235,497,732
1000,510,492,524,263,501,764
1000,505,505,474,253,476,729
1000,485,498,487,242,493,735
1000,504,500,490,241,511,752
1000,498,516,489,263,472,735
1000,484,509,484,254,475,729
1000,481,479,445,220,501,721
1000,508,497,470,252,493,745
1000,508,473,483,245,498,743
1000,517,518,506,266,493,759
1000,513,501,514,257,517,774
1000,484,502,505,238,506,744
1000,462,503,536,231,513,744
1000,512,514,492,279,470,749
1000,489,514,506,248,502,750
1000,515,471,514,243,518,761
1000,482,526,505,253,492,745
1000,489,499,513,235,521,756
1000,510,496,509,247,516,763
1000,485,494,496,232,496,728
1000,485,482,523,222,533,755
1000,496,514,490,255,499,754
1000,549,504,507,277,491,768
1000,492,514,478,263,490,753
1000,532,515,496,264,513,777
1000,536,504,515,257,509,766
1000,493,517,505,257,497,754
1000,486,507,474,230,499,729
1000,509,510,501,251,523,774
1000,499,507,527,248,516,764
1000,486,503,480,232,513,745
1000,508,481,490,250,505,755
1000,493,493,477,249,490,739
1000,501,486,499,255,485,740
1000,530,505,491,271,490,761
1000,516,477,523,233,549,782
1000,480,504,519,245,515,760
1000,484,500,517,241,510,751
1000,496,518,499,256,500,756
1000,506,482,496,256,484,740
1000,484,485,513,249,498,747
1000,487,484,488,244,496,740
1000,537,487,497,278,476,754
1000,511,501,513,242,517,759
1000,500,515,489,251,493,744
1000,484,494,510,243,509,752
1000,509,496,518,245,527,772
1000,464,506,532,244,501,745
1000,512,512,500,276,479,755
1000,489,491,511,242,512,754
1000,492,507,511,251,504,755
1000,530,479,515,258,532,790
1000,518,492,499,255,496,751
1000,501,519,511,258,492,750
1000,498,494,490,239,494,733
1000,476,507,490,239,495,734
1000,503,495,513,255,503,758
1000,499,477,522,250,512,762
1000,492,513,541,247,525,772
1000,489,500,497,232,506,738
1000,498,511,489,246,508,754
1000,506,499,522,248,505,753
1000,507,479,509,248,511,759
1000,499,501,489,241,501,742
1000,509,489,500,244,510,754
1000,509,502,494,256,484,740
1000,499,498,494,243,523,766
1000,488,470,476,228,505,733
1000,499,482,492,224,524,748
1000,512,515,512,267,493,760
1000,508,511,509,263,494,757
1000,509,511,506,267,492,759
1000,489,513,503,245,513,758
1000,502,505,495,263,486,749
1000,511,521,518,261,504,765
1000,488,481,517,237,505,742
1000,494,469,497,238,515,753
1000,515,497,516,256,520,776
1000,532,496,473,274,464,738
1000,505,493,489,243,498,741
1000,504,529,474,268,458,726
1000,471,515,509,234,509,743
1000,496,489,478,243,505,748
1000,511,467,511,226,525,751
1000,486,524,505,254,502,756
1000,516,486,507,243,517,760
1000,513,490,505,249,517,766
1000,522,512,514,261,499,760
1000,514,508,503,271,487,758
1000,472,507,516,229,513,742
1000,468,496,504,235,500,735
1000,463,490,504,231,499,730
1000,492,477,522,244,512,756
1000,525,512,499,265,491,756
1000,498,497,486,237,493,730
1000,520,500,529,261,510,771
1000,502,502,521,250,525,775
1000,501,485,514,243,515,758
1000,478,494,512,225,530,755
1000,520,502,506,270,493,763
1000,488,503,500,236,494,730
1000,501,470,506,223,536,759
1000,499,499,483,248,479,727
1000,499,492,496,252,509,761
1000,513,513,493,261,498,759
1000,539,486,505,259,502,761
1000,498,504,517,241,522,763
1000,495,488,540,252,517,769
1000,515,509,488,261,480,741
1000,501,495,489,257,497,754
1000,495,495,512,248,499,747
1000,490,522,466,247,493,740
1000,497,502,474,239,488,727
1000,515,517,529,266,506,772
1000,514,513,517,267,496,763
1000,480,472,485,228,506,734
1000,497,476,494,252,492,744
1000,497,502,461,236,490,726
1000,506,526,489,275,477,752
1000,505,512,490,277,465,742
1000,466,492,501,242,483,725
1000,500,510,489,246,498,744
1000,480,459,522,225,530,755
1000,482,533,506,266,478,744
1000,470,475,494,202,530,732
1000,507,476,485,238,502,740
1000,489,508,484,231,502,733
1000,514,527,505,275,486,761
1000,499,499,510,238,520,758
1000,499,487,531,234,528,762
1000,525,476,492,255,502,757
1000,525,501,517,274,495,769
1000,493,500,511,249,512,761
1000,506,493,516,252,505,757
1000,505,486,521,250,513,763
1000,489,516,490,253,501,754
1000,507,502,494,254,501,755
1000,480,467,507,226,510,736
1000,477,479,498,223,508,731
1000,500,506,513,249,526,775
1000,492,500,492,238,518,756
1000,498,486,484,250,497,747
1000,496,497,488,239,502,741
1000,510,490,491,240,523,763
1000,468,496,487,228,488,716
1000,497,524,494,268,486,754
1000,525,508,529,262,527,789
1000,508,500,489,263,498,761
1000,508,498,509,242,505,747
1000,493,518,522,259,509,768
1000,507,508,540,242,524,766
1000,500,522,536,249,511,760
1000,492,522,481,258,481,739
1000,504,479,508,242,503,745
1000,517,501,520,256,510,766
1000,485,515,485,266,454,720
1000,477,487,494,230,508,738
1000,525,487,481,258,485,743
1000,508,483,508,247,492,739
1000,495,467,466,226,517,743
1000,513,474,499,247,503,750
1000,479,512,516,255,495,750
1000,473,492,519,228,513,741
1000,495,497,494,242,499,741
1000,492,522,497,269,484,753
1000,508,497,494,261,495,756
1000,518,495,535,255,535,790
1000,506,519,491,248,506,754
1000,494,542,476,269,463,732
1000,518,496,489,255,511,766
1000,509,512,474,260,477,737
1000,498,471,488,248,497,745
1000,487,535,459,269,452,721
1000,497,498,493,248,482,730
1000,518,507,497,269,496,765
1000,503,503,504,245,511,756
1000,483,501,510,234,517,751
1000,491,512,518,264,484,748
1000,506,517,498,257,504,761
1000,455,489,488,222,497,719
1000,514,489,503,256,501,757
1000,484,500,514,244,504,748
1000,509,506,504,263,492,755
1000,472,486,508,245,488,733
1000,508,477,507,249,511,760
1000,505,508,502,251,501,752
1000,511,504,492,269,486,755
1000,501,529,504,265,479,744
1000,498,498,505,231,525,756
1000,465,492,506,249,488,737
1000,493,500,497,242,508,750
1000,537,524,500,280,486,766
1000,500,492,534,249,525,774
1000,512,523,491,275,474,749
1000,509,467,500,234,523,757
1000,500,524,463,273,456,729
1000,509,519,498,263,506,769
1000,500,487,535,241,522,763
1000,508,492,520,238,537,775
1000,512,487,500,270,495,765
1000,499,499,513,255,496,751
1000,516,507,513,273,492,765
1000,470,506,495,239,486,725
1000,483,472,474,217,496,713
1000,502,494,499,244,514,758
1000,484,506,509,236,518,754
1000,497,521,511,268,494,762
1000,514,521,504,270,488,758
1000,497,509,476,258,472,730
1000,496,491,480,246,473,719
1000,493,497,508,252,500,752
1000,513,506,511,252,511,763
1000,514,496,497,248,506,754
1000,491,513,498,250,492,742
1000,527,520,531,285,487,772
1000,519,515,491,262,507,769
1000,486,501,521,256,512,768
1000,510,478,480,242,499,741
1000,501,506,497,252,495,747
1000,502,472,535,224,535,759
1000,490,465,502,230,517,747
1000,504,539,520,276,474,750
1000,495,501,506,241,512,753
1000,487,499,511,232,519,751
1000,522,520,483,272,482,754
1000,502,483,502,238,515,753
1000,519,482,497,269,503,772
1000,495,512,491,240,508,748
1000,526,514,514,259,514,773
1000,505,501,510,253,498,751
1000,519,512,514,265,491,756
1000,498,475,503,230,511,741
1000,501,494,510,236,522,758
1000,507,533,495,264,490,754
1000,519,516,484,262,492,754
1000,496,474,499,222,529,751
1000,510,522,504,269,488,757
1000,501,515,496,259,478,737
1000,506,512,533,261,514,775
1000,529,509,510,274,485,759
1000,499,488,479,252,488,740
1000,514,524,482,272,473,745
1000,519,505,483,257,498,755
1000,501,510,486,241,495,736
1000,515,515,496,257,508,765
1000,504,488,517,251,514,765
1000,502,495,514,260,501,761
1000,480,502,493,245,492,737
1000,466,504,486,221,501,722
1000,499,509,480,253,488,741
1000,483,482,508,227,520,747
1000,529,489,492,241,527,768
1000,497,490,478,242,497,739
1000,505,510,509,251,520,771
1000,513,517,507,276,485,761
1000,514,519,487,262,478,740
1000,495,486,506,240,524,764
1000,516,505,489,260,487,747
1000,501,495,495,246,512,758
1000,463,502,488,223,494,717
1000,517,502,497,275,462,737
1000,476,516,508,233,498,731
1000,512,510,471,258,482,740
1000,485,509,532,250,505,755
1000,480,460,502,217,531,748
1000,508,494,489,254,484,738
1000,531,483,538,268,509,777
1000,509,474,468,244,481,725
1000,476,521,513,248,502,750
1000,492,503,495,256,474,730
1000,492,503,495,245,484,729
1000,505,498,510,261,506,767
1000,493,522,511,266,490,756
1000,488,483,509,229,532,761
1000,489,507,516,257,488,745
1000,492,500,522,242,533,775
1000,509,505,494,262,493,755
1000,490,492,507,225,538,763
1000,492,494,509,231,518,749
1000,513,507,496,250,506,756
1000,489,484,522,245,510,755
1000,487,490,479,238,496,734
1000,473,502,512,239,511,750
1000,505,507,513,253,516,769
1000,489,516,518,242,504,746
1000,513,501,489,271,463,734
1000,483,497,500,229,521,750
1000,491,504,495,255,488,743
1000,508,498,519,265,500,765
1000,517,501,511,253,521,774
1000,476,483,520,234,496,730
1000,508,505,498,250,509,759
1000,516,470,465,253,487,740
1000,530,502,504,274,495,769
1000,497,526,482,246,503,749
1000,495,511,498,261,485,746
1000,497,511,484,252,482,734
1000,501,519,499,260,496,756
1000,521,511,520,269,495,764
1000,527,494,487,260,518,778
1000,513,510,523,256,508,764
1000,479,514,492,239,487,726
1000,486,498,495,241,494,735
1000,472,524,505,233,512,745
1000,523,487,492,264,499,763
1000,474,522,518,258,486,744
1000,524,483,493,251,510,761
1000,458,503,487,209,506,715
1000,503,508,492,251,497,748
1000,488,520,519,240,521,761
1000,511,509,531,263,498,761
1000,475,496,508,249,492,741
1000,480,512,462,252,476,728
1000,512,516,521,257,500,757
1000,489,496,495,245,497,742
1000,498,508,468,236,499,735
1000,519,468,513,246,516,762
1000,481,501,541,224,530,754
1000,521,501,486,258,500,758
1000,512,524,521,270,492,762
1000,479,494,512,240,503,743
1000,485,513,509,249,506,755
1000,519,498,476,265,484,749
1000,495,501,495,240,508,748
1000,496,513,489,245,498,743
1000,492,502,509,255,495,750
1000,496,504,512,254,496,750
1000,511,508,497,253,511,764
1000,481,490,512,244,503,747
1000,510,491,512,248,526,774
1000,513,489,505,248,493,741
1000,501,515,495,265,477,742
1000,508,510,489,266,475,741
1000,491,507,490,233,516,749
1000,508,482,501,235,524,759
1000,492,498,490,243,496,739
1000,506,495,472,267,486,753
1000,490,504,486,256,486,742
1000,499,500,511,245,508,753
1000,517,501,497,278,478,756
1000,521,510,482,267,485,752
1000,518,506,493,257,509,766
1000,482,514,487,240,494,734
1000,505,498,508,254,503,757
1000,512,483,487,254,489,743
1000,492,501,514,243,514,757
1000,519,521,508,265,503,768
1000,475,491,490,222,504,726
1000,513,499,525,251,517,768
1000,498,475,500,221,539,760
1000,504,503,510,253,497,750
1000,496,503,509,243,511,754
1000,548,499,509,259,527,786
1000,504,491,485,270,477,747
1000,507,501,505,250,510,760
1000,509,511,493,257,491,748
1000,479,502,484,236,484,720
1000,484,497,504,243,498,741
1000,512,497,511,246,518,764
1000,476,514,473,241,482,723
1000,496,487,502,241,512,753
1000,511,498,514,240,520,760
1000,527,506,494,254,500,754
1000,518,517,502,269,480,749
1000,498,494,498,243,500,743
1000,496,492,499,256,494,750
1000,492,504,460,262,456,718
1000,495,500,490,260,476,736
1000,521,508,512,270,493,763
1000,498,505,479,265,470,735
1000,507,513,519,250,507,757
1000,496,515,499,249,492,741
1000,514,512,516,269,502,771
1000,496,508,521,261,490,751
1000,495,532,513,260,492,752
1000,505,491,467,239,497,736
1000,479,497,517,242,513,755
1000,492,500,480,244,477,721
1000,510,501,515,258,498,756
1000,519,478,508,256,502,758
1000,485,498,493,238,509,747
1000,508,506,473,239,511,750
1000,503,495,485,245,496,741
1000,498,485,534,235,519,754
1000,529,508,494,268,509,777
1000,493,511,509,254,492,746
1000,472,466,525,237,515,752
1000,517,480,470,242,497,739
1000,497,489,511,236,519,755
1000,477,491,488,256,485,741
1000,490,484,490,230,497,727
1000,494,487,462,231,476,707
1000,493,498,518,236,521,757
1000,508,516,523,252,515,767
1000,487,508,523,265,499,764
1000,505,533,455,269,472,741
1000,521,478,507,246,527,773
1000,518,505,499,265,480,745
1000,495,520,523,260,502,762
1000,505,511,516,248,518,766
1000,526,504,509,271,495,766
1000,512,478,484,238,519,757
1000,504,517,478,249,487,736
1000,525,503,491,261,497,758
1000,498,502,500,247,502,749
1000,476,523,497,255,488,743
1000,488,501,497,256,482,738
1000,484,462,520,215,539,754
1000,508,506,489,240,506,746
1000,508,516,508,253,512,765
1000,516,509,491,264,482,746
1000,531,505,530,273,509,782
1000,529,516,490,273,483,756
1000,503,514,505,257,498,755
1000,490,506,509,245,502,747
1000,484,521,495,251,472,723
1000,509,515,505,285,481,766
1000,483,491,509,242,493,735
1000,507,494,513,248,519,767
1000,507,532,485,274,470,744
1000,492,471,484,223,525,748
1000,509,497,503,260,489,749
1000,496,496,499,239,495,734
1000,530,496,486,264,495,759
1000,500,503,545,250,522,772
1000,501,484,484,237,499,736
1000,500,491,515,257,498,755
1000,474,477,481,230,495,725
1000,491,488,517,242,513,755
1000,503,462,514,244,511,755
1000,504,522,489,264,476,740
1000,515,500,489,263,500,763
1000,496,502,515,254,508,762
1000,525,513,485,260,501,761
1000,503,501,524,259,517,776
1000,519,497,512,264,491,755
1000,485,496,496,233,511,744
1000,493,515,499,255,491,746
1000,509,493,489,248,497,745
1000,511,492,506,249,511,760
1000,498,497,472,252,475,727
1000,497,502,495,260,501,761
1000,472,468,487,235,499,734
1000,514,525,488,280,470,750
1000,486,507,518,244,500,744
1000,504,485,509,234,524,758
1000,485,500,512,231,526,757
1000,498,487,515,248,499,747
1000,504,522,480,258,489,747
1000,508,499,529,261,494,755
1000,486,496,515,230,531,761
1000,488,503,511,236,510,746
1000,498,509,483,255,477,732
1000,490,534,519,260,483,743
1000,502,507,512,260,509,769
1000,485,516,473,257,461,718
1000,502,506,528,265,493,758
1000,507,510,492,262,500,762
1000,498,505,509,249,500,749
1000,510,524,536,257,525,782
1000,481,490,511,237,497,734
1000,482,508,497,248,479,727
1000,514,514,516,269,500,769
1000,512,481,499,267,493,760
1000,502,487,496,249,489,738
1000,515,479,495,239,522,761
1000,487,502,491,239,490,729
1000,509,507,516,269,484,753
1000,513,511,552,262,528,790
1000,486,495,481,255,492,747
1000,468,481,484,219,509,728
1000,497,461,492,233,516,749
1000,511,497,511,273,503,776
1000,501,476,472,236,505,741
1000,528,504,482,269,488,757
1000,510,502,522,242,527,769
1000,512,500,461,233,503,736
1000,486,511,503,247,498,745
1000,499,478,529,250,514,764
1000,491,490,471,236,492,728
1000,495,499,465,238,490,728
1000,453,509,491,224,488,712
1000,469,516,503,247,479,726
1000,503,498,500,255,498,753
1000,500,492,500,247,511,758
1000,504,505,495,264,491,755
1000,509,515,491,245,500,745
1000,507,499,503,252,511,763
1000,501,488,495,243,496,739
1000,486,492,481,228,514,742
1000,509,505,536,255,522,777
1000,503,509,495,270,490,760
1000,512,497,479,257,491,748
1000,492,488,493,245,502,747
1000,497,482,481,242,492,734
1000,503,496,506,236,520,756
1000,496,481,502,243,510,753
1000,504,508,496,262,500,762
1000,479,480,504,226,516,742
1000,520,522,516,282,479,761
1000,510,495,521,254,501,755
1000,509,518,508,273,481,754
1000,514,515,458,273,477,750
1000,500,496,475,244,492,736
1000,486,471,504,231,510,741
1000,503,506,501,262,480,742
1000,517,516,497,263,495,758
1000,486,506,504,246,504,750
1000,491,510,502,256,485,741
1000,488,509,509,242,504,746
1000,491,485,502,241,499,740
1000,501,494,526,245,521,766
1000,502,478,505,257,496,753
1000,499,509,490,257,478,735
1000,536,490,495,260,514,774
1000,494,492,489,244,497,741
1000,509,536,508,262,492,754
1000,491,494,475,242,483,725
1000,503,496,457,256,471,727
1000,510,488,495,248,487,735
1000,519,503,478,261,483,744
1000,527,486,526,254,531,785
1000,499,497,509,256,495,751
1000,485,505,485,252,484,736
1000,514,504,498,270,485,755
1000,516,485,527,257,519,776
1000,498,502,491,248,511,759
1000,491,503,464,249,479,728
1000,497,516,478,262,465,727
1000,504,485,527,237,535,772
1000,483,486,498,227,523,750
1000,498,484,475,238,495,733
1000,484,496,515,223,522,745
1000,500,509,474,240,499,739
1000,484,498,507,241,524,765
1000,491,498,516,264,493,757
1000,509,497,503,246,509,755
1000,496,468,504,237,521,758
1000,506,505,483,260,493,753
1000,479,492,495,233,500,733
1000,499,505,510,253,513,766
1000,491,470,523,239,526,765
1000,501,493,515,255,501,756
1000,478,489,497,229,507,736
1000,503,501,513,254,507,761
1000,505,513,494,267,481,748
1000,507,497,490,247,502,749
1000,495,490,473,259,472,731
1000,506,494,487,252,490,742
1000,483,495,494,244,470,714
1000,502,523,515,271,484,755
1000,526,475,526,246,537,783
1000,511,529,510,278,469,747
1000,483,519,513,243,504,747
1000,492,511,502,259,475,734
1000,513,512,503,269,473,742
1000,482,468,520,232,516,748
1000,481,482,504,220,518,738
1000,498,500,512,247,519,766
1000,489,511,489,233,509,742
1000,488,503,494,245,477,722
1000,493,477,480,233,512,745
1000,507,499,509,240,514,754
1000,504,502,502,262,498,760
1000,516,483,494,264,506,770
1000,489,475,508,243,508,751
1000,503,490,492,244,507,751
1000,491,509,536,244,502,746
1000,488,458,494,217,531,748
1000,518,496,519,265,515,780
1000,521,486,481,245,499,744
1000,506,540,477,270,470,740
1000,509,519,478,267,475,742
1000,499,487,518,241,511,752
1000,489,516,507,249,505,754
1000,495,500,494,247,513,760
1000,502,509,501,258,478,736
1000,490,483,495,215,516,731
1000,469,494,501,218,527,745
1000,511,490,513,257,502,759
1000,515,506,503,267,480,747
1000,489,527,510,253,494,747
1000,498,475,495,240,503,743
1000,501,517,526,242,526,768
1000,494,508,474,256,473,729
1000,511,498,500,257,495,752
1000,491,497,467,249,480,729
1000,503,488,519,252,506,758
1000,483,518,512,250,512,762
1000,485,475,501,225,523,748
1000,498,491,478,236,504,740
1000,507,517,469,265,465,730
1000,484,517,497,260,468,728
1000,502,502,507,253,501,754
1000,488,492,473,243,497,740
1000,511,506,482,246,503,749
1000,509,498,497,262,489,751
1000,483,537,520,266,496,762
1000,493,524,485,244,492,736
1000,518,509,497,268,475,743
1000,496,509,518,249,510,759
1000,499,525,513,262,502,764
1000,516,495,489,254,500,754
1000,487,503,502,227,513,740
1000,489,517,505,248,500,748
1000,462,482,502,235,487,722
1000,462,477,479,225,480,705
1000,493,509,504,255,497,752
1000,482,502,496,237,512,749
1000,474,511,518,251,500,751
1000,501,497,490,252,489,741
1000,495,514,496,255,488,743
1000,480,534,491,250,489,739
1000,511,524,481,263,488,751
1000,494,475,463,226,509,735
1000,512,479,507,256,513,769
1000,504,507,490,259,489,748
1000,509,520,513,261,502,763
1000,499,476,485,228,517,745
1000,521,512,482,290,465,755
1000,508,507,506,245,507,752
1000,504,481,501,236,508,744
1000,522,505,529,258,520,778
1000,522,506,490,267,481,748
1000,503,508,506,250,507,757
1000,499,493,474,243,487,730
1000,493,476,472,241,500,741
1000,480,495,499,244,497,741
1000,510,505,491,260,507,767
1000,502,507,509,256,492,748
1000,501,482,482,244,507,751
1000,482,475,479,217,514,731
1000,501,508,506,266,481,747
1000,509,503,512,270,480,750
1000,486,501,502,234,506,740
1000,507,508,495,252,493,745
1000,498,490,521,247,522,769
1000,490,510,495,264,473,737
1000,519,502,502,255,520,775
1000,488,516,489,248,477,725
1000,495,526,503,252,493,745
1000,514,495,496,257,514,771
1000,481,479,485,209,521,730
1000,530,508,489,294,451,745
1000,471,480,516,222,530,752
1000,501,488,476,246,494,740
1000,499,487,490,243,500,743
1000,498,474,489,220,513,733
1000,482,499,482,246,491,737
1000,492,490,500,228,529,757
1000,511,498,517,258,502,760
1000,514,494,496,268,501,769
1000,511,522,542,272,498,770
1000,473,506,495,238,490,728
1000,493,496,492,259,487,746
1000,497,511,523,260,508,768
1000,525,486,475,250,505,755
1000,494,505,503,251,496,747
1000,487,488,521,226,520,746
1000,483,508,491,240,504,744
1000,510,496,504,242,513,755
1000,508,484,485,253,492,745
1000,528,510,495,266,497,763
1000,499,490,525,246,518,764
1000,491,506,506,248,514,762
1000,500,524,499,269,494,763
1000,497,493,519,237,529,766
1000,458,509,522,229,525,754
1000,518,501,503,261,511,772
1000,492,529,454,268,461,729
1000,518,519,494,268,494,762
1000,521,479,499,237,520,757
1000,514,505,502,264,489,753
1000,496,539,484,273,477,750
1000,504,509,512,254,497,751
1000,518,498,514,250,499,749
1000,508,498,470,253,481,734
1000,473,508,477,250,469,719
1000,520,509,517,254,519,773
1000,517,507,488,266,490,756
1000,485,528,501,263,468,731
1000,497,480,510,248,510,758
1000,482,517,473,256,467,723
1000,479,513,496,252,489,741
1000,462,514,504,240,495,735
1000,481,503,514,239,500,739
1000,514,458,492,249,506,755
1000,500,505,508,253,505,758
1000,520,530,492,282,476,758
1000,513,522,520,271,490,761
1000,496,506,502,248,511,759
1000,526,496,490,261,494,755
1000,505,479,483,237,498,735
1000,525,516,515,288,473,761
1000,481,472,503,219,533,752
1000,503,491,488,259,480,739
1000,491,495,486,240,502,742
1000,487,487,493,243,495,738
1000,526,499,508,261,507,768
1000,494,519,511,260,493,753
1000,503,488,480,239,510,749
1000,520,486,506,238,538,776
1000,475,470,494,237,481,718
1000,488,487,471,233,488,721
1000,475,514,484,236,490,726
1000,510,500,479,258,489,747
1000,512,501,491,255,481,736
1000,495,460,495,220,521,741
1000,496,483,483,242,503,745
1000,528,500,494,267,495,762
1000,511,467,524,231,529,760
1000,514,524,501,269,488,757
1000,488,535,519,256,501,757
1000,523,500,490,272,483,755
1000,506,506,510,252,507,759
1000,505,507,538,257,518,775
1000,500,472,475,222,521,743
1000,493,509,531,252,503,755
1000,472,507,490,245,487,732
1000,517,502,488,246,504,750
1000,507,508,495,263,491,754
1000,523,539,527,285,479,764
1000,499,499,511,252,518,770
1000,524,496,461,256,477,733
1000,522,516,496,261,507,768
1000,482,483,490,240,497,737
1000,504,496,522,249,528,777
1000,557,489,482,274,489,763
1000,508,486,502,244,511,755
1000,502,508,498,257,483,740
1000,507,531,516,272,496,768
1000,508,513,506,272,495,767
1000,510,483,492,240,500,740
1000,522,494,486,260,490,750
1000,516,486,505,270,493,763
1000,485,526,499,245,491,736
1000,505,494,484,255,477,732
1000,522,531,507,276,499,775
1000,502,487,478,258,471,729
1000,505,507,526,253,519,772
1000,511,488,498,260,504,764
1000,513,496,513,251,517,768
1000,507,505,478,261,484,745
1000,511,493,472,255,483,738
1000,509,495,540,247,542,789
1000,488,510,498,253,488,741
1000,503,508,506,250,494,744
1000,480,521,509,246,499,745
1000,512,494,509,263,494,757
1000,502,523,496,264,486,750
1000,513,499,502,246,500,746
1000,476,522,495,245,494,739
1000,488,509,519,245,524,769
1000,466,502,471,237,465,702
1000,524,506,531,269,506,775
1000,517,504,472,269,453,722
1000,475,496,513,230,518,748
1000,483,522,534,270,490,760
1000,487,485,508,236,507,743
1000,507,505,510,262,495,757
1000,481,509,516,238,495,733
1000,522,490,505,262,497,759
1000,491,489,492,232,508,740
1000,511,519,515,262,498,760
1000,472,500,518,227,521,748
1000,511,480,532,246,519,765
1000,506,505,484,246,518,764
1000,510,488,499,252,512,764
1000,538,463,524,250,530,780
1000,523,510,501,263,503,766
1000,480,505,504,252,486,738
1000,501,500,496,249,504,753
1000,495,508,484,252,504,756
1000,502,491,514,259,489,748
1000,489,491,511,258,493,751
1000,535,481,491,240,536,776
1000,512,509,474,250,498,748
1000,504,528,466,263,460,723
1000,509,497,508,258,497,755
1000,500,508,526,263,493,756
1000,500,506,488,264,479,743
1000,476,501,506,238,511,749
1000,514,511,521,264,502,766
1000,511,514,503,259,501,760
1000,509,504,498,251,500,751
1000,491,503,493,253,485,738
1000,537,534,485,284,487,771
1000,499,504,477,249,479,728
1000,497,511,485,252,480,732
1000,505,473,489,246,498,744
1000,490,495,515,252,489,741
1000,474,513,514,249,491,740
1000,505,482,518,235,522,757
1000,506,500,506,259,493,752
1000,502,495,494,250,498,748
1000,496,477,526,230,524,754
1000,495,499,506,258,492,750
1000,504,495,503,254,508,762
1000,481,492,527,252,506,758
1000,482,488,511,244,496,740
1000,519,525,511,287,467,754
1000,507,492,500,252,507,759
1000,500,510,490,255,486,741
1000,490,503,506,255,495,750
1000,490,496,501,239,511,750
1000,483,518,520,254,494,748
1000,519,495,521,263,505,768
1000,475,506,506,227,516,743
1000,507,506,493,249,509,758
1000,513,483,521,242,531,773
1000,495,494,506,231,522,753
1000,502,490,505,254,492,746
1000,496,518,489,259,488,747
1000,506,493,490,257,485,742
1000,495,470,546,235,548,783
1000,509,506,493,249,517,766
1000,481,504,487,230,507,737
1000,491,500,510,247,509,756
1000,499,473,500,236,518,754
1000,490,503,485,242,491,733
1000,502,511,482,260,474,734
1000,483,504,505,244,484,728
1000,474,487,519,224,521,745
1000,515,516,503,260,499,759
1000,495,486,506,237,502,739
1000,487,488,505,238,510,748
1000,487,519,452,263,458,721
1000,485,477,500,229,503,732
1000,479,532,461,247,477,724
1000,474,541,503,270,466,736
1000,495,524,502,255,496,751
1000,515,512,497,264,495,759
1000,505,498,512,250,506,756
1000,541,509,509,273,510,783
1000,492,509,508,265,489,754
1000,483,495,491,234,518,752
1000,463,499,497,226,499,725
1000,508,491,487,256,478,734
1000,492,520,509,257,490,747
1000,521,504,511,263,510,773
1000,499,522,491,282,460,742
1000,492,501,485,240,506,746
1000,495,514,499,254,494,748
1000,459,490,508,234,496,730
1000,509,519,477,272,471,743
1000,508,515,465,257,495,752
1000,499,504,505,256,493,749
1000,518,555,502,293,482,775
1000,502,508,472,258,482,740
1000,501,462,475,240,482,722
1000,497,484,474,241,496,737
1000,484,504,489,254,475,729
1000,529,498,526,275,500,775
1000,526,512,520,275,496,771
1000,497,529,497,270,472,742
1000,527,512,455,280,453,733
1000,503,518,495,255,498,753
1000,527,502,498,259,502,761
1000,506,487,514,248,523,771
1000,485,494,527,240,514,754
1000,502,502,489,258,484,742
1000,524,505,491,263,494,757
1000,476,493,519,238,516,754
1000,504,478,497,244,499,743
1000,526,498,488,256,504,760
1000,510,506,511,255,501,756
1000,489,503,491,253,501,754
1000,504,484,519,247,509,756
1000,481,514,487,255,484,739
1000,515,493,498,260,503,763
1000,506,496,513,248,510,758
1000,519,491,473,247,504,751
1000,507,502,493,260,501,761
1000,503,506,495,262,484,746
1000,512,500,510,251,502,753
1000,518,499,481,253,500,753
1000,500,520,483,262,496,758
1000,522,497,517,259,510,769
1000,521,491,487,267,492,759
1000,492,503,492,247,501,748
1000,489,495,485,244,475,719
1000,486,481,490,242,509,751
1000,501,511,479,262,472,734
1000,494,486,500,245,511,756
1000,503,494,502,258,481,739
1000,465,526,506,236,506,742
1000,518,490,519,247,504,751
1000,482,456,514,228,509,737
1000,504,498,538,261,520,781
1000,518,500,495,264,509,773
1000,478,513,494,254,486,740
1000,480,469,502,231,516,747
1000,459,483,493,217,500,717
1000,500,497,497,241,507,748
1000,485,499,499,240,497,737
1000,468,499,496,237,495,732
1000,517,477,514,247,520,767
1000,499,498,503,252,499,751
1000,495,498,470,243,482,725
1000,501,501,496,261,484,745
1000,504,486,505,267,489,756
1000,506,497,518,255,499,754
1000,515,496,514,258,513,771
1000,504,507,485,255,509,764
1000,480,522,486,253,477,730
1000,507,522,506,268,479,747
1000,526,492,485,263,498,761
1000,504,492,515,244,511,755
1000,512,504,492,269,476,745
1000,504,540,522,272,492,764
1000,478,530,507,257,487,744
1000,513,474,502,252,503,755
1000,519,483,500,238,526,764
1000,500,508,474,250,466,716
1000,484,505,496,246,496,742
1000,485,486,495,250,500,750
1000,474,476,483,240,480,720
1000,514,493,502,244,529,773
1000,492,483,476,235,504,739
1000,517,489,521,254,522,776
1000,489,519,522,260,487,747
1000,510,480,483,240,500,740
1000,511,525,482,276,469,745
1000,492,490,517,242,509,751
1000,485,510,502,240,503,743
1000,508,494,511,263,485,748
1000,463,485,524,219,523,742
1000,502,540,499,273,474,747
1000,519,505,478,262,485,747
1000,499,521,522,249,508,757
1000,485,509,501,232,512,744
1000,531,492,485,253,517,770
1000,482,521,489,248,493,741
1000,505,515,506,263,494,757
1000,465,531,497,238,504,742
1000,501,519,520,272,496,768
1000,506,500,503,251,504,755
1000,492,493,512,256,503,759
1000,506,537,498,270,485,755
1000,507,507,507,262,483,745
1000,495,529,498,252,490,742
1000,488,496,493,247,486,733
1000,488,494,512,234,515,749
1000,503,513,524,251,519,770
1000,491,500,469,244,480,724
1000,508,497,503,256,499,755
1000,498,489,498,247,506,753
1000,522,513,494,263,504,767
1000,516,527,543,266,519,785
1000,478,509,503,240,498,738
1000,492,491,524,231,531,762
1000,510,505,511,263,506,769
1000,474,545,525,245,508,753
1000,514,500,517,257,502,759
1000,506,513,519,268,488,756
1000,473,520,509,235,504,739
1000,517,489,501,258,492,750
1000,500,493,492,256,498,754
1000,508,527,492,265,494,759
1000,495,500,489,236,508,744
1000,487,478,528,236,526,762
1000,473,512,499,232,491,723
1000,515,517,492,265,486,751
1000,505,518,493,261,500,761
1000,500,476,490,228,505,733
1000,500,505,491,256,483,739
1000,493,499,519,248,499,747
1000,520,495,480,250,486,736
1000,465,487,512,233,516,749
1000,499,507,492,258,490,748
1000,508,470,497,233,512,745
1000,518,497,506,258,502,760
1000,511,481,516,235,530,765
1000,512,482,519,259,501,760
1000,500,520,494,251,485,736
1000,521,489,510,237,541,778
1000,513,490,498,243,509,752
1000,475,521,504,259,479,738
1000,488,485,497,237,497,734
1000,492,516,496,266,481,747
1000,483,513,496,240,503,743
1000,502,514,498,267,475,742
1000,494,508,488,233,504,737
1000,517,509,483,267,486,753
1000,491,471,475,244,484,728
1000,522,506,508,259,510,769
1000,480,509,512,238,496,734
1000,526,511,501,264,498,762
1000,491,515,494,247,489,736
1000,503,500,499,264,491,755
1000,519,463,507,249,526,775
1000,488,525,479,258,485,743
1000,532,488,509,259,515,774
1000,487,518,495,259,480,739
1000,479,480,523,222,527,749
1000,499,504,501,254,494,748
1000,501,495,488,244,502,746
1000,493,513,470,241,499,740
1000,460,527,510,234,490,724
1000,508,508,486,266,477,743
1000,468,506,486,238,495,733
1000,496,511,499,245,514,759
1000,501,488,514,251,509,760
1000,501,497,489,247,515,762
1000,484,518,469,248,483,731
1000,477,514,484,241,487,728
1000,498,500,510,253,494,747
1000,489,488,517,238,510,748
1000,513,507,487,256,486,742
1000,528,517,488,271,502,773
1000,500,497,509,244,508,752
1000,529,490,516,258,524,782
1000,470,481,497,233,505,738
1000,500,489,492,236,511,747
1000,508,490,516,244,516,760
1000,503,517,478,247,496,743
1000,531,506,493,257,500,757
1000,501,501,517,242,515,757
1000,519,516,490,274,469,743
1000,511,498,510,252,501,753
1000,510,512,500,261,490,751
1000,511,487,475,251,510,761
1000,518,506,497,267,491,758
1000,518,508,493,268,486,754
1000,488,492,529,233,528,761
1000,521,538,485,280,467,747
1000,497,483,478,231,527,758
1000,527,532,502,269,495,764
1000,498,467,507,232,532,764
1000,526,502,512,261,491,752
1000,490,518,511,255,498,753
1000,505,498,506,255,508,763
1000,504,512,517,268,497,765
1000,520,497,461,263,474,737
1000,492,511,500,265,475,740
1000,496,506,485,251,486,737
1000,511,506,496,263,499,762
1000,510,482,518,247,520,767
1000,550,501,513,275,509,784
1000,517,482,484,249,519,768
1000,494,498,471,245,479,724
1000,488,495,480,247,476,723
1000,485,515,492,247,478,725
1000,497,489,507,235,531,766
1000,509,526,504,261,497,758
1000,509,490,495,250,499,749
1000,511,535,490,281,456,737
1000,464,515,496,235,497,732
1000,521,481,513,253,518,771
1000,535,508,509,278,499,777
1000,502,507,491,262,477,739
1000,536,529,511,283,508,791
1000,473,486,526,234,511,745
1000,468,533,499,254,482,736
1000,515,490,511,257,497,754
1000,490,505,498,250,481,731
1000,497,479,493,233,516,749
1000,502,522,504,267,485,752
1000,511,496,493,256,501,757
1000,495,474,469,228,497,725
1000,473,488,506,228,505,733
1000,475,471,511,221,524,745
1000,509,517,544,267,518,785
1000,486,496,493,243,496,739
1000,491,497,482,250,494,744
1000,504,491,481,248,488,736
1000,511,483,471,233,502,735
1000,519,493,529,251,520,771
1000,511,500,499,255,511,766
1000,497,520,496,258,478,736
1000,527,497,496,250,506,756
1000,479,504,523,245,505,750
1000,489,498,517,239,516,755
1000,496,473,485,241,501,742
1000,495,518,505,250,495,745
1000,449,527,493,234,492,726
1000,488,496,510,250,493,743
1000,490,507,533,250,513,763
1000,503,482,506,239,535,774
1000,477,485,483,242,482,724
1000,495,497,478,253,478,731
1000,492,483,509,240,513,753
1000,506,474,511,236,519,755
1000,487,546,523,265,481,746
1000,504,508,503,265,504,769
1000,498,495,472,250,486,736
1000,477,502,508,240,512,752
1000,486,483,494,229,504,733
1000,549,506,494,277,497,774
1000,495,480,490,239,505,744
1000,509,516,480,254,475,729
1000,511,517,487,276,468,744
1000,490,506,516,251,496,747
1000,512,490,506,241,515,756
1000,509,511,501,263,481,744
1000,472,480,478,231,468,699
1000,498,488,498,250,504,754
1000,511,498,498,271,488,759
1000,499,483,504,239,513,752
1000,500,487,487,247,496,743
1000,530,528,480,286,472,758
1000,495,518,480,256,482,738
1000,547,499,503,285,487,772
1000,492,503,495,238,496,734
1000,515,488,500,247,506,753
1000,513,512,481,266,476,742
1000,492,512,499,239,510,749
1000,506,512,474,263,471,734
1000,503,486,510,254,495,749
1000,480,489,513,234,503,737
1000,486,466,494,225,514,739
1000,493,492,496,259,479,738
1000,506,507,520,250,533,783
1000,496,503,501,244,512,756
1000,503,491,510,229,534,763
1000,501,509,518,255,499,754
1000,511,540,528,274,489,763
1000,483,496,476,251,485,736
1000,493,473,506,229,515,744
1000,512,497,500,260,498,758
1000,504,494,476,242,491,733
1000,499,508,489,241,500,741
1000,528,505,496,271,491,762
1000,500,489,492,251,488,739
1000,517,474,475,236,508,744
1000,528,501,505,272,486,758
1000,493,487,496,249,497,746
1000,529,520,493,267,500,767
1000,483,504,477,236,492,728
1000,468,464,497,223,513,736
1000,475,509,509,234,515,749
1000,473,510,473,246,480,726
1000,512,514,476,255,494,749
1000,498,532,465,275,470,745
1000,495,490,499,255,502,757
1000,529,518,514,285,481,766
1000,509,502,491,245,498,743
1000,511,492,496,244,502,746
1000,494,512,517,250,517,767
1000,499,505,500,252,500,752
1000,515,508,507,280,483,763
1000,496,504,498,248,493,741
1000,533,510,509,269,502,771
1000,480,474,493,230,500,730
1000,496,488,497,250,502,752
1000,495,500,507,265,484,749
1000,525,495,467,271,482,753
1000,510,525,476,265,499,764
1000,507,484,485,258,491,749
1000,508,472,530,242,532,774
1000,479,533,490,251,483,734
1000,489,476,506,226,525,751
1000,490,482,458,235,485,720
1000,493,510,501,257,500,757
1000,536,489,499,273,491,764
1000,508,501,500,248,500,748
1000,531,544,493,287,460,747
1000,497,491,528,259,500,759
1000,502,484,514,253,511,764
1000,496,524,506,275,487,762
1000,495,504,502,257,481,738
1000,518,523,500,271,483,754
1000,527,497,519,275,493,768
1000,494,489,494,235,540,775
1000,486,511,513,254,498,752
1000,484,498,490,247,479,726
1000,529,496,495,279,481,760
1000,503,512,476,257,483,740
1000,486,492,489,235,511,746
1000,515,516,486,267,481,748
1000,515,526,523,280,498,778
1000,513,502,500,275,485,760
1000,507,489,453,248,476,724
1000,472,469,487,213,510,723
1000,490,514,489,243,493,736
1000,502,473,507,243,508,751
1000,521,502,491,259,494,753
1000,478,513,498,250,503,753
1000,487,507,500,249,503,752
1000,497,497,491,238,512,750
1000,518,520,503,275,485,760
1000,499,507,488,259,480,739
1000,492,509,485,252,490,742
1000,495,504,476,245,489,734
1000,506,510,498,252,491,743
1000,470,530,506,255,471,726
1000,504,517,487,271,457,728
1000,508,515,494,254,489,743
1000,500,487,524,239,522,761
1000,499,500,497,243,502,745
1000,510,496,474,255,473,728
1000,508,483,476,248,499,747
1000,502,519,536,261,508,769
1000,495,459,495,233,513,746
1000,489,517,507,257,493,750
1000,492,477,480,234,514,748
1000,516,482,503,250,512,762
1000,490,498,489,255,481,736
1000,477,473,498,245,482,727
1000,513,512,499,255,491,746
1000,502,487,496,242,510,752
1000,539,499,516,243,527,770
1000,530,529,500,285,472,757
1000,487,498,514,245,506,751
1000,501,498,491,249,486,735
1000,486,481,524,248,496,744
1000,478,526,493,257,486,743
1000,496,484,507,250,506,756
1000,492,493,512,227,532,759
1000,516,496,501,263,479,742
1000,496,494,507,245,518,763
1000,501,490,499,238,517,755
1000,517,482,489,252,496,748
1000,495,517,477,261,472,733
1000,501,492,519,241,509,750
1000,503,504,482,255,481,736
1000,507,464,512,223,532,755
1000,476,504,521,226,517,743
1000,492,502,523,235,529,764
1000,485,517,489,247,493,740
1000,515,508,510,279,492,771
1000,513,491,498,252,513,765
1000,524,474,482,246,504,750
1000,510,492,467,247,478,725
1000,512,510,525,270,485,755
1000,513,508,485,267,493,760
1000,507,494,492,254,483,737
1000,511,482,469,240,503,743
1000,499,493,510,241,515,756
1000,507,483,505,239,527,766
1000,517,488,526,264,514,778
1000,489,482,500,224,509,733
1000,524,512,506,266,490,756
1000,503,492,495,247,507,754
1000,506,501,495,251,497,748
1000,516,501,486,257,492,749
1000,514,479,495,239,507,746
1000,471,486,514,237,515,752
1000,494,532,501,254,487,741
1000,504,502,487,246,493,739
1000,507,503,486,253,492,745
1000,500,486,480,243,486,729
1000,499,501,480,252,485,737
1000,516,484,505,250,526,776
1000,492,515,498,262,476,738
1000,513,491,522,262,510,772
1000,512,504,535,271,510,781
1000,493,478,487,232,506,738
1000,502,517,514,268,490,758
1000,483,512,493,244,491,735
1000,528,520,487,284,467,751
1000,501,480,484,235,511,746
1000,499,492,511,249,494,743
1000,505,525,500,269,481,750
1000,482,492,494,233,499,732
1000,500,494,491,253,485,738
1000,485,522,494,243,506,749
1000,486,504,512,227,524,751
1000,495,501,517,248,513,761
1000,482,510,511,243,504,747
1000,497,469,453,230,505,735
1000,521,520,489,265,509,774
1000,506,499,505,251,495,746
1000,507,488,494,244,500,744
1000,499,514,498,260,487,747
1000,498,520,474,246,495,741
1000,497,514,508,264,489,753
1000,523,500,506,264,494,758
1000,519,490,508,250,537,787
1000,537,494,476,276,487,763
1000,504,494,533,250,519,769
1000,498,533,515,273,479,752
1000,504,499,497,258,494,752
1000,532,473,530,244,550,794
1000,532,501,470,268,484,752
1000,495,458,509,227,528,755
1000,501,475,510,235,519,754
1000,491,518,488,255,481,736
1000,502,496,499,239,515,754
1000,498,489,484,228,515,743
1000,535,522,513,285,497,782
1000,506,480,482,237,498,735
1000,520,479,525,234,527,761
1000,501,524,498,265,486,751
1000,492,505,498,253,498,751
1000,491,518,474,250,478,728
1000,493,487,487,244,488,732
1000,520,509,535,271,496,767
1000,522,477,493,244,518,762
1000,509,493,479,234,513,747
1000,493,504,514,265,480,745
1000,506,489,489,248,501,749
1000,502,499,475,251,501,752
1000,492,454,507,229,531,760
1000,453,516,518,225,516,741
1000,488,526,492,263,462,725
1000,474,513,508,248,500,748
1000,505,520,492,249,499,748
1000,485,497,505,237,513,750
1000,490,495,506,239,512,751
1000,498,503,506,256,480,736
1000,492,495,507,225,527,752
1000,470,498,476,229,492,721
1000,510,489,495,258,493,751
1000,529,499,488,257,508,765
1000,484,497,482,233,491,724
1000,491,490,474,246,493,739
1000,491,491,514,243,499,742
1000,515,500,516,255,514,769
1000,506,477,501,249,514,763
1000,502,531,487,276,471,747
1000,514,495,507,249,506,755
1000,507,524,505,264,484,748
1000,507,525,480,266,466,732
1000,491,501,491,253,483,736
1000,503,498,504,246,507,753
1000,521,498,473,263,486,749
1000,485,472,486,225,503,728
1000,508,505,514,265,494,759
1000,483,536,486,261,485,746
1000,493,488,497,248,489,737
1000,499,497,503,246,519,765
1000,514,495,528,244,533,777
1000,505,461,503,233,522,755
1000,509,501,486,256,493,749
1000,491,514,520,249,516,765
1000,478,505,507,231,516,747
1000,504,483,475,233,509,742
1000,498,510,514,257,516,773
1000,496,479,467,262,464,726
1000,491,528,495,247,502,749
1000,506,519,510,270,486,756
1000,479,502,522,239,517,756
1000,493,508,494,252,498,750
1000,475,493,453,228,489,717
1000,496,509,505,242,505,747
1000,524,493,502,265,471,736
1000,485,509,524,242,516,758
1000,485,501,510,245,514,759
1000,509,525,497,267,503,770
1000,506,485,502,248,514,762
1000,527,462,512,253,520,773
1000,492,494,486,242,512,754
1000,498,501,494,242,513,755
1000,523,528,453,270,448,718
1000,482,525,502,249,495,744
1000,507,524,499,258,482,740
1000,502,502,493,276,471,747
1000,490,465,509,221,525,746
1000,503,497,492,246,516,762
1000,468,504,499,226,511,737
1000,510,505,517,255,516,771
1000,500,491,511,238,516,754
1000,487,506,512,253,501,754
1000,512,485,499,242,503,745
1000,488,492,507,233,514,747
1000,507,513,478,277,464,741
1000,535,488,487,261,497,758
1000,519,520,486,267,511,778
1000,512,503,520,260,504,764
1000,491,519,498,265,483,748
1000,501,518,486,246,490,736
1000,505,503,508,254,502,756
1000,500,505,501,253,498,751
1000,517,503,499,272,470,742
1000,535,484,533,263,529,792
1000,537,497,522,267,507,774
1000,512,504,525,265,510,775
1000,519,495,478,250,498,748
1000,499,492,510,238,518,756
1000,503,511,495,252,490,742
1000,512,510,517,268,499,767
1000,501,507,522,254,506,760
1000,501,493,490,249,494,743
1000,508,468,517,240,515,755
1000,503,492,515,234,529,763
1000,487,536,487,272,471,743
1000,498,527,492,264,475,739
1000,523,517,482,273,490,763
1000,515,507,504,263,505,768
1000,507,473,485,235,509,744
1000,498,517,504,261,490,751
1000,509,505,498,256,479,735
1000,499,504,472,241,490,731
1000,495,503,515,248,510,758
1000,502,518,485,252,487,739
1000,512,507,484,264,487,751
1000,486,490,510,232,513,745
1000,503,489,520,249,512,761
1000,535,501,498,270,483,753
1000,498,486,472,251,477,728
1000,480,479,514,237,503,740
1000,488,490,501,236,495,731
1000,512,496,500,251,495,746
1000,505,504,496,260,495,755
1000,498,444,512,225,533,758
1000,514,484,507,252,495,747
1000,497,522,499,241,514,755
1000,494,488,513,250,505,755
1000,511,487,490,255,491,746
1000,484,465,491,225,519,744
1000,496,476,502,223,527,750
1000,484,495,501,228,516,744
1000,506,511,513,257,506,763
1000,501,520,500,267,486,753
1000,515,474,543,231,549,780
1000,512,495,514,254,502,756
1000,488,500,509,225,516,741
1000,503,490,520,238,509,747
1000,495,493,547,248,526,774
1000,498,518,537,265,505,770
1000,509,500,505,275,480,755
1000,510,483,496,231,524,755
1000,509,526,531,256,531,787
1000,512,514,506,259,477,736
1000,491,485,502,226,510,736
1000,539,473,522,244,537,781
1000,500,485,486,232,513,745
1000,510,506,497,258,493,751
1000,491,477,525,228,516,744
1000,503,510,519,256,512,768
1000,495,485,483,232,505,737
1000,515,504,476,271,476,747
1000,504,485,490,245,493,738
1000,515,494,500,245,520,765
1000,502,475,506,246,519,765
1000,483,517,509,247,492,739
1000,482,487,528,247,509,756
1000,488,505,516,259,496,755
1000,497,487,506,244,498,742
1000,502,501,506,252,504,756
1000,492,499,477,236,514,750
1000,493,477,475,251,482,733
1000,512,505,486,261,489,750
1000,500,504,499,236,510,746
1000,498,517,514,262,479,741
1000,483,478,475,231,500,731
1000,477,516,499,246,489,735
1000,514,484,508,246,503,749
1000,499,501,504,247,513,760
1000,517,520,497,260,499,759
1000,494,475,498,230,516,746
1000,481,482,473,236,501,737
1000,499,490,511,244,512,756
1000,501,495,497,261,492,753
1000,536,485,517,255,512,767
1000,498,517,493,251,499,750
1000,485,520,506,255,474,729
1000,510,518,496,262,490,752
1000,484,513,502,236,499,735
1000,508,497,487,258,484,742
1000,487,467,495,218,532,750
1000,497,525,466,250,485,735
1000,481,484,499,226,523,749
1000,503,526,497,279,479,758
1000,512,513,482,267,471,738
1000,496,483,504,237,528,765
1000,484,476,525,215,533,748
1000,521,493,484,255,498,753
1000,488,497,518,244,511,755
1000,508,487,514,243,516,759
1000,504,503,495,252,493,745
1000,514,488,501,251,513,764
1000,494,480,507,250,495,745
1000,529,493,502,266,490,756
1000,523,474,518,247,520,767
1000,489,492,485,238,502,740
1000,486,514,484,245,480,725
1000,508,511,518,266,494,760
1000,495,513,515,243,513,756
1000,494,510,531,252,510,762
1000,494,512,499,265,471,736
1000,517,508,490,265,490,755
1000,515,504,524,243,526,769
1000,496,495,543,245,534,779
1000,512,490,489,265,496,761
1000,482,507,470,247,486,733
1000,504,489,521,260,500,760
1000,498,513,513,261,490,751
1000,486,486,523,242,509,751
1000,501,480,482,243,500,743
1000,513,475,466,249,494,743
1000,496,481,485,216,529,745
1000,510,514,524,266,508,774
1000,486,477,482,225,514,739
1000,471,488,504,231,516,747
1000,495,483,526,247,515,762
1000,485,464,497,218,519,737
1000,480,523,480,264,471,735
1000,489,488,499,241,506,747
1000,493,513,533,255,511,766
1000,492,498,501,240,503,743
1000,495,492,489,245,504,749
1000,521,479,494,258,491,749
1000,489,499,473,231,501,732
1000,505,491,487,247,489,736
1000,509,508,507,254,525,779
1000,501,513,509,253,501,754
1000,501,481,513,245,516,761
1000,497,513,481,244,502,746
1000,516,529,505,275,479,754
1000,480,510,504,243,498,741
1000,514,509,520,259,504,763
1000,531,499,496,264,478,742
1000,510,515,488,260,499,759
1000,470,490,520,246,489,735
1000,490,498,515,256,502,758
1000,485,517,515,245,501,746
1000,498,490,510,250,507,757
1000,483,517,497,249,487,736
1000,504,496,506,253,495,748
1000,493,463,516,246,503,749
1000,493,492,485,247,511,758
1000,499,497,524,232,539,771
1000,524,521,503,272,494,766
1000,522,502,528,256,513,769
1000,508,500,522,249,512,761
1000,494,500,497,248,494,742
1000,488,501,497,243,492,735
1000,497,509,493,253,498,751
1000,509,469,501,232,508,740
1000,504,507,517,247,500,747
1000,489,494,514,254,499,753
1000,478,502,498,240,495,735
1000,498,496,512,261,481,742
1000,499,502,508,249,512,761
1000,510,512,511,273,491,764
1000,500,515,501,256,509,765
1000,516,465,482,239,504,743
1000,523,484,475,260,489,749
1000,493,504,489,242,500,742
1000,504,498,504,239,502,741
1000,508,494,529,247,536,783
1000,494,499,504,258,493,751
1000,483,504,484,247,478,725
1000,511,516,481,258,475,733
1000,482,492,506,250,497,747
1000,498,487,480,230,523,753
1000,480,500,488,236,510,746
1000,506,508,500,256,507,763
1000,504,490,493,254,510,764
1000,487,495,498,241,499,740
1000,504,475,505,245,524,769
1000,508,512,515,249,511,760
1000,505,535,493,276,465,741
1000,502,468,502,238,514,752
1000,498,510,523,260,510,770
1000,498,455,523,219,544,763
1000,491,505,494,242,488,730
1000,526,494,542,261,523,784
1000,487,503,524,246,517,763
1000,530,520,485,270,493,763
1000,505,508,495,245,499,744
1000,509,491,495,252,496,748
1000,510,476,503,232,519,751
1000,507,508,499,261,478,739
1000,523,501,513,251,524,775
1000,502,482,499,231,522,753
1000,515,519,524,277,488,765
1000,490,507,465,251,463,714
1000,497,517,490,254,480,734
1000,516,506,490,258,494,752
1000,495,503,528,237,516,753
1000,490,478,492,220,512,732
1000,500,498,505,251,498,749
1000,476,493,491,228,514,742
1000,512,507,506,261,493,754
1000,491,509,496,250,486,736
1000,467,498,507,230,504,734
1000,507,500,508,254,514,768
1000,505,490,491,253,518,771
1000,505,514,521,269,497,766
1000,514,471,510,248,503,751
1000,500,479,504,232,532,764
1000,496,505,497,247,501,748
1000,502,467,496,249,499,748
1000,506,512,492,249,514,763
1000,502,485,510,246,499,745
1000,492,480,465,229,508,737
1000,515,507,479,257,490,747
1000,511,529,495,271,479,750
1000,504,478,511,256,488,744
1000,482,488,498,231,505,736
1000,503,496,516,255,502,757
1000,497,505,506,253,505,758
1000,502,490,519,253,502,755
1000,501,528,496,277,483,760
1000,501,513,505,255,489,744
1000,470,520,512,257,481,738
1000,520,516,501,267,498,765
1000,516,533,523,282,487,769
1000,483,498,497,241,500,741
1000,504,515,524,247,514,761
1000,512,506,497,260,487,747
1000,508,522,497,263,478,741
1000,530,512,509,264,501,765
1000,481,488,524,226,532,758
1000,497,497,498,254,491,745
1000,491,476,515,239,519,758
1000,529,510,519,266,501,767
1000,506,526,490,280,463,743
1000,474,488,507,219,520,739
1000,482,514,498,244,487,731
1000,493,479,515,246,501,747
1000,505,504,499,258,493,751
1000,515,488,512,243,523,766
1000,517,480,461,258,484,742
1000,477,508,494,252,479,731
1000,483,501,487,254,478,732
1000,527,493,506,264,487,751
1000,504,493,503,246,510,756
1000,506,488,485,252,500,752
1000,466,492,476,248,469,717
1000,502,510,518,259,502,761
1000,512,479,504,253,497,750
1000,503,502,512,252,505,757
1000,490,497,503,239,517,756
1000,507,527,494,280,462,742
1000,483,508,526,239,521,760
1000,476,513,503,254,476,730
1000,515,508,515,260,512,772
1000,508,518,496,265,497,762
1000,515,466,515,248,524,772
1000,497,511,537,271,494,765
1000,506,491,465,257,490,747
1000,481,509,515,242,503,745
1000,509,500,501,240,521,761
1000,511,487,503,262,485,747
1000,483,537,472,254,470,724
1000,510,503,513,242,529,771
1000,501,520,503,261,488,749
1000,481,494,506,233,514,747
1000,499,465,512,237,516,753
1000,503,493,504,270,480,750
1000,511,507,487,256,510,766
1000,476,504,498,235,486,721
1000,480,505,505,246,489,735
1000,516,475,493,243,505,748
1000,526,489,483,270,481,751
1000,488,499,494,250,507,757
1000,489,483,485,231,506,737
1000,474,510,516,246,485,731
1000,476,503,501,228,524,752
1000,494,507,514,251,501,752
1000,486,499,494,229,521,750
1000,468,485,493,229,518,747
1000,512,496,487,253,492,745
1000,513,476,509,254,498,752
1000,475,506,485,232,497,729
1000,504,506,493,254,494,748
1000,477,506,486,234,494,728
1000,518,503,502,262,501,763
1000,499,532,501,263,479,742
1000,494,466,490,217,545,762
1000,520,493,498,267,488,755
1000,490,465,486,228,503,731
1000,472,469,510,217,526,743
1000,488,474,484,230,496,726
1000,500,495,509,236,504,740
1000,496,509,505,244,514,758
1000,508,519,519,266,486,752
1000,522,484,512,265,497,762
1000,506,467,495,238,514,752
1000,503,469,514,246,529,775
1000,498,497,506,241,513,754
1000,489,495,490,254,490,744
1000,496,485,498,217,520,737
1000,515,505,502,264,500,764
1000,486,499,488,245,502,747
1000,504,504,497,261,501,762
1000,510,506,492,259,494,753
1000,489,500,499,246,492,738
1000,480,513,518,249,497,746
1000,510,485,503,253,506,759
1000,526,499,493,258,505,763
1000,486,492,475,241,490,731
1000,490,511,532,240,533,773
1000,502,506,500,258,487,745
1000,498,528,516,272,498,770
1000,498,484,461,252,452,704
1000,500,484,506,241,503,744
1000,491,496,484,234,510,744
1000,484,508,528,235,511,746
1000,506,510,487,242,509,751
1000,525,512,494,273,496,769
1000,503,511,496,253,507,760
1000,512,523,483,254,494,748
1000,500,496,529,242,519,761
1000,496,488,499,233,530,763
1000,491,471,498,232,501,733
1000,499,513,519,256,507,763
1000,513,490,527,231,548,779
1000,506,524,506,270,476,746
1000,500,509,505,256,486,742
1000,498,463,494,234,497,731
1000,488,480,504,244,506,750
1000,510,490,507,247,513,760
1000,513,525,518,269,490,759
1000,497,491,490,262,496,758
1000,500,498,508,250,503,753
1000,488,502,474,241,482,723
1000,503,486,495,246,518,764
1000,510,505,484,262,482,744
1000,505,521,501,272,489,761
1000,506,502,493,251,497,748
1000,500,492,497,231,522,753
1000,501,512,508,261,504,765
1000,513,503,490,253,492,745
1000,494,488,486,248,491,739
1000,491,538,494,261,498,759
1000,516,515,533,268,509,777
1000,504,463,500,229,518,747
1000,498,509,494,244,504,748
1000,489,486,502,233,505,738
1000,513,483,518,248,510,758
1000,490,492,490,248,509,757
1000,506,504,490,252,512,764
1000,488,505,512,248,495,743
1000,474,503,496,249,478,727
1000,523,504,499,266,494,760
1000,483,505,508,237,508,745
1000,522,485,498,260,498,758
1000,525,522,484,273,471,744
1000,487,513,500,244,489,733
1000,522,526,491,270,484,754
1000,515,515,504,253,498,751
1000,497,513,509,259,502,761
1000,480,491,472,232,478,710
1000,489,463,503,226,517,743
1000,499,472,511,239,528,767
1000,500,510,491,242,506,748
1000,515,481,473,241,499,740
1000,517,484,495,255,491,746
1000,503,490,490,246,509,755
1000,488,515,504,256,480,736
1000,532,495,524,265,513,778
1000,492,514,512,260,505,765
1000,489,502,516,239,516,755
1000,526,495,504,264,507,771
1000,498,534,490,269,484,753
1000,511,479,508,234,515,749
1000,497,520,488,275,455,730
1000,498,525,524,263,498,761
1000,495,522,507,248,505,753
1000,509,524,502,267,496,763
1000,490,488,495,242,500,742
1000,533,484,509,256,525,781
1000,491,474,510,230,523,753
1000,510,502,521,252,510,762
1000,481,502,493,245,503,748
1000,487,540,496,269,486,755
1000,508,496,505,254,512,766
1000,486,492,496,258,487,745
1000,523,500,478,266,488,754
1000,492,505,495,249,498,747
1000,501,493,492,250,511,761
1000,514,490,484,245,496,741
1000,506,492,509,261,491,752
1000,482,514,502,246,500,746
1000,493,487,492,238,503,741
1000,507,499,488,253,489,742
1000,514,535,523,282,482,764
1000,490,507,485,259,487,746
1000,511,509,488,258,475,733
1000,502,508,471,247,493,740
1000,513,500,462,258,491,749
1000,483,479,507,233,514,747
1000,521,492,509,262,485,747
1000,495,480,490,249,504,753
1000,518,501,508,250,532,782
1000,496,505,483,244,496,740
1000,502,497,509,251,504,755
1000,465,486,483,228,488,716
1000,518,525,479,264,482,746
1000,489,481,502,249,488,737
1000,505,518,509,260,499,759
1000,500,508,516,252,508,760
1000,479,502,480,242,478,720
1000,504,516,498,267,497,764
1000,484,525,486,262,486,748
1000,473,498,502,241,506,747
1000,475,494,498,241,512,753
1000,495,444,495,222,516,738
1000,503,495,510,253,505,758
1000,496,501,497,254,493,747
1000,524,507,502,263,494,757
1000,525,486,496,260,494,754
1000,524,520,479,278,466,744
1000,482,510,498,230,502,732
1000,519,508,505,266,493,759
1000,496,497,482,243,491,734
1000,473,505,516,233,498,731
1000,528,515,478,262,474,736
1000,466,476,489,224,506,730
1000,493,500,473,231,504,735
1000,507,513,488,270,492,762
1000,504,494,515,244,521,765
1000,479,541,507,244,489,733
1000,488,493,496,239,500,739
1000,503,502,507,268,473,741
1000,499,493,491,268,478,746
1000,507,494,507,249,522,771
1000,488,499,489,246,501,747
1000,505,484,496,239,514,753
1000,501,496,524,248,517,765
1000,518,516,503,267,490,757
1000,509,506,531,260,501,761
1000,470,515,467,246,482,728
1000,498,541,492,272,479,751
1000,507,500,478,251,487,738
1000,502,496,497,245,511,756
1000,518,510,505,270,487,757
1000,523,501,542,262,532,794
1000,493,511,516,253,483,736
1000,486,497,521,233,529,762
1000,504,470,516,241,524,765
1000,505,512,493,253,499,752
1000,492,524,497,264,485,749
1000,514,489,481,264,486,750
1000,509,485,512,242,511,753
1000,495,501,479,249,486,735
1000,526,525,523,268,511,779
1000,496,488,497,247,499,746
1000,505,478,501,250,506,756
1000,469,489,484,214,522,736
1000,505,511,506,260,506,766
1000,495,497,490,255,485,740
1000,511,491,494,258,508,766
1000,519,497,521,246,523,769
1000,496,492,486,246,496,742
1000,506,490,505,241,520,761
1000,516,497,511,247,517,764
1000,477,500,510,235,503,738
1000,467,496,502,226,508,734
1000,520,485,515,271,490,761
1000,482,495,524,237,516,753
1000,527,510,506,272,487,759
1000,478,481,494,222,515,737
1000,516,504,497,265,485,750
1000,499,514,491,259,484,743
1000,511,517,490,261,485,746
1000,501,499,471,246,485,731
1000,524,522,492,273,481,754
1000,466,500,479,223,495,718
1000,482,469,512,234,537,771
1000,492,480,520,244,503,747
1000,484,504,491,242,493,735
1000,513,492,499,254,505,759
1000,502,514,490,241,502,743
1000,529,510,498,276,487,763
1000,482,507,473,236,495,731
1000,529,483,520,259,509,768
1000,506,490,487,258,473,731
1000,497,496,506,240,511,751
1000,496,506,505,258,492,750
1000,489,519,492,267,473,740
1000,494,519,508,246,510,756
1000,484,494,485,233,500,733
1000,500,471,505,244,519,763
1000,510,487,500,257,501,758
1000,533,503,506,267,504,771
1000,532,495,490,257,509,766
1000,517,515,522,263,499,762
1000,463,500,520,232,505,737
1000,505,482,482,243,489,732
1000,510,499,491,247,505,752
1000,536,494,495,264,501,765
1000,499,478,521,244,517,761
1000,481,523,519,254,501,755
1000,509,505,504,279,480,759
1000,510,501,499,256,503,759
1000,497,495,484,245,496,741
1000,507,508,518,262,481,743
1000,499,472,494,236,527,763
1000,484,515,475,248,472,720
1000,481,505,520,239,506,745
1000,498,489,506,236,512,748
1000,531,521,493,267,499,766
1000,483,513,476,241,500,741
1000,512,487,510,254,514,768
1000,512,524,509,275,475,750
1000,541,508,499,279,495,774
1000,475,489,511,234,509,743
1000,481,525,511,243,511,754
1000,514,530,480,279,469,748
1000,491,481,523,255,499,754
1000,486,502,488,243,489,732
1000,514,514,485,267,482,749
1000,487,507,483,236,503,739
1000,526,519,494,259,506,765
1000,497,503,497,234,505,739
1000,495,514,492,261,477,738
1000,512,456,502,233,525,758
1000,503,512,491,260,485,745
1000,506,482,510,238,511,749
1000,495,504,483,236,501,737
1000,492,514,524,264,500,764
1000,488,515,515,263,490,753
1000,492,495,514,252,499,751
1000,500,495,523,259,498,757
1000,480,477,470,241,490,731
1000,521,503,501,275,487,762
1000,497,518,496,263,491,754
1000,480,480,514,236,504,740
1000,515,493,495,265,498,763
1000,527,507,504,281,486,767
1000,520,493,518,267,492,759
1000,481,492,513,247,488,735
1000,488,522,517,248,511,759
1000,509,473,480,252,497,749
1000,488,515,513,250,510,760
1000,507,491,499,251,495,746
1000,528,490,519,280,489,769
1000,511,492,504,249,519,768
1000,457,497,513,232,500,732
1000,496,499,513,254,502,756
1000,513,520,542,282,486,768
1000,494,482,537,252,522,774
1000,482,476,487,232,520,752
1000,505,492,522,234,524,758
1000,516,506,501,261,497,758
1000,500,506,479,271,486,757
1000,501,500,509,251,497,748
1000,475,518,488,249,472,721
1000,496,498,497,243,509,752
1000,499,498,511,252,490,742
1000,517,514,484,266,484,750
1000,525,486,496,254,518,772
1000,502,483,504,240,503,743
1000,497,498,529,244,517,761
1000,502,515,507,253,501,754
1000,493,505,491,250,501,751
1000,505,491,487,249,502,751
1000,507,512,484,245,511,756
1000,519,496,525,259,505,764
1000,504,491,498,253,504,757
1000,512,502,502,262,498,760
1000,486,520,483,239,483,722
1000,499,508,485,250,506,756
1000,503,495,485,250,489,739
1000,513,501,514,272,492,764
1000,491,500,491,239,511,750
1000,496,491,489,245,501,746
1000,509,479,487,240,510,750
1000,520,492,490,260,484,744
1000,485,506,481,244,477,721
1000,477,486,491,242,486,728
1000,496,497,494,246,511,757
1000,498,484,490,255,488,743
1000,492,502,497,253,502,755
1000,510,511,514,264,504,768
1000,504,517,491,254,507,761
1000,543,523,518,278,505,783
1000,482,494,511,239,520,759
1000,511,493,515,257,509,766
1000,490,483,498,243,491,734
1000,513,493,495,252,497,749
1000,493,456,488,226,499,725
1000,516,499,486,254,491,745
1000,493,521,477,256,477,733
1000,501,509,492,262,482,744
1000,480,493,479,244,488,732
1000,526,496,504,263,487,750
1000,487,504,484,237,493,730
1000,464,490,507,231,512,743
1000,502,490,502,245,497,742
1000,478,482,507,241,500,741
1000,492,493,507,242,511,753
1000,487,476,456,229,487,716
1000,478,529,525,247,503,750
1000,512,501,489,269,485,754
1000,527,518,527,276,498,774
1000,487,498,491,237,500,737
1000,495,507,513,233,530,763
1000,501,517,499,252,483,735
1000,512,476,507,246,516,762
1000,498,481,508,234,517,751
1000,494,512,490,248,503,751
1000,520,507,502,261,507,768
1000,507,505,484,261,486,747
1000,503,484,503,244,514,758
1000,489,484,508,240,497,737
1000,494,463,488,215,518,733
1000,511,498,507,260,488,748
1000,518,510,492,256,504,760
1000,501,501,492,257,495,752
1000,517,496,496,257,501,758
1000,486,518,509,242,502,744
1000,515,502,476,283,463,746
1000,491,496,488,233,523,756
1000,507,505,505,260,495,755
1000,507,516,477,268,474,742
1000,505,493,513,257,503,760
1000,519,503,529,259,500,759
1000,480,513,538,258,508,766
1000,529,498,495,268,491,759
1000,481,515,509,245,492,737
1000,495,514,505,258,499,757
1000,504,507,519,251,525,776
1000,513,530,513,277,486,763
1000,509,485,495,256,491,747
1000,488,500,497,244,497,741
1000,479,473,496,229,510,739
1000,494,505,504,243,509,752
1000,528,481,505,250,524,774
1000,500,467,537,228,545,773
1000,515,481,504,238,523,761
1000,505,488,507,259,496,755
1000,498,525,486,264,485,749
1000,509,495,520,250,519,769
1000,498,502,506,262,484,746
1000,479,496,502,233,505,738
1000,501,493,517,254,518,772
1000,507,511,478,250,495,745
1000,492,507,493,248,493,741
1000,482,507,505,248,493,741
1000,489,501,491,246,490,736
1000,493,516,487,241,493,734
1000,497,458,509,227,528,755
1000,504,483,509,248,510,758
1000,494,505,487,251,493,744
1000,490,503,509,244,507,751
1000,502,500,499,246,502,748
1000,519,505,503,268,498,766
1000,517,473,499,259,495,754
1000,498,515,497,245,495,740
1000,499,510,493,260,482,742
1000,511,500,518,244,513,757
1000,484,510,503,244,501,745
1000,498,498,478,258,484,742
1000,461,513,521,237,515,752
1000,531,512,514,267,501,768
1000,493,510,493,252,498,750
1000,481,495,498,238,520,758
1000,492,515,496,258,493,751
1000,496,498,505,239,505,744
1000,500,503,498,242,500,742
1000,485,488,509,253,493,746
1000,494,494,501,242,520,762
1000,521,494,517,279,491,770
1000,493,509,449,255,466,721
1000,512,478,499,235,526,761
1000,494,525,526,270,494,764
1000,526,500,498,268,507,775
1000,525,501,488,262,479,741
1000,505,490,513,248,527,775
1000,492,496,475,243,494,737
1000,490,488,518,244,503,747
1000,514,497,486,254,507,761
1000,512,523,518,282,469,751
1000,478,489,510,218,526,744
1000,497,492,517,246,519,765
1000,507,501,509,249,499,748
1000,481,507,519,248,487,735
1000,493,506,501,255,484,739
1000,516,479,508,243,526,769
1000,479,496,505,243,491,734
1000,491,468,492,244,504,748
1000,494,496,507,255,501,756
1000,503,485,499,251,504,755
1000,507,498,502,244,514,758
1000,479,504,504,233,490,723
1000,496,515,474,256,475,731
1000,507,484,507,235,524,759
1000,535,484,468,263,483,746
1000,506,459,514,233,511,744
1000,516,517,492,242,515,757
1000,519,532,477,270,480,750
1000,482,477,500,239,509,748
1000,516,499,483,256,500,756
1000,505,475,512,238,513,751
1000,499,481,493,244,485,729
1000,508,480,507,245,500,745
1000,505,498,500,252,501,753
1000,516,509,511,256,508,764
1000,498,481,510,250,502,752
1000,511,485,487,257,499,756
1000,541,489,492,259,500,759
1000,481,478,479,211,520,731
1000,505,492,479,248,497,745
1000,482,491,507,238,509,747
1000,515,535,492,272,481,753
1000,501,492,508,248,515,763
1000,544,470,498,261,528,789
1000,518,506,529,280,500,780
1000,508,510,480,266,488,754
1000,499,509,495,243,493,736
1000,481,504,478,221,508,729
1000,481,501,503,237,506,743
1000,501,479,507,227,530,757
1000,493,491,476,243,494,737
1000,518,494,488,257,495,752
1000,510,484,499,250,503,753
1000,531,524,474,277,485,762
1000,555,483,529,271,522,793
1000,511,499,472,258,490,748
1000,475,497,512,229,522,751
1000,525,499,478,263,494,757
1000,508,506,534,255,537,792
1000,506,483,490,244,516,760
1000,470,507,491,245,483,728
1000,497,493,474,259,486,745
1000,504,491,500,244,508,752
1000,536,477,517,238,528,766
1000,536,499,488,258,491,749
1000,527,513,520,267,508,775
1000,525,473,490,258,508,766
1000,531,507,482,275,486,761
1000,522,492,496,256,523,779
1000,500,524,514,273,470,743
1000,524,492,477,249,493,742
1000,499,521,521,262,491,753
1000,468,531,530,253,505,758
1000,477,514,506,253,498,751
1000,520,493,528,266,505,771
1000,499,529,512,266,499,765
1000,516,494,472,264,464,728
1000,505,495,505,249,512,761
1000,501,491,504,257,507,764
1000,483,495,517,231,541,772
1000,481,471,518,219,531,750
1000,497,529,521,255,503,758
1000,505,506,522,261,502,763
1000,489,502,504,260,488,748
1000,503,532,493,275,477,752
1000,485,479,479,221,520,741
1000,510,537,488,266,498,764
1000,502,507,502,260,492,752
1000,501,504,503,252,495,747
1000,528,480,483,265,487,752
1000,509,502,496,253,492,745
1000,512,504,513,268,482,750
1000,501,484,499,241,503,744
1000,487,492,497,234,507,741
1000,494,502,499,249,494,743
1000,483,490,483,237,492,729
1000,480,498,503,236,519,755
1000,489,503,481,233,502,735
1000,501,483,528,250,505,755
1000,492,494,512,256,506,762
1000,504,444,511,221,537,758
1000,491,503,510,234,516,750
1000,484,481,534,243,518,761
1000,500,485,534,241,537,778
1000,499,510,482,244,487,731
1000,495,508,507,249,491,740
1000,523,511,525,265,520,785
1000,517,513,518,256,523,779
1000,453,498,507,228,498,726
1000,497,489,514,232,530,762
1000,516,501,487,251,489,740
1000,538,486,511,261,515,776
1000,492,518,501,249,484,733
1000,483,499,526,241,526,767
1000,492,485,509,245,504,749
1000,524,513,470,262,479,741
1000,474,509,494,245,483,728
1000,515,526,501,269,493,762
1000,494,511,507,247,511,758
1000,514,500,475,254,503,757
1000,529,443,516,244,521,765
1000,517,506,508,276,492,768
1000,481,470,504,232,508,740
1000,484,496,504,251,488,739
1000,509,518,465,253,488,741
1000,484,494,518,248,496,744
1000,506,496,500,257,504,761
1000,488,497,499,236,501,737
1000,509,488,496,256,495,751
1000,494,499,518,246,508,754
1000,502,515,504,257,492,749
1000,517,502,508,256,514,770
1000,512,499,517,249,524,773
1000,522,482,463,252,498,750
1000,493,496,509,249,513,762
1000,503,501,517,259,506,765
1000,491,489,482,236,495,731
1000,492,511,533,262,498,760
1000,469,526,486,258,476,734
1000,498,470,530,228,532,760
1000,484,518,492,245,494,739
1000,488,516,500,240,494,734
1000,485,480,488,232,517,749
1000,511,497,505,252,513,765
1000,489,492,483,238,503,741
1000,508,457,485,244,505,749
1000,507,527,540,257,517,774
1000,519,500,512,253,513,766
1000,483,512,523,254,491,745
1000,483,494,513,242,499,741
1000,508,525,495,269,471,740
1000,507,513,503,263,494,757
1000,519,487,503,255,507,762
1000,512,481,494,248,507,755
1000,508,479,492,231,519,750
1000,501,521,506,264,489,753
1000,459,492,514,242,482,724
1000,500,514,513,258,485,743
1000,503,519,511,262,496,758
1000,488,481,494,240,494,734
1000,484,475,497,213,524,737
1000,520,516,508,269,496,765
1000,488,482,500,244,499,743
1000,480,505,511,250,492,742
1000,490,503,494,244,513,757
1000,528,498,483,259,508,767
1000,515,507,487,252,503,755
1000,511,476,501,247,519,766
1000,501,499,499,259,483,742
1000,467,474,498,226,501,727
1000,510,506,485,265,484,749
1000,520,506,497,273,485,758
1000,511,514,492,256,500,756
1000,510,497,507,255,516,771
1000,468,498,476,236,493,729
1000,483,492,481,248,486,734
1000,489,488,491,241,503,744
1000,506,537,494,266,493,759
1000,511,503,510,270,487,757
1000,493,512,488,266,475,741
1000,502,474,494,248,493,741
1000,525,498,499,262,495,757
1000,487,528,502,257,497,754
1000,492,490,476,240,499,739
1000,519,500,514,252,515,767
1000,521,493,483,257,511,768
1000,516,483,535,245,542,787
1000,507,485,493,236,516,752
1000,496,492,504,243,509,752
1000,502,497,502,263,497,760
1000,488,496,511,244,507,751
1000,529,490,493,255,522,777
1000,502,498,508,253,497,750
1000,520,476,508,252,502,754
1000,492,520,506,258,495,753
1000,502,494,499,243,504,747
1000,529,508,481,269,493,762
1000,491,487,509,230,519,749
1000,499,544,468,274,471,745
1000,500,497,495,255,490,745
1000,514,481,475,254,492,746
1000,515,496,515,261,507,768
1000,488,524,491,251,479,730
1000,481,483,487,227,515,742
1000,509,512,486,262,487,749
1000,496,510,489,244,500,744
1000,521,486,488,256,502,758
1000,486,498,495,241,489,730
1000,496,510,498,251,498,749
1000,490,507,518,250,501,751
1000,487,471,518,240,504,744
1000,472,517,508,262,476,738
1000,488,512,486,254,495,749
1000,481,498,523,245,496,741
1000,484,498,505,242,499,741
1000,496,494,493,242,501,743
1000,474,509,497,251,475,726
1000,496,489,518,248,502,750
1000,501,491,513,246,511,757
1000,535,512,470,262,491,753
1000,503,509,484,244,492,736
1000,496,495,470,244,496,740
1000,488,505,513,238,520,758
1000,490,505,509,229,524,753
1000,483,498,514,255,501,756
1000,495,510,507,253,516,769
1000,508,497,523,266,496,762
1000,520,530,489,276,489,765
1000,512,522,488,267,471,738
1000,494,510,483,239,498,737
1000,507,520,498,253,489,742
1000,508,531,490,253,508,761
1000,463,489,522,240,514,754
1000,511,517,468,257,488,745
1000,525,506,499,263,502,765
1000,534,507,511,281,507,788
1000,501,541,505,270,476,746
1000,495,498,493,236,519,755
1000,488,511,499,249,480,729
1000,491,491,491,235,513,748
1000,486,491,496,248,492,740
1000,488,494,525,249,517,766
1000,491,488,504,249,498,747
1000,499,501,502,236,505,741
1000,484,485,516,236,499,735
1000,486,502,500,247,484,731
1000,502,517,491,260,490,750
1000,512,507,501,259,493,752
1000,514,521,500,265,480,745
1000,477,515,518,244,503,747
1000,514,494,493,258,504,762
1000,471,485,499,221,520,741
1000,497,485,503,257,499,756
1000,499,497,485,252,496,748
1000,467,484,523,223,535,758
1000,500,522,486,257,477,734
1000,487,485,485,248,504,752
1000,495,497,475,236,509,745
1000,535,498,478,270,491,761
1000,489,508,490,239,491,730
1000,532,486,526,252,526,778
1000,476,493,507,222,516,738
1000,514,499,493,267,475,742
1000,538,496,496,264,504,768
1000,499,508,508,274,480,754
1000,534,494,508,257,511,768
1000,469,515,482,249,474,723
1000,467,493,489,221,509,730
1000,508,473,490,248,505,753
1000,516,492,513,243,528,771
1000,511,517,506,269,485,754
1000,480,512,521,247,508,755
1000,516,519,492,266,481,747
1000,489,491,487,233,501,734
1000,490,545,494,255,482,737
1000,495,499,521,241,512,753
1000,489,501,503,257,493,750
1000,501,520,491,259,479,738
1000,490,498,490,256,488,744
1000,490,548,509,258,506,764
1000,499,492,487,248,487,735
1000,517,514,499,282,476,758
1000,529,507,500,273,504,777
1000,491,503,485,243,492,735
1000,502,492,437,247,477,724
1000,498,504,471,256,473,729
1000,503,531,516,288,479,767
1000,510,507,475,261,478,739
1000,497,505,500,242,504,746
1000,475,500,502,236,502,738
1000,500,483,522,260,494,754
1000,508,510,502,258,498,756
1000,486,482,504,232,519,751
1000,513,499,469,241,504,745
1000,500,498,474,248,494,742
1000,483,489,489,230,501,731
1000,480,481,537,229,517,746
1000,531,475,522,262,503,765
1000,478,490,518,239,507,746
1000,495,480,509,237,512,749
1000,491,496,484,238,495,733
1000,511,490,491,265,486,751
1000,501,507,490,259,492,751
1000,500,495,498,240,510,750
1000,512,493,505,251,516,767
1000,470,493,495,228,502,730
1000,510,493,490,244,503,747
1000,485,512,504,255,472,727
1000,479,510,475,226,492,718
1000,481,511,505,261,477,738
1000,506,506,483,263,475,738
1000,496,513,467,259,479,738
1000,480,524,461,251,467,718
1000,509,513,515,255,509,764
1000,497,496,488,239,506,745
1000,510,502,477,255,490,745
1000,483,526,491,255,475,730
1000,477,540,494,265,467,732
1000,502,532,505,248,504,752
1000,507,511,495,263,480,743
1000,524,483,487,257,494,751
1000,504,500,498,250,496,746
1000,486,494,491,233,500,733
1000,502,508,513,248,507,755
1000,508,491,473,239,497,736
1000,512,484,496,261,494,755
1000,504,502,509,262,498,760
1000,474,514,476,256,463,719
1000,507,513,506,261,502,763
1000,505,448,496,220,535,755
1000,517,511,501,261,509,770
1000,485,485,512,233,510,743
1000,529,507,485,277,483,760
1000,507,500,483,256,501,757
1000,481,503,488,231,511,742
1000,528,508,477,269,486,755
1000,500,482,483,238,499,737
1000,500,528,500,259,487,746
1000,497,504,499,247,489,736
1000,492,504,513,248,507,755
1000,515,493,491,256,483,739
1000,507,501,504,263,499,762
1000,490,505,492,247,495,742
1000,513,494,499,252,499,751
1000,499,503,496,253,501,754
1000,486,499,515,252,498,750
1000,502,512,501,257,498,755
1000,515,487,491,254,496,750
1000,516,497,470,266,489,755
1000,497,496,515,248,504,752
1000,527,500,497,266,502,768
1000,511,487,523,238,521,759
1000,510,510,490,247,506,753
1000,519,468,481,244,502,746
1000,475,474,494,221,514,735
1000,504,505,515,253,516,769
1000,487,494,528,243,525,768
1000,504,496,507,253,508,761
1000,520,473,500,248,511,759
1000,488,488,501,248,499,747
1000,504,474,502,234,509,743
1000,508,514,496,275,476,751
1000,492,499,498,246,504,750
1000,482,468,503,214,542,756
1000,481,470,490,218,523,741
1000,505,487,480,235,505,740
1000,496,479,489,241,506,747
1000,507,512,505,255,511,766
1000,497,484,509,238,520,758
1000,465,500,491,226,493,719
1000,494,492,493,255,484,739
1000,505,507,526,254,509,763
1000,514,484,487,259,495,754
1000,500,462,485,237,501,738
1000,506,498,487,242,491,733
1000,529,532,485,276,470,746
1000,474,535,505,247,503,750
1000,507,503,507,251,508,759
1000,532,485,468,272,487,759
1000,496,479,503,234,505,739
1000,475,506,501,234,500,734
1000,508,514,489,258,495,753
1000,521,498,480,268,489,757
1000,489,495,502,222,524,746
1000,516,505,515,258,509,767
1000,481,487,484,237,503,740
1000,501,506,490,253,495,748
1000,489,489,509,230,520,750
1000,527,511,507,277,486,763
1000,483,486,514,246,512,758
1000,476,504,483,244,488,732
1000,503,522,496,269,481,750
1000,490,499,486,246,483,729
1000,496,514,499,247,491,738
1000,540,494,497,261,509,770
1000,505,514,512,249,506,755
1000,498,488,497,252,500,752
1000,508,523,504,275,482,757
1000,477,498,497,228,518,746
1000,497,495,502,251,499,750
1000,489,500,495,226,515,741
1000,522,508,496,261,499,760
1000,513,515,475,270,468,738
1000,497,499,505,253,493,746
1000,490,504,509,228,512,740
1000,488,511,488,252,491,743
1000,467,497,513,231,518,749
1000,492,506,503,258,490,748
1000,517,502,494,274,476,750
1000,496,506,512,242,509,751
1000,486,527,475,247,479,726
1000,508,500,477,247,495,742
1000,518,522,536,271,483,754
1000,503,517,481,258,472,730
1000,512,517,469,260,501,761
1000,475,482,495,231,512,743
1000,497,496,490,263,471,734
1000,476,496,516,233,516,749
1000,487,513,504,243,498,741
1000,496,491,502,243,489,732
1000,501,518,518,262,499,761
1000,496,515,496,240,517,757
1000,484,487,492,225,532,757
1000,509,492,507,242,531,773
1000,501,487,509,234,513,747
1000,518,525,499,260,495,755
1000,515,505,483,257,499,756
1000,485,511,497,235,520,755
1000,506,491,501,253,493,746
1000,492,495,496,252,479,731
1000,514,472,490,234,522,756
1000,512,486,497,255,498,753
1000,496,503,489,256,491,747
1000,520,504,482,260,480,740
1000,513,474,508,232,544,776
1000,509,477,506,242,508,750
1000,494,471,512,233,514,747
1000,513,484,524,259,500,759
1000,450,535,483,245,475,720
1000,501,502,495,259,495,754
1000,477,511,474,247,478,725
1000,525,488,505,267,496,763
1000,501,519,507,260,492,752
1000,459,503,511,230,517,747
1000,500,475,461,218,523,741
1000,487,500,506,234,516,750
1000,511,499,498,254,496,750
1000,514,507,491,248,494,742
1000,492,534,490,253,482,735
1000,513,458,515,241,510,751
1000,516,500,493,265,498,763
1000,501,495,485,251,493,744
1000,477,493,494,245,498,743
1000,508,510,493,251,503,754
1000,502,501,482,247,495,742
1000,482,499,504,240,508,748
1000,502,487,501,262,489,751
1000,513,497,499,251,508,759
1000,503,484,514,246,504,750
1000,498,486,493,235,512,747
1000,511,498,507,252,504,756
1000,520,502,515,268,493,761
1000,499,530,475,259,467,726
1000,529,476,485,243,507,750
1000,502,521,513,262,509,771
1000,503,494,497,248,499,747
1000,496,500,483,254,492,746
1000,508,501,498,263,493,756
1000,499,501,479,255,477,732
1000,537,508,513,255,515,770
1000,505,494,500,237,515,752
1000,492,481,486,229,507,736
1000,492,510,503,245,499,744
1000,488,512,496,246,486,732
1000,500,494,472,244,495,739
1000,497,492,505,241,522,763
1000,507,481,506,245,498,743
1000,493,503,506,265,497,762
1000,484,501,494,255,490,745
1000,515,499,514,255,506,761
1000,487,524,468,278,445,723
1000,532,526,481,277,484,761
1000,519,518,500,262,499,761
1000,507,501,492,257,493,750
1000,500,471,509,238,518,756
1000,503,520,502,254,495,749
1000,508,538,502,266,479,745
1000,504,474,490,247,495,742
1000,499,503,505,245,498,743
1000,541,518,504,293,480,773
1000,495,469,489,235,516,751
1000,508,487,482,251,490,741
1000,503,488,514,250,517,767
1000,487,498,510,233,512,745
1000,500,479,489,250,496,746
1000,509,511,503,258,500,758
1000,483,483,490,243,501,744
1000,514,505,505,260,498,758
1000,501,533,492,275,494,769
1000,497,504,509,254,501,755
1000,494,508,482,253,497,750
1000,507,510,482,257,481,738
1000,498,499,497,234,526,760
1000,502,488,516,244,511,755
1000,461,498,489,232,504,736
1000,503,493,475,257,487,744
1000,509,493,517,246,526,772
1000,544,502,507,280,485,765
1000,499,494,511,251,511,762
1000,524,475,502,236,521,757
1000,495,499,500,240,496,736
1000,484,507,486,239,513,752
1000,485,488,495,241,496,737
1000,489,483,515,234,516,750
1000,527,518,479,267,501,768
1000,502,471,471,239,518,757
1000,483,484,496,238,508,746
1000,471,501,485,225,507,732
1000,478,514,499,246,485,731
1000,521,489,493,271,496,767
1000,532,511,500,280,486,766
1000,483,506,524,240,515,755
1000,533,524,487,269,487,756
1000,484,500,485,234,512,746
1000,498,499,499,244,519,763
1000,491,502,521,253,505,758
1000,513,526,503,269,477,746
1000,531,517,493,271,475,746
1000,475,486,507,244,496,740
1000,502,498,488,251,482,733
1000,488,510,514,263,500,763
1000,496,486,503,242,508,750
1000,507,495,471,264,490,754
1000,486,497,482,244,486,730
1000,517,492,493,252,495,747
1000,500,504,524,267,503,770
1000,492,492,529,249,524,773
1000,487,480,505,233,509,742
1000,472,492,488,230,513,743
1000,536,492,496,253,491,744
1000,490,517,515,255,497,752
1000,505,513,521,260,494,754
1000,523,484,493,252,508,760
1000,512,486,503,253,513,766
1000,501,509,517,251,508,759
1000,498,514,476,251,486,737
1000,506,518,504,262,499,761
1000,505,496,502,251,501,752
1000,511,481,471,249,499,748
1000,481,506,487,252,485,737
1000,518,496,516,252,515,767
1000,518,479,528,244,528,772
1000,510,515,494,256,501,757
1000,498,495,503,245,495,740
1000,519,507,521,262,493,755
1000,475,503,496,247,493,740
1000,509,485,511,250,505,755
1000,482,499,508,255,496,751
1000,502,497,497,251,501,752
1000,471,483,487,230,505,735
1000,485,492,506,240,498,738
1000,511,499,516,247,505,752
1000,502,491,502,239,521,760
1000,514,495,484,257,491,748
1000,487,489,493,242,502,744
1000,506,479,511,254,496,750
1000,504,490,500,245,529,774
1000,514,503,496,265,495,760
1000,500,501,498,270,482,752
1000,482,492,510,231,524,755
1000,494,516,500,252,497,749
1000,467,517,502,246,481,727
1000,515,520,497,269,465,734
1000,479,504,484,233,481,714
1000,507,506,507,252,517,769
1000,501,485,498,247,498,745
1000,484,517,479,242,499,741
1000,516,516,534,274,499,773
1000,498,490,508,231,531,762
1000,506,460,471,235,503,738
1000,529,479,499,241,524,765
1000,486,502,516,245,506,751
1000,519,500,503,245,515,760
1000,508,484,493,261,484,745
1000,461,498,502,230,493,723
1000,510,488,486,260,457,717
1000,510,505,484,272,464,736
1000,513,491,502,254,490,744
1000,505,499,483,256,487,743
1000,495,505,512,251,506,757
1000,498,469,499,232,532,764
1000,489,498,532,249,518,767
1000,500,494,510,229,517,746
1000,525,528,481,286,472,758
1000,521,504,510,256,515,771
1000,516,502,494,254,502,756
1000,500,486,508,241,525,766
1000,465,502,498,231,513,744
1000,510,489,504,263,499,762
1000,482,480,507,223,518,741
1000,468,508,502,234,514,748
1000,483,516,514,244,501,745
1000,505,497,520,235,515,750
1000,517,492,497,245,517,762
1000,505,510,489,252,496,748
1000,486,508,481,252,479,731
1000,486,526,484,251,500,751
1000,504,520,501,260,507,767
1000,486,530,502,249,492,741
1000,490,490,509,245,503,748
1000,482,481,519,227,523,750
1000,520,508,515,261,502,763
1000,499,496,486,240,508,748
1000,502,522,507,250,511,761
1000,505,532,505,270,484,754
1000,490,524,484,260,472,732
1000,471,507,490,236,504,740
1000,476,494,528,221,535,756
1000,486,497,502,246,496,742
1000,492,518,500,254,494,748
1000,495,480,488,239,508,747
1000,510,487,493,247,506,753
1000,500,515,498,274,483,757
1000,540,511,499,284,473,757
1000,514,514,507,257,485,742
1000,491,470,491,221,529,750
1000,510,512,485,247,483,730
1000,503,498,509,253,505,758
1000,489,515,513,251,503,754
1000,498,505,486,253,482,735
1000,505,483,485,242,502,744
1000,497,537,498,265,472,737
1000,497,498,488,235,500,735
1000,518,510,468,265,485,750
1000,529,524,491,279,470,749
1000,510,517,488,261,480,741
1000,482,489,486,210,519,729
1000,504,484,489,245,504,749
1000,501,516,525,263,492,755
1000,516,511,466,268,467,735
1000,491,521,481,258,475,733
1000,521,493,497,241,516,757
1000,458,513,529,241,507,748
1000,502,497,508,253,490,743
1000,478,501,541,250,517,767
1000,494,538,515,270,474,744
1000,492,495,519,248,503,751
1000,521,499,491,256,485,741
1000,503,502,482,253,483,736
1000,501,508,490,258,486,744
1000,472,491,482,238,490,728
1000,491,508,484,252,480,732
1000,522,528,505,270,498,768
1000,482,500,532,250,494,744
1000,533,492,512,267,512,779
1000,508,506,489,248,500,748
1000,502,485,508,230,518,748
1000,497,468,510,220,542,762
1000,493,515,473,255,481,736
1000,507,484,507,249,500,749
1000,494,499,500,248,497,745
1000,499,499,486,253,487,740
1000,499,498,494,250,493,743
1000,499,505,509,225,527,752
1000,487,491,496,240,490,730
1000,544,519,480,278,489,767
1000,552,502,515,271,515,786
1000,514,489,485,248,485,733
1000,492,480,501,234,500,734
1000,479,511,506,250,492,742
1000,522,485,498,276,468,744
1000,479,529,516,257,497,754
1000,485,519,503,266,477,743
1000,483,491,481,243,485,728
1000,499,517,513,263,495,758
1000,521,502,498,268,486,754
1000,526,506,482,258,493,751
1000,499,498,499,245,500,745
1000,516,506,523,254,519,773
1000,495,505,493,251,489,740
1000,497,494,531,256,503,759
1000,518,476,493,255,500,755
1000,504,507,519,267,500,767
1000,481,513,520,248,515,763
1000,497,508,508,242,523,765
1000,524,491,492,267,498,765
1000,502,505,491,246,491,737
1000,502,469,479,236,510,746
1000,525,482,493,241,517,758
1000,514,524,500,268,478,746
1000,488,474,508,235,518,753
1000,492,482,482,247,487,734
1000,499,494,500,248,510,758
1000,519,528,513,279,481,760
1000,484,514,456,250,470,720
1000,490,516,491,242,488,730
1000,498,488,523,246,512,758
1000,509,507,496,257,505,762
1000,493,500,500,246,501,747
1000,505,493,509,246,505,751
1000,476,488,502,233,511,744
1000,497,510,508,258,500,758
1000,525,484,504,259,498,757
1000,511,510,486,250,519,769
1000,509,526,523,271,494,765
1000,504,502,516,247,514,761
1000,526,510,492,266,476,742
1000,510,493,489,253,492,745
1000,510,525,478,268,470,738
1000,464,496,485,236,485,721
1000,486,463,490,228,498,726
1000,486,508,505,257,481,738
1000,469,509,526,243,498,741
1000,496,485,492,233,510,743
1000,523,489,515,247,518,765
1000,498,500,506,246,514,760
1000,519,471,490,240,519,759
1000,476,510,494,242,502,744
1000,499,508,492,267,456,723
1000,486,512,480,244,503,747
1000,493,513,505,264,477,741
1000,513,496,491,260,484,744
1000,487,498,488,237,507,744
1000,472,495,492,228,493,721
1000,514,502,505,253,516,769
1000,518,506,516,274,500,774
1000,529,495,502,260,500,760
1000,514,498,511,251,521,772
1000,517,525,548,271,517,788
1000,498,540,502,266,488,754
1000,532,485,498,279,485,764
1000,533,490,494,267,491,758
1000,498,509,527,243,510,753
1000,514,515,520,267,511,778
1000,507,489,484,240,503,743
1000,449,501,517,232,502,734
1000,503,509,491,259,485,744
1000,507,488,507,244,518,762
1000,506,503,484,248,496,744
1000,476,473,522,225,531,756
1000,499,492,531,247,521,768
1000,505,517,535,272,505,777
1000,490,495,501,252,491,743
1000,518,494,497,262,496,758
1000,494,509,508,244,509,753
1000,497,517,480,264,478,742
1000,491,506,489,238,494,732
1000,535,509,520,272,503,775
1000,488,506,516,255,513,768
1000,508,509,477,250,496,746
1000,515,507,513,262,499,761
1000,472,495,506,234,510,744
1000,492,518,494,267,470,737
1000,500,496,513,239,523,762
1000,544,498,477,271,497,768
1000,507,481,506,241,515,756
1000,486,505,502,237,513,750
1000,490,517,495,256,495,751
1000,498,529,519,262,507,769
1000,506,508,472,254,489,743
1000,510,511,497,263,503,766
1000,484,509,516,259,499,758
1000,496,485,508,252,498,750
1000,515,504,475,258,489,747
1000,486,473,529,237,530,767
1000,507,510,498,250,489,739
1000,503,521,490,265,487,752
1000,519,530,497,281,486,767
1000,497,520,514,278,488,766
1000,491,499,501,244,500,744
1000,512,499,502,261,488,749
1000,522,488,509,253,515,768
1000,503,516,498,262,472,734
1000,484,492,507,231,491,722
1000,487,501,531,248,506,754
1000,507,513,526,260,508,768
1000,524,486,496,256,496,752
1000,500,501,505,250,499,749
1000,496,493,481,242,489,731
1000,493,492,491,246,499,745
1000,501,489,497,251,492,743
1000,492,511,490,257,489,746
1000,476,505,521,235,509,744
1000,498,502,495,250,494,744
1000,516,498,487,264,474,738
1000,505,509,501,260,481,741
1000,489,528,496,255,476,731
1000,528,494,508,247,509,756
1000,503,485,501,251,504,755
1000,482,509,504,250,489,739
1000,516,503,462,268,462,730
1000,505,477,517,238,535,773
1000,501,465,466,250,480,730
1000,490,514,510,248,502,750
1000,514,510,475,268,482,750
1000,490,512,510,263,497,760
1000,502,508,484,255,487,742
1000,495,505,496,249,491,740
1000,532,505,480,263,488,751
1000,513,490,511,247,509,756
1000,498,518,511,251,509,760
1000,518,518,503,260,501,761
1000,494,462,533,227,554,781
1000,495,487,494,238,508,746
1000,491,462,510,219,533,752
1000,483,510,524,251,507,758
1000,494,520,507,255,498,753
1000,507,491,514,242,533,775
1000,524,488,486,271,491,762
1000,482,499,459,246,459,705
1000,498,484,515,243,518,761
1000,510,512,502,271,494,765
1000,526,497,491,257,503,760
1000,489,504,536,246,512,758
1000,497,474,481,229,522,751
1000,473,517,492,253,487,740
1000,554,487,534,275,520,795
1000,483,487,504,240,504,744
1000,495,512,490,252,492,744
1000,470,488,523,223,515,738
1000,494,468,526,205,544,749
1000,498,513,495,252,495,747
1000,489,503,498,266,471,737
1000,508,495,512,256,491,747
1000,478,498,477,238,493,731
1000,502,536,502,264,491,755
1000,500,476,523,238,519,757
1000,490,495,495,236,493,729
1000,516,509,501,270,481,751
1000,499,499,519,251,509,760
1000,518,526,535,275,488,763
1000,473,495,522,242,519,761
1000,504,496,531,258,500,758
1000,501,512,503,257,487,744
1000,481,498,496,244,496,740
1000,514,489,475,250,519,769
1000,507,521,538,267,518,785
1000,495,514,523,258,507,765
1000,504,507,505,252,519,771
1000,515,501,487,273,483,756
1000,500,483,503,241,502,743
1000,517,474,490,247,508,755
1000,486,508,511,241,504,745
1000,489,502,511,242,524,766
1000,493,469,520,219,541,760
1000,501,515,494,267,472,739
1000,476,482,509,216,516,732
1000,535,515,492,271,486,757
1000,527,490,499,264,513,777
1000,507,516,525,251,511,762
1000,490,515,515,249,514,763
1000,490,494,483,233,514,747
1000,480,462,507,218,538,756
1000,510,485,505,250,503,753
1000,530,504,517,262,490,752
1000,487,493,497,244,485,729
1000,494,508,491,247,498,745
1000,492,500,512,243,503,746
1000,486,505,520,241,509,750
1000,498,522,490,257,472,729
1000,503,495,492,245,511,756
1000,486,496,518,251,496,747
1000,528,462,483,238,525,763
1000,460,505,503,239,502,741
1000,497,512,501,254,489,743
1000,521,493,505,250,530,780
1000,468,507,470,228,485,713
1000,514,504,514,257,497,754
1000,491,450,493,218,532,750
1000,509,511,511,262,506,768
1000,515,502,507,250,514,764
1000,479,517,488,257,473,730
1000,499,496,481,253,490,743
1000,491,495,502,238,514,752
1000,498,478,510,229,522,751
1000,514,520,498,264,492,756
1000,508,533,502,285,474,759
1000,510,492,514,244,514,758
1000,521,492,491,248,509,757
1000,523,495,495,261,509,770
1000,516,514,513,273,492,765
1000,509,504,502,265,493,758
1000,504,516,482,253,496,749
1000,469,466,518,209,532,741
1000,491,513,499,246,485,731
1000,509,529,513,275,505,780
1000,508,477,480,258,489,747
1000,477,490,495,238,496,734
1000,498,497,463,252,466,718
1000,512,509,504,260,504,764
1000,509,512,517,257,514,771
1000,485,495,507,233,524,757
1000,499,514,487,265,477,742
1000,533,490,479,258,498,756
1000,519,522,518,274,497,771
1000,504,501,515,259,503,762
1000,493,493,524,249,508,757
1000,511,493,457,246,486,732
1000,467,534,493,246,478,724
1000,507,506,496,258,498,756
1000,483,501,496,244,484,728
1000,481,493,483,237,489,726
1000,503,490,532,237,515,752
1000,524,487,502,244,518,762
1000,509,505,466,253,488,741
1000,498,482,510,241,523,764
1000,518,509,513,256,519,775
1000,499,496,508,236,498,734
1000,480,523,507,258,466,724
1000,483,503,497,237,501,738
1000,528,499,544,254,532,786
1000,491,526,511,262,491,753
1000,520,495,496,252,500,752
1000,520,491,508,253,497,750
1000,523,481,474,247,497,744
1000,476,515,513,261,489,750
1000,499,484,499,239,519,758
1000,496,515,531,279,465,744
1000,476,498,497,244,493,737
1000,512,534,476,285,463,748
1000,502,506,518,259,494,753
1000,472,484,472,228,491,719
1000,515,527,502,279,478,757
1000,486,494,480,226,507,733
1000,491,473,503,228,514,742
1000,498,516,516,258,504,762
1000,514,491,519,262,503,765
1000,495,503,549,247,520,767
1000,512,506,493,248,499,747
1000,501,514,509,247,502,749
1000,514,553,497,282,467,749
1000,491,503,507,251,491,742
1000,513,494,522,251,512,763
1000,540,493,493,270,497,767
1000,479,482,510,233,496,729
1000,525,512,511,256,507,763
1000,515,486,501,246,499,745
1000,486,498,486,232,500,732
1000,501,511,509,262,498,760
1000,487,505,503,249,493,742
1000,506,507,508,255,506,761
1000,510,464,499,229,511,740
1000,496,499,503,250,514,764
1000,488,481,474,234,487,721
1000,515,494,486,239,517,756
1000,475,505,493,246,481,727
1000,484,493,529,228,532,760
1000,499,504,495,267,479,746
1000,486,518,493,245,490,735
1000,517,502,507,261,476,737
1000,504,500,507,240,515,755
1000,509,519,511,268,497,765
1000,498,516,493,249,509,758
1000,506,498,497,242,503,745
1000,475,498,503,239,509,748
1000,499,499,502,239,515,754
1000,500,513,511,256,494,750
1000,508,486,527,252,512,764
1000,494,476,471,247,491,738
1000,521,504,480,269,477,746
1000,503,503,505,244,495,739
1000,492,497,489,241,496,737
1000,489,520,493,271,459,730
1000,503,493,482,245,511,756
1000,511,494,497,246,500,746
1000,494,506,487,247,487,734
1000,513,505,485,265,490,755
1000,520,510,523,269,503,772
1000,502,509,496,261,488,749
1000,474,506,535,238,507,745
1000,513,481,471,252,480,732
1000,486,496,506,233,526,759
1000,497,509,505,249,510,759
1000,475,492,519,234,523,757
1000,494,475,502,242,505,747
1000,492,477,517,221,533,754
1000,484,483,492,235,497,732
1000,485,495,508,231,504,735
1000,469,497,463,224,475,699
1000,469,476,489,222,503,725
1000,498,502,510,262,482,744
1000,483,494,496,234,497,731
1000,497,511,494,259,473,732
1000,492,521,514,259,505,764
1000,511,523,523,269,498,767
1000,488,469,511,230,518,748
1000,515,502,511,250,495,745
1000,509,511,501,264,486,750
1000,508,504,501,254,507,761
1000,497,497,515,249,511,760
1000,497,497,538,231,533,764
1000,535,501,498,272,492,764
1000,504,496,499,253,504,757
1000,537,490,498,267,505,772
1000,501,533,489,269,480,749
1000,504,494,488,252,492,744
1000,489,508,497,235,502,737
1000,501,525,480,253,490,743
1000,468,531,543,257,505,762
1000,500,526,501,267,481,748
1000,519,524,499,280,491,771
1000,478,482,502,245,496,741
1000,491,510,517,260,506,766
1000,476,476,524,224,527,751
1000,480,494,502,234,502,736
1000,520,517,486,267,493,760
1000,512,488,477,249,496,745
1000,500,513,490,239,502,741
1000,495,505,501,249,494,743
1000,512,484,510,257,504,761
1000,497,512,477,260,495,755
1000,489,485,500,225,510,735
1000,477,493,479,247,490,737
1000,499,504,490,260,476,736
1000,499,518,517,252,491,743
1000,531,495,494,272,493,765
1000,503,492,517,252,510,762
1000,476,527,520,237,512,749
1000,481,532,486,244,487,731
1000,496,478,496,239,507,746
1000,490,516,469,252,481,733
1000,515,528,524,274,489,763
1000,494,496,494,235,504,739
1000,484,470,501,252,503,755
1000,491,476,499,235,510,745
1000,487,514,508,251,497,748
1000,477,522,493,246,485,731
1000,500,489,469,244,483,727
1000,524,494,495,265,507,772
1000,487,506,501,243,497,740
1000,495,500,480,258,469,727
1000,482,469,526,226,544,770
1000,519,517,497,253,509,762
1000,507,500,497,231,516,747
1000,498,513,480,244,495,739
1000,510,487,499,239,520,759
1000,525,507,513,277,488,765
1000,491,471,492,218,522,740
1000,484,468,475,214,516,730
1000,505,512,449,251,470,721
1000,512,491,497,254,496,750
1000,519,483,485,250,509,759
1000,488,504,492,248,510,758
1000,513,518,524,269,491,760
1000,482,479,483,228,500,728
1000,523,487,486,243,507,750
1000,529,497,504,268,488,756
1000,509,480,490,249,485,734
1000,497,495,477,241,483,724
1000,489,479,498,239,504,743
1000,511,492,498,261,509,770
1000,471,521,510,242,503,745
1000,488,489,505,260,489,749
1000,540,500,496,274,486,760
1000,506,518,524,261,505,766
1000,494,527,516,261,488,749
1000,502,516,508,259,492,751
1000,505,524,506,256,503,759
1000,499,514,484,257,499,756
1000,496,460,494,214,518,732
1000,494,526,509,267,491,758
1000,487,485,511,256,485,741
1000,523,509,497,263,493,756
1000,490,503,492,238,509,747
1000,488,488,500,233,538,771
1000,505,503,502,256,491,747
1000,477,529,502,258,482,740
1000,497,498,476,244,481,725
1000,528,525,500,282,475,757
1000,489,488,479,223,510,733
1000,494,507,509,237,512,749
1000,514,529,493,278,467,745
1000,517,518,526,270,495,765
1000,530,510,507,258,516,774
1000,494,495,479,240,491,731
1000,505,490,507,243,513,756
1000,463,510,522,223,522,745
1000,537,475,499,257,530,787
1000,511,498,500,252,503,755
1000,529,479,495,244,522,766
1000,484,515,502,243,493,736
1000,510,505,502,260,505,765
1000,504,501,510,239,534,773
1000,522,487,490,243,515,758
1000,498,493,494,243,507,750
1000,508,542,465,269,463,732
1000,514,473,502,244,515,759
1000,492,496,514,248,508,756
1000,490,498,497,237,502,739
1000,525,492,517,263,505,768
1000,516,505,498,257,488,745
1000,497,493,483,236,517,753
1000,488,505,504,231,520,751
1000,475,503,483,229,505,734
1000,502,512,508,257,499,756
1000,502,507,491,250,494,744
1000,515,505,495,256,500,756
1000,492,508,537,248,520,768
1000,474,508,498,247,487,734
1000,508,505,515,248,520,768
1000,485,500,493,238,505,743
1000,500,484,483,252,477,729
1000,468,492,481,234,489,723
1000,491,506,486,262,469,731
1000,503,492,491,244,514,758
1000,505,497,477,257,488,745
1000,501,510,477,242,501,743
1000,476,512,477,238,485,723
1000,526,490,513,249,526,775
1000,512,494,496,247,500,747
1000,520,489,508,258,511,769
1000,494,484,504,235,504,739
1000,504,514,519,257,504,761
1000,496,487,507,238,510,748
1000,484,515,499,244,500,744
1000,496,488,493,240,508,748
1000,508,484,493,250,501,751
1000,479,515,497,236,500,736
1000,503,525,494,261,490,751
1000,504,510,520,263,490,753
1000,502,511,518,259,498,757
1000,488,510,477,262,467,729
1000,494,501,497,250,493,743
1000,476,477,524,231,522,753
1000,495,501,484,259,501,760
1000,495,481,517,237,525,762
1000,490,465,514,225,527,752
1000,497,478,510,249,503,752
1000,495,497,511,257,495,752
1000,490,506,482,244,492,736
1000,502,508,510,259,496,755
1000,486,471,496,237,524,761
1000,498,509,510,249,494,743
1000,490,492,507,239,502,741
1000,493,501,472,256,481,737
1000,477,492,495,235,496,731
1000,529,517,486,284,474,758
1000,484,490,465,244,479,723
1000,515,504,505,262,494,756
1000,509,512,462,256,487,743
1000,504,505,499,250,494,744
1000,493,510,508,244,500,744
1000,512,525,518,258,501,759
1000,500,502,489,244,483,727
1000,495,520,504,269,487,756
1000,530,483,489,242,513,755
1000,484,500,493,251,478,729
1000,486,486,500,238,493,731
1000,506,473,478,242,500,742
1000,533,522,493,280,480,760
1000,528,508,499,269,494,763
1000,494,488,473,237,490,727
1000,508,483,498,263,484,747
1000,503,524,510,266,474,740
1000,489,490,515,231,528,759
1000,493,511,496,252,504,756
1000,502,487,519,245,517,762
1000,488,486,513,239,509,748
1000,482,497,501,250,474,724
1000,498,518,507,265,486,751
1000,487,495,501,254,491,745
1000,518,496,489,281,472,753
1000,549,510,512,281,509,790
1000,484,491,508,235,501,736
1000,514,488,495,237,521,758
1000,473,507,505,233,506,739
1000,486,496,480,228,511,739
1000,507,511,490,262,489,751
1000,462,513,507,238,511,749
1000,503,485,495,231,517,748
1000,500,502,500,238,506,744
1000,516,510,528,272,503,775
1000,524,500,536,262,515,777
1000,502,495,523,248,515,763
1000,511,507,479,257,507,764
1000,498,539,495,260,493,753
1000,487,498,503,237,508,745
1000,536,511,501,283,478,761
1000,491,476,460,235,497,732
1000,497,489,520,233,517,750
1000,519,488,492,259,493,752
1000,493,508,488,251,493,744
1000,497,493,492,243,500,743
1000,524,519,495,271,490,761
1000,527,473,503,243,532,775
1000,485,509,496,244,498,742
1000,474,512,475,240,497,737
1000,517,507,502,254,511,765
1000,508,503,493,259,494,753
1000,504,485,514,245,510,755
1000,507,525,504,273,476,749
1000,490,485,493,237,491,728
1000,521,496,503,265,495,760
1000,504,517,501,261,491,752
1000,520,510,520,265,518,783
1000,513,527,518,281,477,758
1000,496,496,515,240,521,761
1000,520,520,514,271,484,755
1000,472,524,514,246,508,754
1000,523,490,516,263,503,766
1000,512,489,513,246,511,757
1000,504,489,496,245,498,743
1000,493,499,502,251,499,750
1000,490,512,501,252,501,753
1000,505,517,494,257,485,742
1000,469,489,478,233,495,728
1000,486,487,514,244,514,758
1000,493,469,512,233,528,761
1000,511,495,519,257,493,750
1000,506,489,512,241,521,762
1000,505,507,495,254,506,760
1000,542,482,503,239,526,765
1000,493,516,455,254,482,736
1000,490,536,503,265,476,741
1000,489,502,496,235,506,741
1000,486,504,487,244,495,739
1000,508,495,466,275,471,746
1000,480,500,486,239,493,732
1000,513,495,467,264,486,750
1000,469,501,476,219,496,715
1000,485,513,533,245,526,771
1000,478,520,501,251,481,732
1000,501,507,519,245,515,760
1000,516,481,507,256,506,762
1000,508,476,494,246,495,741
1000,511,498,542,249,540,789
1000,513,502,529,250,508,758
1000,487,486,514,250,500,750
1000,503,485,503,242,505,747
1000,524,502,512,267,498,765
1000,494,504,503,250,501,751
1000,511,514,505,265,481,746
1000,511,488,486,250,491,741
1000,521,478,528,247,528,775
1000,511,503,482,260,487,747
1000,513,501,495,266,489,755
1000,471,512,485,243,486,729
1000,528,494,527,251,533,784
1000,469,500,475,223,502,725
1000,469,443,478,221,498,719
1000,483,484,507,238,496,734
1000,506,508,507,266,471,737
1000,519,491,498,255,498,753
1000,504,522,494,253,490,743
1000,500,492,516,235,518,753
1000,532,497,520,273,513,786
1000,486,493,490,250,488,738
1000,477,508,514,243,489,732
1000,498,489,503,234,526,760
1000,535,497,485,273,480,753
1000,512,504,486,245,521,766
1000,522,501,520,261,512,773
1000,505,522,490,269,483,752
1000,508,475,478,255,484,739
1000,501,520,499,252,495,747
1000,488,522,475,258,475,733
1000,510,508,513,262,508,770
1000,488,510,500,262,486,748
1000,472,492,505,234,506,740
1000,517,508,520,265,498,763
1000,511,509,472,255,501,756
1000,495,482,495,244,505,749
1000,493,486,473,244,495,739
1000,541,507,520,255,518,773
1000,506,515,506,262,488,750
1000,490,498,528,243,515,758
1000,501,484,501,230,529,759
1000,488,508,516,243,520,763
1000,511,495,515,254,510,764
1000,481,511,496,246,501,747
1000,496,488,522,245,503,748
1000,514,500,493,256,505,761
1000,489,513,503,261,484,745
1000,489,506,509,255,496,751
1000,513,500,504,268,501,769
1000,499,515,481,244,495,739
1000,503,533,499,265,492,757
1000,507,496,465,244,494,738
1000,506,495,513,249,521,770
1000,505,529,491,265,497,762
1000,498,494,489,267,482,749
1000,503,484,498,232,527,759
1000,467,516,519,230,512,742
1000,519,505,493,267,489,756
1000,510,475,506,247,518,765
1000,518,521,485,263,494,757
1000,497,521,510,248,513,761
1000,483,492,507,245,512,757
1000,515,506,487,262,488,750
1000,456,502,500,225,511,736
1000,535,502,503,258,492,750
1000,472,486,474,224,502,726
1000,505,508,548,238,527,765
1000,525,511,507,267,508,775
1000,530,533,524,289,477,766
1000,515,499,504,239,531,770
1000,473,498,500,245,487,732
1000,504,495,491,244,502,746
1000,488,482,504,246,492,738
1000,487,487,485,238,493,731
1000,481,528,494,261,477,738
1000,512,494,526,255,512,767
1000,500,502,520,252,514,766
1000,504,519,520,267,487,754
1000,509,505,515,260,509,769
1000,525,504,510,271,494,765
1000,474,495,521,229,517,746
1000,502,498,496,233,529,762
1000,467,534,499,246,488,734
1000,484,486,476,230,497,727
1000,518,523,483,277,467,744
1000,492,488,526,246,509,755
1000,488,514,513,256,497,753
1000,498,504,514,252,502,754
1000,487,469,481,236,517,753
1000,480,504,527,231,526,757
1000,503,520,529,262,514,776
1000,486,512,525,253,506,759
1000,493,496,520,250,518,768
1000,484,522,504,249,502,751
1000,533,497,468,267,481,748
1000,475,496,469,235,493,728
1000,483,500,500,241,494,735
1000,510,525,500,259,500,759
1000,522,512,514,260,514,774
1000,489,514,514,251,491,742
1000,492,490,487,249,487,736
1000,506,482,513,237,521,758
1000,528,499,464,264,492,756
1000,517,505,487,263,488,751
1000,484,512,475,249,484,733
1000,492,491,488,229,500,729
1000,497,477,514,246,517,763
1000,508,514,492,261,487,748
1000,498,467,483,240,494,734
1000,501,490,503,249,513,762
1000,485,487,510,232,513,745
1000,488,480,504,242,506,748
1000,487,509,491,234,512,746
1000,500,504,507,245,514,759
1000,481,486,473,239,481,720
1000,497,494,517,242,505,747
1000,496,495,510,247,506,753
1000,474,465,541,224,529,753
1000,485,503,483,241,498,739
1000,477,490,502,239,504,743
1000,488,499,504,249,497,746
1000,484,493,492,246,493,739
1000,522,505,485,262,496,758
1000,485,486,501,225,515,740
1000,517,498,494,271,484,755
1000,505,491,500,253,517,770
1000,501,502,490,251,501,752
1000,523,482,484,253,499,752
1000,473,504,492,239,505,744
1000,514,521,507,267,481,748
1000,491,491,511,245,502,747
1000,514,479,529,243,539,782
1000,505,494,485,251,497,748
1000,498,491,502,238,512,750
1000,476,509,516,249,504,753
1000,496,514,495,254,492,746
1000,491,482,522,233,511,744
1000,486,494,479,237,507,744
1000,498,482,493,244,506,750
1000,520,513,510,269,501,770
1000,505,501,489,254,507,761
1000,502,521,516,267,474,741
1000,503,504,528,250,509,759
1000,497,491,496,243,513,756
1000,489,478,487,224,511,735
1000,495,477,467,226,506,732
1000,518,508,522,254,517,771
1000,469,480,493,226,498,724
1000,501,516,498,250,489,739
1000,500,484,517,240,532,772
1000,535,495,511,274,493,767
1000,485,480,492,225,511,736
1000,490,510,530,250,499,749
1000,506,495,506,245,503,748
1000,481,480,481,224,507,731
1000,489,497,488,249,492,741
1000,513,485,518,262,506,768
1000,508,509,493,265,478,743
1000,477,501,523,231,518,749
1000,485,518,473,246,474,720
1000,511,516,510,247,518,765
1000,502,525,502,265,490,755
1000,522,475,491,241,509,750
1000,497,496,527,239,530,769
1000,489,489,502,259,496,755
1000,478,485,529,230,527,757
1000,517,498,494,262,486,748
1000,517,482,515,246,530,776
1000,497,496,516,251,504,755
1000,475,515,512,251,486,737
1000,480,507,482,236,503,739
1000,497,506,485,251,485,736
1000,493,478,503,234,507,741
1000,503,497,527,251,500,751
1000,519,467,492,240,512,752
1000,492,503,523,240,531,771
1000,504,525,515,264,486,750
1000,499,514,498,247,495,742
1000,491,482,511,219,524,743
1000,481,512,479,251,477,728
1000,496,505,503,254,496,750
1000,521,496,500,265,495,760
1000,494,504,487,239,512,751
1000,506,519,483,251,499,750
1000,505,517,473,269,469,738
1000,527,517,519,275,490,765
1000,479,503,490,243,498,741
1000,504,487,508,236,513,749
1000,503,505,501,261,507,768
1000,509,553,493,272,480,752
1000,521,506,497,275,477,752
1000,488,513,509,246,495,741
1000,511,502,531,268,501,769
1000,506,477,512,236,522,758
1000,509,494,495,246,499,745
1000,522,500,510,266,511,777
1000,518,522,530,271,500,771
1000,502,508,495,251,495,746
1000,514,491,499,252,495,747
1000,502,471,496,235,503,738
1000,493,482,499,231,510,741
1000,523,482,501,260,501,761
1000,511,540,466,268,470,738
1000,496,516,473,248,469,717
1000,549,522,505,296,487,783
1000,485,518,472,247,483,730
1000,504,492,496,248,496,744
1000,495,493,522,247,508,755
1000,509,471,481,238,499,737
1000,518,506,499,257,509,766
1000,504,506,503,262,481,743
1000,504,502,488,265,482,747
1000,516,494,506,263,510,773
1000,496,478,515,248,515,763
1000,475,510,497,240,491,731
1000,499,483,496,242,495,737
1000,499,486,497,242,512,754
1000,471,511,487,251,469,720
1000,511,506,496,256,491,747
1000,474,515,520,236,517,753
1000,547,502,496,268,488,756
1000,506,506,480,253,494,747
1000,467,501,500,227,503,730
1000,510,518,505,257,514,771
1000,475,498,502,254,484,738
1000,513,498,496,255,490,745
1000,491,491,519,250,498,748
1000,497,482,494,237,517,754
1000,509,490,504,257,506,763
1000,501,467,504,240,508,748
1000,496,478,485,238,505,743
1000,491,520,495,251,494,745
1000,484,511,499,267,471,738
1000,475,502,496,235,500,735
1000,487,516,498,255,487,742
1000,495,525,555,255,515,770
1000,477,506,494,225,500,725
1000,525,493,522,257,512,769
1000,496,513,476,253,480,733
1000,485,494,498,243,490,733
1000,503,476,471,236,507,743
1000,498,500,490,261,474,735
1000,531,490,500,258,510,768
1000,504,501,494,251,504,755
1000,508,479,503,239,517,756
1000,487,475,508,230,521,751
1000,498,501,500,258,493,751
1000,492,478,525,228,533,761
1000,502,473,511,234,519,753
1000,514,488,486,262,484,746
1000,505,494,515,252,510,762
1000,519,508,525,260,506,766
1000,535,501,516,256,522,778
1000,528,491,472,269,480,749
1000,466,508,511,232,497,729
1000,519,498,487,268,484,752
1000,517,506,491,268,483,751
1000,507,488,522,248,525,773
1000,491,504,488,246,498,744
1000,496,487,507,237,510,747
1000,524,458,520,235,535,770
1000,488,533,504,270,477,747
1000,481,527,485,257,474,731
1000,526,509,494,259,521,780
1000,476,487,500,230,517,747
1000,514,496,470,259,493,752
1000,482,505,495,262,481,743
1000,513,532,515,263,515,778
1000,512,497,470,245,493,738
1000,515,502,485,259,506,765
1000,515,509,525,245,529,774
1000,496,497,499,234,519,753
1000,482,497,514,236,521,757
1000,468,474,477,228,511,739
1000,481,500,504,243,496,739
1000,500,480,484,249,480,729
1000,494,498,488,251,480,731
1000,512,520,487,264,480,744
1000,499,520,493,254,491,745
1000,497,499,472,248,496,744
1000,498,507,490,247,495,742
1000,499,492,483,261,478,739
1000,493,523,502,272,482,754
1000,492,511,499,261,476,737
1000,508,496,506,261,494,755
1000,501,484,524,247,528,775
1000,528,485,485,271,481,752
1000,479,506,513,247,487,734
1000,496,494,532,250,508,758
1000,497,485,517,240,514,754
1000,470,495,520,240,509,749
1000,476,515,484,249,475,724
1000,504,509,491,251,478,729
1000,477,516,519,244,506,750
1000,493,490,515,243,503,746
1000,503,478,492,243,500,743
1000,485,491,512,230,515,745
1000,475,529,498,251,494,745
1000,485,481,498,242,502,744
1000,495,493,478,233,510,743
1000,466,500,501,226,515,741
1000,522,506,531,276,491,767
1000,512,487,505,247,502,749
1000,527,499,506,268,513,781
1000,506,492,518,235,524,759
1000,500,495,508,250,504,754
1000,479,507,497,260,474,734
1000,509,489,516,253,504,757
1000,497,509,507,261,512,773
1000,479,517,502,244,489,733
1000,482,506,516,235,510,745
1000,517,501,488,260,471,731
1000,497,498,507,248,510,758
1000,472,510,478,263,461,724
1000,478,516,512,244,507,751
1000,516,489,503,241,514,755
1000,480,503,480,247,494,741
1000,482,498,491,234,503,737
1000,483,484,506,238,511,749
1000,518,494,486,265,487,752
1000,494,508,477,249,494,743
1000,502,474,514,240,520,760
1000,508,522,479,253,497,750
1000,490,511,513,244,507,751
1000,491,512,529,254,516,770
1000,496,487,485,242,495,737
1000,527,506,498,275,487,762
1000,507,492,497,259,489,748
1000,517,516,489,272,486,758
1000,507,505,489,267,480,747
1000,496,521,489,266,471,737
1000,499,487,480,242,488,730
1000,492,489,502,238,501,739
1000,521,502,479,246,519,765
1000,467,476,518,221,518,739
1000,516,507,479,255,489,744
1000,502,509,501,251,495,746
1000,489,491,485,236,503,739
1000,496,507,493,246,494,740
1000,490,500,518,245,518,763
1000,475,488,507,235,510,745
1000,507,529,496,276,481,757
1000,499,477,490,237,498,735
1000,519,516,512,254,511,765
1000,472,498,509,224,534,758
1000,495,497,483,247,476,723
1000,503,517,502,260,508,768
1000,494,499,504,245,508,753
1000,490,525,524,255,497,752
1000,514,495,499,264,486,750
1000,497,519,487,260,480,740
1000,488,531,503,250,485,735
1000,493,516,475,237,505,742
1000,503,528,514,271,495,766
1000,516,502,481,256,496,752
1000,514,519,472,277,465,742
1000,505,480,511,245,498,743
1000,515,461,511,233,529,762
1000,503,509,502,250,493,743
1000,510,501,508,252,509,761
1000,482,494,516,245,504,749
1000,550,506,498,260,511,771
1000,494,496,501,225,525,750
1000,479,523,498,250,478,728
1000,490,477,482,227,501,728
1000,463,498,529,239,522,761
1000,483,480,505,220,534,754
1000,482,484,491,232,518,750
1000,452,505,505,237,478,715
1000,501,504,500,263,483,746
1000,531,494,498,254,502,756
1000,523,498,475,259,482,741
1000,492,488,497,229,517,746
1000,520,491,507,253,498,751
1000,524,530,518,290,477,767
1000,514,499,503,263,485,748
1000,474,504,506,246,487,733
1000,478,483,492,243,490,733
1000,485,516,489,242,493,735
1000,518,512,464,254,488,742
1000,484,485,523,228,526,754
1000,515,514,500,278,465,743
1000,498,503,506,262,496,758
1000,503,521,499,270,482,752
1000,515,502,474,273,481,754
1000,523,507,502,256,494,750
1000,497,519,507,257,493,750
1000,505,500,478,243,500,743
1000,499,495,516,242,518,760
1000,505,513,515,248,509,757
1000,456,488,477,219,485,704
1000,535,490,512,253,527,780
1000,483,484,471,217,509,726
1000,502,503,500,245,511,756
1000,494,498,493,247,482,729
1000,487,488,478,223,505,728
1000,512,469,530,247,531,778
1000,502,467,496,233,517,750
1000,519,500,471,281,466,747
1000,505,508,488,253,489,742
1000,484,519,504,248,486,734
1000,510,523,502,260,481,741
1000,509,520,489,252,498,750
1000,479,500,489,236,487,723
1000,510,507,504,252,507,759
1000,508,520,534,266,502,768
1000,517,499,477,246,499,745
1000,535,493,526,257,514,771
1000,471,522,512,266,476,742
1000,528,480,507,249,522,771
1000,503,511,440,253,459,712
1000,523,506,481,251,495,746
1000,518,504,500,258,494,752
1000,487,501,516,263,487,750
1000,514,471,532,253,512,765
1000,507,482,468,249,494,743
1000,505,513,509,261,491,752
1000,492,524,491,255,491,746
1000,549,481,494,268,505,773
1000,500,488,477,266,483,749
1000,515,515,515,262,499,761
1000,527,504,503,256,506,762
1000,500,492,473,239,503,742
1000,488,484,505,235,504,739
1000,477,504,510,234,519,753
1000,484,502,521,248,519,767
1000,539,514,481,277,484,761
1000,506,505,512,251,500,751
1000,478,524,502,247,491,738
1000,495,508,490,253,486,739
1000,512,503,521,260,494,754
1000,494,484,495,232,510,742
1000,484,506,501,238,502,740
1000,486,483,472,231,504,735
1000,502,513,500,247,500,747
1000,511,504,507,258,494,752
1000,538,508,493,267,504,771
1000,504,502,497,263,483,746
1000,516,511,504,269,479,748
1000,486,490,508,224,526,750
1000,477,500,441,240,464,704
1000,502,521,503,259,509,768
1000,449,524,512,234,486,720
1000,533,507,505,263,501,764
1000,506,519,482,251,500,751
1000,514,515,499,257,514,771
1000,514,474,487,239,507,746
1000,494,517,511,251,514,765
1000,502,497,492,247,511,758
1000,481,490,503,231,501,732
1000,475,527,514,244,493,737
1000,497,488,504,249,511,760
1000,491,497,463,239,493,732
1000,499,531,495,272,465,737
1000,476,538,519,254,499,753
1000,526,496,513,268,498,766
1000,471,511,516,246,500,746
1000,511,482,529,247,518,765
1000,483,504,488,235,496,731
1000,473,524,494,245,488,733
1000,485,490,475,239,494,733
1000,530,485,505,265,507,772
1000,503,497,507,254,501,755
1000,510,486,506,242,514,756
1000,493,522,487,259,467,726
1000,518,483,491,244,502,746
1000,503,526,520,275,480,755
1000,485,489,511,242,503,745
1000,511,483,531,239,533,772
1000,499,490,489,243,515,758
1000,520,509,499,256,504,760
1000,482,465,546,228,534,762
1000,537,509,492,267,486,753
1000,497,513,481,245,481,726
1000,502,502,508,245,492,737
1000,493,485,498,226,525,751
1000,522,489,524,262,512,774
1000,479,490,527,244,510,754
1000,503,483,501,230,527,757
1000,501,512,523,260,514,774
1000,516,494,504,241,532,773
1000,516,510,484,268,479,747
1000,507,485,494,250,505,755
1000,494,495,516,248,519,767
1000,482,487,509,229,513,742
1000,503,498,502,256,504,760
1000,510,516,517,255,511,766
1000,516,500,474,237,493,730
1000,499,511,473,270,460,730
1000,508,493,525,254,535,789
1000,472,516,516,242,504,746
1000,504,522,498,251,501,752
1000,503,534,512,270,493,763
1000,515,505,509,256,508,764
1000,502,491,504,255,492,747
1000,513,508,497,272,490,762
1000,510,511,501,263,501,764
1000,474,494,515,230,518,748
1000,504,489,525,228,537,765
1000,483,496,512,243,487,730
1000,488,517,468,244,484,728
1000,499,483,513,256,501,757
1000,477,486,472,216,512,728
1000,516,499,485,259,488,747
1000,526,517,520,264,514,778
1000,496,519,506,251,503,754
1000,483,510,491,247,492,739
1000,515,480,522,242,535,777
1000,494,503,502,259,473,732
1000,501,507,479,258,474,732
1000,476,507,505,245,490,735
1000,491,505,520,247,507,754
1000,505,505,507,270,492,762
1000,480,500,507,235,501,736
1000,496,516,513,246,507,753
1000,502,494,511,254,498,752
1000,478,495,514,243,497,740
1000,512,477,476,246,495,741
1000,497,498,498,254,488,742
1000,508,502,488,259,480,739
1000,505,484,495,246,498,744
1000,477,527,514,256,502,758
1000,507,501,504,258,496,754
1000,497,504,504,255,502,757
1000,516,478,511,245,522,767
1000,499,495,479,248,501,749
1000,506,506,510,262,481,743
1000,533,525,526,284,487,771
1000,495,512,489,249,491,740
1000,515,512,531,270,495,765
1000,514,510,505,275,494,769
1000,478,494,493,230,522,752
1000,497,485,498,230,531,761
1000,503,494,509,245,517,762
1000,501,503,505,243,518,761
1000,472,494,497,241,501,742
1000,517,508,502,267,492,759
1000,488,523,505,248,506,754
1000,502,495,511,236,514,750
1000,518,514,505,273,492,765
1000,518,478,494,242,516,758
1000,491,505,503,242,508,750
1000,479,519,484,231,507,738
1000,507,478,504,247,512,759
1000,541,497,532,260,536,796
1000,495,490,532,236,525,761
1000,522,520,502,275,486,761
1000,509,510,516,272,485,757
1000,499,504,507,252,511,763
1000,519,479,521,247,523,770
1000,509,501,524,258,513,771
1000,497,510,498,247,497,744
1000,507,505,482,259,470,729
1000,506,488,512,260,492,752
1000,478,501,517,245,501,746
1000,496,475,514,231,529,760
1000,501,496,499,239,507,746
1000,511,462,494,221,538,759
1000,486,497,503,236,508,744
1000,493,500,505,252,496,748
1000,479,452,504,221,525,746
1000,488,492,502,243,487,730
1000,503,509,516,265,500,765
1000,511,478,486,241,505,746
1000,488,514,498,262,470,732
1000,484,513,483,249,485,734
1000,489,526,497,253,490,743
1000,510,515,495,271,471,742
1000,518,491,501,250,510,760
1000,502,508,474,263,472,735
1000,495,486,499,234,504,738
1000,513,522,510,257,513,770
1000,510,501,490,261,496,757
1000,487,486,482,235,489,724
1000,500,518,508,266,472,738
1000,494,537,488,262,470,732
1000,505,505,505,242,509,751
1000,487,474,494,220,532,752
1000,500,500,513,250,514,764
1000,503,510,515,257,507,764
1000,495,497,513,248,515,763
1000,518,501,502,261,493,754
1000,471,491,510,221,532,753
1000,505,528,468,276,467,743
1000,521,491,484,250,510,760
1000,477,477,506,217,535,752
1000,500,501,512,247,516,763
1000,482,508,524,254,508,762
1000,503,518,526,250,513,763
1000,505,509,493,255,494,749
1000,516,505,502,262,501,763
1000,525,498,501,259,510,769
1000,488,485,484,223,508,731
1000,497,512,520,263,500,763
1000,474,510,493,244,488,732
1000,492,496,492,231,512,743
1000,502,509,498,253,480,733
1000,472,503,483,237,470,707
1000,478,525,482,251,484,735
1000,496,487,500,251,503,754
1000,490,507,520,253,505,758
1000,506,518,523,246,520,766
1000,495,483,486,244,506,750
1000,483,504,514,244,506,750
1000,532,493,517,251,515,766
1000,487,512,515,252,505,757
1000,484,517,511,256,501,757
1000,498,503,533,265,504,769
1000,504,495,517,256,504,760
1000,514,507,511,253,520,773
1000,490,507,508,261,508,769
1000,534,519,487,287,460,747
1000,484,502,446,233,481,714
1000,511,523,483,281,478,759
1000,490,501,523,245,510,755
1000,489,475,523,234,531,765
1000,501,496,513,260,504,764
1000,509,493,489,247,512,759
1000,484,495,523,255,499,754
1000,488,494,508,235,524,759
1000,480,498,511,225,518,743
1000,538,489,523,264,524,788
1000,504,516,463,263,487,750
1000,486,500,489,235,500,735
1000,492,497,487,247,487,734
1000,478,539,509,257,484,741
1000,514,516,475,263,492,755
1000,490,512,504,245,508,753
1000,493,502,514,257,491,748
1000,511,476,484,247,503,750
1000,499,523,488,266,473,739
1000,497,515,496,260,478,738
1000,499,521,516,255,500,755
1000,501,504,506,257,488,745
1000,492,483,492,246,503,749
1000,501,497,489,258,498,756
1000,490,521,505,258,487,745
1000,522,491,496,255,508,763
1000,496,497,468,252,479,731
1000,510,501,526,268,499,767
1000,493,485,500,241,502,743
1000,491,499,525,239,512,751
1000,519,479,506,246,518,764
1000,500,500,506,241,518,759
1000,495,469,480,223,520,743
1000,513,482,495,246,502,748
1000,522,483,515,259,514,773
1000,512,485,489,256,487,743
1000,485,491,461,243,472,715
1000,511,496,521,256,502,758
1000,497,510,532,255,514,769
1000,521,479,507,239,525,764
1000,504,502,500,235,520,755
1000,492,510,504,253,490,743
1000,503,487,496,253,500,753
1000,505,509,493,261,491,752
1000,467,481,503,223,519,742
1000,494,510,493,234,508,742
1000,472,484,485,215,513,728
1000,483,485,531,229,521,750
1000,489,510,513,246,496,742
1000,502,466,521,233,532,765
1000,505,465,473,228,508,736
1000,508,501,501,252,499,751
1000,522,498,508,258,502,760
1000,507,492,505,241,512,753
1000,482,504,490,242,501,743
1000,492,512,505,250,481,731
1000,499,508,488,255,492,747
1000,474,502,528,230,520,750
1000,494,510,498,252,503,755
1000,511,507,493,253,493,746
1000,520,514,495,275,483,758
1000,531,524,497,283,476,759
1000,506,479,486,251,500,751
1000,524,495,500,260,505,765
1000,496,515,475,251,488,739
1000,508,475,497,242,509,751
1000,486,519,497,243,502,745
1000,509,503,481,252,502,754
1000,549,494,493,262,510,772
1000,489,493,488,235,491,726
1000,516,490,508,258,511,769
1000,501,497,506,256,490,746
1000,511,475,525,239,520,759
1000,502,519,502,255,507,762
1000,499,504,485,255,476,731
1000,527,501,484,260,492,752
1000,518,494,499,249,501,750
1000,531,464,460,248,492,740
1000,510,492,494,241,506,747
1000,497,494,504,253,496,749
1000,475,505,496,228,499,727
1000,510,487,507,248,509,757
1000,503,505,507,251,505,756
1000,488,531,516,261,485,746
1000,490,524,523,262,507,769
1000,483,521,511,245,501,746
1000,483,510,490,252,481,733
1000,495,495,491,246,504,750
1000,516,481,508,239,532,771
1000,487,493,504,239,501,740
1000,519,494,504,261,497,758
1000,501,480,520,244,512,756
1000,524,533,508,287,481,768
1000,525,504,493,254,509,763
1000,524,494,499,245,529,774
1000,505,501,494,256,487,743
1000,494,503,513,246,506,752
1000,500,520,518,274,482,756
1000,497,456,508,218,545,763
1000,491,522,516,249,506,755
1000,507,499,492,258,494,752
1000,508,509,508,256,512,768
1000,494,484,491,252,501,753
1000,496,478,495,256,495,751
1000,501,485,484,231,521,752
1000,540,518,491,281,481,762
1000,509,492,512,246,512,758
1000,484,522,515,251,500,751
1000,485,496,496,232,514,746
1000,495,500,494,246,509,755
1000,493,500,516,244,505,749
1000,510,491,525,252,511,763
1000,486,520,485,249,493,742
1000,500,498,511,245,504,749
1000,487,514,497,249,491,740
1000,487,484,521,236,533,769
1000,500,505,481,255,489,744
1000,518,481,517,245,516,761
1000,495,508,462,253,469,722
1000,515,491,474,256,483,739
1000,482,508,505,237,515,752
1000,495,515,517,252,506,758
1000,486,509,485,232,506,738
1000,488,488,512,227,522,749
1000,495,496,506,246,512,758
1000,521,469,508,234,529,763
1000,494,509,475,246,496,742
1000,516,505,488,257,498,755
1000,505,490,477,232,506,738
1000,514,495,514,262,506,768
1000,516,511,509,262,496,758
1000,506,510,484,262,478,740
1000,486,511,455,233,493,726
1000,483,521,515,243,519,762
1000,510,489,486,247,502,749
1000,499,522,531,256,508,764
1000,525,503,500,266,485,751
1000,479,505,486,249,474,723
1000,509,499,488,244,514,758
1000,499,498,480,246,498,744
1000,512,484,466,236,508,744
1000,492,491,509,238,524,762
1000,499,482,495,243,485,728
1000,497,530,472,276,473,749
1000,499,491,488,255,496,751
1000,491,502,477,237,495,732
1000,485,513,522,247,515,762
1000,509,494,502,248,509,757
1000,500,522,486,261,467,728
1000,487,483,509,225,527,752
1000,493,497,486,249,491,740
1000,505,480,525,254,510,764
1000,494,508,504,251,500,751
1000,473,511,475,234,485,719
1000,508,501,532,257,515,772
1000,511,504,487,262,490,752
1000,483,500,502,239,502,741
1000,505,484,496,248,505,753
1000,489,515,483,240,482,722
1000,498,519,527,253,514,767
1000,502,499,518,241,509,750
1000,535,509,495,284,479,763
1000,495,528,522,259,494,753
1000,502,502,517,247,512,759
1000,519,527,502,273,491,764
1000,518,500,501,267,503,770
1000,503,499,499,248,494,742
1000,508,468,493,226,516,742
1000,499,492,513,257,498,755
1000,521,495,484,270,479,749
1000,464,486,503,236,499,735
1000,530,500,493,272,487,759
1000,461,519,489,239,486,725
1000,478,515,505,238,513,751
1000,494,488,502,240,506,746
1000,483,500,487,241,491,732
1000,486,490,504,255,489,744
1000,493,513,491,241,495,736
1000,503,496,508,242,514,756
1000,497,491,521,250,519,769
1000,508,516,507,265,495,760
1000,481,496,451,243,471,714
1000,534,489,485,257,499,756
1000,494,506,487,260,473,733
1000,465,505,494,244,488,732
1000,485,482,477,223,509,732
1000,510,519,530,270,487,757
1000,502,485,532,253,516,769
1000,544,508,504,273,500,773
1000,490,483,517,227,532,759
1000,463,482,494,215,507,722
1000,486,501,522,250,503,753
1000,495,478,476,235,496,731
1000,504,523,504,264,490,754
1000,474,516,505,243,501,744
1000,469,498,494,230,491,721
1000,475,498,476,231,497,728
1000,491,496,498,261,482,743
1000,506,522,477,254,486,740
1000,497,506,497,253,494,747
1000,505,496,478,258,493,751
1000,493,508,501,256,497,753
1000,501,494,509,251,504,755
1000,491,501,485,236,506,742
1000,516,490,492,250,495,745
1000,466,477,506,232,514,746
1000,512,520,476,269,492,761
1000,481,487,492,235,495,730
1000,510,511,500,276,468,744
1000,505,502,512,245,512,757
1000,519,501,504,268,505,773
1000,478,490,505,248,491,739
1000,520,498,509,280,497,777
1000,499,489,494,238,520,758
1000,518,512,519,268,488,756
1000,491,482,518,239,526,765
1000,497,535,491,262,492,754
1000,486,489,491,254,472,726
1000,487,516,522,254,505,759
1000,491,464,510,233,520,753
1000,521,499,509,259,502,761
1000,478,499,490,232,505,737
1000,523,504,492,263,490,753
1000,495,490,497,247,501,748
1000,495,508,490,250,486,736
1000,467,484,493,215,511,726
1000,512,508,512,259,492,751
1000,487,497,479,233,491,724
1000,488,505,490,232,514,746
1000,509,490,485,257,498,755
1000,516,498,499,256,497,753
1000,497,519,495,244,518,762
1000,479,518,503,253,497,750
1000,476,517,456,239,477,716
1000,505,478,501,247,502,749
1000,484,499,503,240,507,747
1000,495,516,516,255,497,752
1000,526,507,488,270,486,756
1000,555,473,495,265,523,788
1000,487,501,473,256,458,714
1000,496,500,505,253,493,746
1000,492,508,476,256,472,728
1000,524,499,492,270,483,753
1000,503,501,519,243,512,755
1000,525,505,524,256,533,789
1000,483,500,485,262,484,746
1000,505,506,527,244,517,761
1000,529,514,509,263,504,767
1000,503,520,489,252,488,740
1000,492,500,505,244,506,750
1000,512,518,488,267,495,762
1000,500,510,513,261,489,750
1000,502,499,525,248,519,767
1000,492,495,464,243,486,729
1000,508,511,524,265,499,764
1000,525,509,518,259,497,756
1000,499,500,513,257,491,748
1000,504,478,506,242,515,757
1000,487,509,495,244,485,729
1000,504,499,522,258,501,759
1000,505,485,514,253,497,750
1000,488,495,513,238,499,737
1000,511,487,518,258,499,757
1000,477,482,486,227,510,737
1000,490,506,479,254,477,731
1000,506,490,501,258,488,746
1000,476,495,496,237,504,741
1000,502,498,510,261,493,754
1000,476,494,506,243,487,730
1000,513,524,480,268,469,737
1000,532,498,542,267,521,788
1000,522,479,496,253,516,769
1000,510,521,514,271,501,772
1000,477,488,482,231,505,736
1000,514,482,504,254,514,768
1000,480,513,499,249,478,727
1000,509,491,512,243,519,762
1000,527,485,489,261,493,754
1000,499,523,495,256,491,747
1000,510,507,519,259,512,771
1000,505,522,523,270,485,755
1000,523,493,491,256,505,761
1000,496,507,521,246,523,769
1000,510,511,489,269,472,741
1000,502,495,523,247,507,754
1000,488,487,486,245,498,743
1000,499,532,472,265,469,734
1000,544,497,498,272,499,771
1000,499,491,479,238,505,743
1000,497,502,486,246,484,730
1000,464,501,494,241,474,715
1000,501,517,500,265,483,748
1000,495,505,507,252,498,750
1000,506,503,479,245,507,752
1000,534,504,505,277,491,768
1000,500,499,483,237,515,752
1000,515,514,478,274,476,750
1000,507,504,517,250,516,766
1000,485,509,514,241,517,758
1000,511,508,504,262,495,757
1000,516,477,496,259,500,759
1000,498,504,483,251,482,733
1000,492,489,512,258,486,744
1000,517,482,487,253,508,761
1000,478,476,513,215,517,732
1000,498,500,491,245,499,744
1000,479,484,488,232,496,728
1000,484,507,505,236,526,762
1000,549,491,498,274,506,780
1000,491,521,483,259,483,742
1000,509,488,482,239,513,752
1000,493,493,485,230,500,730
1000,494,484,523,242,518,760
1000,503,511,502,245,491,736
1000,514,488,479,256,489,745
1000,516,526,500,270,493,763
1000,491,514,503,262,483,745
1000,511,496,510,248,529,777
1000,510,510,498,286,479,765
1000,508,492,502,251,513,764
1000,522,477,484,245,498,743
1000,489,508,501,260,485,745
1000,499,505,525,250,496,746
1000,521,490,480,250,505,755
1000,479,528,521,255,501,756
1000,481,529,511,256,493,749
1000,497,488,496,250,491,741
1000,491,496,493,227,507,734
1000,495,492,515,248,492,740
1000,511,497,496,263,485,748
1000,528,514,484,279,479,758
1000,513,480,510,249,511,760
1000,494,499,502,259,480,739
1000,497,500,506,259,504,763
1000,538,513,529,278,492,770
1000,496,518,513,271,470,741
1000,511,473,463,250,491,741
1000,518,497,488,251,516,767
1000,506,490,495,240,516,756
1000,491,495,478,229,506,735
1000,482,494,502,231,522,753
1000,471,518,517,236,503,739
1000,500,493,482,246,497,743
1000,525,519,486,276,466,742
1000,509,499,521,259,510,769
1000,512,498,500,254,498,752
1000,509,501,480,245,480,725
1000,498,518,514,249,502,751
1000,510,517,491,257,486,743
1000,516,502,488,243,519,762
1000,512,481,505,240,521,761
1000,528,518,531,268,504,772
1000,496,476,487,247,477,724
1000,502,475,466,222,503,725
1000,474,524,481,258,478,736
1000,476,512,512,258,492,750
1000,517,473,494,227,520,747
1000,474,488,493,226,494,720
1000,502,477,504,234,529,763
1000,505,500,502,237,510,747
1000,514,522,506,281,476,757
1000,487,487,492,238,500,738
1000,511,523,498,271,487,758
1000,491,499,470,253,492,745
1000,500,467,494,228,524,752
1000,496,506,499,261,489,750
1000,484,512,498,256,477,733
1000,511,503,488,253,493,746
1000,503,488,491,239,518,757
1000,509,496,508,255,510,765
1000,505,503,507,251,512,763
1000,503,524,496,261,491,752
1000,494,501,484,234,498,732
1000,510,487,501,250,520,770
1000,493,526,529,261,512,773
1000,485,527,514,250,488,738
1000,501,512,472,272,462,734
1000,488,498,506,239,514,753
1000,506,508,495,262,483,745
1000,513,529,476,264,489,753
1000,477,513,496,235,503,738
1000,514,510,512,271,503,774
1000,480,500,516,237,508,745
1000,486,502,507,244,511,755
1000,496,512,501,256,494,750
1000,547,503,489,270,497,767
1000,494,508,514,251,494,745
1000,529,516,500,280,480,760
1000,480,502,485,230,492,722
1000,492,501,521,252,506,758
1000,483,482,510,242,517,759
1000,527,515,478,263,494,757
1000,500,504,492,244,489,733
1000,494,517,515,265,497,762
1000,504,474,499,243,513,756
1000,500,504,520,257,510,767
1000,514,476,530,249,533,782
1000,513,531,497,279,471,750
1000,513,524,520,275,488,763
1000,502,484,519,265,490,755
1000,499,467,495,231,518,749
1000,508,505,519,267,478,745
1000,495,526,479,278,460,738
1000,512,479,508,242,514,756
1000,508,502,502,248,503,751
1000,502,508,490,254,498,752
1000,513,509,490,263,480,743
1000,487,506,490,241,481,722
1000,512,494,514,253,501,754
1000,498,520,514,261,489,750
1000,500,504,502,255,489,744
1000,489,514,504,262,480,742
1000,501,513,505,263,490,753
1000,501,500,487,252,502,754
1000,534,502,478,261,503,764
1000,496,509,494,245,502,747
1000,500,490,491,247,501,748
1000,512,507,495,269,485,754
1000,525,501,518,259,506,765
1000,515,485,493,250,525,775
1000,491,520,495,252,488,740
1000,514,508,514,265,490,755
1000,521,512,513,259,498,757
1000,491,475,491,232,507,739
1000,498,505,493,258,490,748
1000,502,528,516,272,485,757
1000,467,482,516,218,516,734
1000,484,495,491,239,495,734
1000,491,493,489,252,474,726
1000,496,503,517,259,488,747
1000,495,512,497,246,493,739
1000,509,496,474,258,485,743
1000,512,495,506,249,526,775
1000,493,508,526,257,503,760
1000,502,502,495,259,489,748
1000,504,506,517,255,505,760
1000,455,482,483,221,495,716
1000,500,519,489,263,477,740
1000,520,511,503,272,493,765
1000,505,486,522,228,538,766
1000,506,497,486,255,478,733
1000,526,505,472,270,478,748
1000,491,505,498,234,505,739
1000,513,509,508,259,509,768
1000,488,480,494,230,506,736
1000,501,483,493,243,515,758
1000,489,483,498,239,510,749
1000,504,475,470,233,509,742
1000,482,497,471,243,486,729
1000,507,499,485,260,464,724
1000,467,503,482,229,491,720
1000,479,484,487,244,490,734
1000,514,492,503,246,508,754
1000,481,516,519,233,529,762
1000,493,489,493,245,485,730
1000,523,505,515,263,511,774
1000,501,506,510,244,513,757
1000,475,491,476,261,471,732
1000,496,507,488,251,503,754
1000,489,510,500,251,500,751
1000,491,505,521,237,528,765
1000,502,496,492,242,494,736
1000,482,505,521,238,520,758
1000,464,520,510,249,477,726
1000,487,512,482,246,486,732
1000,484,507,507,247,505,752
1000,523,489,489,264,503,767
1000,478,484,500,236,491,727
1000,480,507,511,246,501,747
1000,506,510,511,251,511,762
1000,481,502,467,234,479,713
1000,483,497,510,239,505,744
1000,509,496,486,246,497,743
1000,489,502,487,260,487,747
1000,480,513,508,239,506,745
1000,501,482,523,227,529,756
1000,530,485,509,262,509,771
1000,502,513,498,269,483,752
1000,500,486,489,250,491,741
1000,482,509,493,240,502,742
1000,478,488,482,229,508,737
1000,489,491,509,245,505,750
1000,490,480,505,250,484,734
1000,503,493,493,249,498,747
1000,494,521,523,258,502,760
1000,510,544,500,277,472,749
1000,517,509,498,247,499,746
1000,519,511,493,275,482,757
1000,523,517,502,270,498,768
1000,493,511,497,256,492,748
1000,511,495,483,262,474,736
1000,499,502,521,254,516,770
1000,471,486,505,229,517,746
1000,495,490,495,232,516,748
1000,471,483,482,227,494,721
1000,504,492,488,255,506,761
1000,490,510,532,261,495,756
1000,497,494,535,242,535,777
1000,517,497,509,256,517,773
1000,505,497,512,258,510,768
1000,516,519,492,271,476,747
1000,511,495,509,255,495,750
1000,502,493,510,237,518,755
1000,533,488,512,261,502,763
1000,513,515,486,249,500,749
1000,515,506,511,248,521,769
1000,496,497,496,247,491,738
1000,502,509,526,244,522,766
1000,493,475,511,241,514,755
1000,505,517,520,249,502,751
1000,498,520,490,248,492,740
1000,518,493,507,245,516,761
1000,505,493,480,257,488,745
1000,507,464,481,229,522,751
1000,473,501,511,237,510,747
1000,484,520,500,261,482,743
1000,516,487,515,265,507,772
1000,483,510,531,244,521,765
1000,511,537,515,281,484,765
1000,492,526,485,264,475,739
1000,506,497,503,246,515,761
1000,515,488,503,256,506,762
1000,493,487,479,231,497,728
1000,485,504,486,233,505,738
1000,489,529,505,272,468,740
1000,506,507,517,255,512,767
1000,494,507,529,246,504,750
1000,501,505,476,235,507,742
1000,490,501,470,254,488,742
1000,509,533,514,262,504,766
1000,481,461,492,208,530,738
1000,487,490,494,235,495,730
1000,515,514,500,251,497,748
1000,528,533,503,284,490,774
1000,509,502,504,265,485,750
1000,509,518,504,281,468,749
1000,515,493,499,249,503,752
1000,502,471,479,227,503,730
1000,508,477,496,246,495,741
1000,497,496,477,242,484,726
1000,493,507,493,242,495,737
1000,501,518,491,248,507,755
1000,523,514,514,280,487,767
1000,497,511,501,268,488,756
1000,522,469,512,227,540,767
1000,505,479,523,246,527,773
1000,488,482,477,230,498,728
1000,480,491,514,242,508,750
1000,501,476,492,245,499,744
1000,497,502,515,250,509,759
1000,490,513,529,255,511,766
1000,495,485,526,235,524,759
1000,501,536,512,268,492,760
1000,502,509,513,242,507,749
1000,492,483,514,228,526,754
1000,461,515,498,236,494,730
1000,502,514,505,251,499,750
1000,510,478,514,246,527,773
1000,491,527,520,273,488,761
1000,525,484,532,241,538,779
1000,491,495,525,239,536,775
1000,471,494,526,228,507,735
1000,476,473,508,218,520,738
1000,507,524,506,276,486,762
1000,504,497,502,259,483,742
1000,503,506,465,261,475,736
1000,513,502,513,267,477,744
1000,479,524,527,255,499,754
1000,515,497,494,243,503,746
1000,513,498,527,254,519,773
1000,488,505,522,250,511,761
1000,524,493,495,252,498,750
1000,526,506,498,271,494,765
1000,518,494,499,249,518,767
1000,476,482,483,231,506,737
1000,526,498,488,263,493,756
1000,476,486,513,240,483,723
1000,487,484,527,228,535,763
1000,493,524,492,263,486,749
1000,495,493,494,254,495,749
1000,502,506,501,254,506,760
1000,507,521,490,279,477,756
1000,496,491,503,244,497,741
1000,503,499,522,260,500,760
1000,512,497,493,244,525,769
1000,497,523,489,251,488,739
1000,516,491,499,258,494,752
1000,531,478,473,246,513,759
1000,505,513,500,271,490,761
1000,499,465,478,242,507,749
1000,489,503,496,231,514,745
1000,511,491,501,256,505,761
1000,516,484,486,257,499,756
1000,504,498,482,255,488,743
1000,522,517,480,266,491,757
1000,502,486,489,250,502,752
1000,500,473,513,238,516,754
1000,511,503,473,253,491,744
1000,488,513,490,260,477,737
1000,496,500,514,262,492,754
1000,487,465,518,226,531,757
1000,479,507,478,252,476,728
1000,513,499,497,248,508,756
1000,482,481,480,237,501,738
1000,521,506,514,267,518,785
1000,498,479,523,233,525,758
1000,479,489,522,228,512,740
1000,507,515,512,262,491,753
1000,482,508,533,253,504,757
1000,476,485,484,228,510,738
1000,483,500,527,238,515,753
1000,499,502,476,263,466,729
1000,507,520,543,263,515,778
1000,487,488,508,240,511,751
1000,510,509,502,276,477,753
1000,525,521,529,275,509,784
1000,499,485,500,227,531,758
1000,507,486,506,249,515,764
1000,475,499,478,233,480,713
1000,517,493,528,248,515,763
1000,498,501,513,270,479,749
1000,525,485,514,255,520,775
1000,538,523,507,277,498,775
1000,500,517,497,259,486,745
1000,489,501,502,247,503,750
1000,525,491,494,264,490,754
1000,492,512,505,255,494,749
1000,518,476,483,236,522,758
1000,510,503,505,256,510,766
1000,518,514,486,267,494,761
1000,473,495,513,242,509,751
1000,521,501,517,238,531,769
1000,493,497,510,249,508,757
1000,494,471,506,241,506,747
1000,511,475,469,243,496,739
1000,491,503,518,240,513,753
1000,524,478,484,262,485,747
1000,482,526,482,255,472,727
1000,503,487,500,244,504,748
1000,515,506,511,255,502,757
1000,518,504,469,273,470,743
1000,527,496,471,267,474,741
1000,493,478,512,236,509,745
1000,478,489,519,239,507,746
1000,488,507,514,248,509,757
1000,518,502,524,237,533,770
1000,494,471,500,243,517,760
1000,481,490,499,241,522,763
1000,504,501,505,254,511,765
1000,492,486,524,234,529,763
1000,476,476,499,222,517,739
1000,472,505,477,248,475,723
1000,504,510,485,246,513,759
1000,493,495,510,250,503,753
1000,495,504,494,249,494,743
1000,511,484,468,235,516,751
1000,508,476,489,247,503,750
1000,509,503,504,259,498,757
1000,521,498,488,253,507,760
1000,502,465,490,237,506,743
1000,478,505,511,249,506,755
1000,509,489,515,240,510,750
1000,501,521,488,263,484,747
1000,518,534,517,272,494,766
1000,501,475,511,236,522,758
1000,487,487,486,232,500,732
1000,504,501,532,266,499,765
1000,515,513,504,267,491,758
1000,504,489,468,245,485,730
1000,504,511,524,253,504,757
1000,485,498,490,245,494,739
1000,490,476,511,216,541,757
1000,485,487,499,217,516,733
1000,511,498,509,242,521,763
1000,508,489,478,242,497,739
1000,494,514,511,265,499,764
1000,515,486,515,249,534,783
1000,503,499,514,254,508,762
1000,511,483,498,251,490,741
1000,484,490,490,238,495,733
1000,503,510,508,242,520,762
1000,503,509,512,237,506,743
1000,515,513,479,257,503,760
1000,483,499,525,246,514,760
1000,514,475,515,236,518,754
1000,467,523,500,253,488,741
1000,469,493,508,238,510,748
1000,526,481,527,241,529,770
1000,490,529,478,259,463,722
1000,512,500,501,246,504,750
1000,491,455,491,213,526,739
1000,489,490,521,240,511,751
1000,512,468,500,241,510,751
1000,502,517,507,262,509,771
1000,473,490,494,234,486,720
1000,471,499,483,236,484,720
1000,513,476,498,245,510,755
1000,486,485,500,239,505,744
1000,513,485,500,258,486,744
1000,495,516,481,256,470,726
1000,529,531,488,282,473,755
1000,484,507,475,241,498,739
1000,505,515,502,242,510,752
1000,515,498,507,256,513,769
1000,502,525,501,268,494,762
1000,518,485,487,259,497,756
1000,517,477,506,242,511,753
1000,484,489,509,248,496,744
1000,506,505,493,244,526,770
1000,508,493,493,263,483,746
1000,486,496,478,232,502,734
1000,496,524,479,244,501,745
1000,511,498,504,235,532,767
1000,511,497,498,284,469,753
1000,497,500,500,247,498,745
1000,489,496,470,250,477,727
1000,508,505,467,252,482,734
1000,498,486,495,253,499,752
1000,489,494,491,237,503,740
1000,501,492,504,243,506,749
1000,497,494,511,257,490,747
1000,500,493,484,249,487,736
1000,500,490,491,246,509,755
1000,508,534,510,281,465,746
1000,496,514,502,258,486,744
1000,515,494,488,246,500,746
1000,518,489,511,263,490,753
1000,483,496,496,243,505,748
1000,484,497,505,230,515,745
1000,481,515,523,250,510,760
1000,504,483,492,254,492,746
1000,496,500,511,236,532,768
1000,475,497,508,255,488,743
1000,501,502,513,255,506,761
1000,500,512,467,244,491,735
1000,509,496,476,253,483,736
1000,539,496,501,271,495,766
1000,537,522,528,284,496,780
1000,522,500,500,256,518,774
1000,484,505,476,240,491,731
1000,518,489,478,234,523,757
1000,507,477,509,241,524,765
1000,512,517,493,268,497,765
1000,525,524,510,290,474,764
1000,498,497,522,242,527,769
1000,491,499,508,233,510,743
1000,506,481,480,236,507,743
1000,510,493,481,251,490,741
1000,510,474,486,244,508,752
1000,510,494,494,259,485,744
1000,484,507,490,243,490,733
1000,491,513,497,255,502,757
1000,522,508,492,260,495,755
1000,507,471,523,232,528,760
1000,530,501,523,268,515,783
1000,499,494,527,237,516,753
1000,514,483,510,242,523,765
1000,507,519,490,263,488,751
1000,522,470,468,258,469,727
1000,478,482,512,225,517,742
1000,502,520,505,253,503,756
1000,494,494,476,253,480,733
1000,517,520,471,268,489,757
1000,481,498,533,237,533,770
1000,494,507,488,257,486,743
1000,504,531,504,265,480,745
1000,513,517,475,250,495,745
1000,503,492,514,239,511,750
1000,488,534,492,269,471,740
1000,509,508,498,262,490,752
1000,528,507,498,266,514,780
1000,496,505,476,252,493,745
1000,479,514,497,242,490,732
1000,507,507,500,246,497,743
1000,506,529,515,262,507,769
1000,498,497,489,257,498,755
1000,459,479,481,207,517,724
1000,504,486,526,231,528,759
1000,515,485,498,237,506,743
1000,478,511,504,246,509,755
1000,494,513,491,259,479,738
1000,514,496,481,254,484,738
1000,522,514,530,272,505,777
1000,528,478,499,262,496,758
1000,529,512,471,287,470,757
1000,494,486,480,236,491,727
1000,514,491,518,257,505,762
1000,480,490,497,250,492,742
1000,488,495,488,236,494,730
1000,500,491,507,255,503,758
1000,518,520,511,264,511,775
1000,513,517,501,269,490,759
1000,494,517,474,256,485,741
1000,499,523,493,251,500,751
1000,522,501,504,256,500,756
1000,493,481,480,244,493,737
1000,484,488,514,230,524,754
1000,473,524,505,244,500,744
1000,472,495,489,226,500,726
1000,485,507,498,249,481,730
1000,474,477,482,214,512,726
1000,506,514,505,257,491,748
1000,506,503,464,243,502,745
1000,491,497,514,240,513,753
1000,503,499,492,252,483,735
1000,524,523,498,288,468,756
1000,492,524,503,264,482,746
1000,525,502,504,259,507,766
1000,506,539,502,264,494,758
1000,503,486,511,230,536,766
1000,513,530,510,278,479,757
1000,497,489,509,253,498,751
1000,511,518,499,283,470,753
1000,493,511,494,249,499,748
1000,492,515,470,248,476,724
1000,509,475,500,249,493,742
1000,507,499,467,252,486,738
1000,492,475,497,223,520,743
1000,496,488,510,243,506,749
1000,465,505,522,245,490,735
1000,509,485,494,249,511,760
1000,495,511,519,261,502,763
1000,501,502,475,249,490,739
1000,517,498,504,254,508,762
1000,483,498,517,250,498,748
1000,494,485,513,235,518,753
1000,485,506,508,250,489,739
1000,500,500,497,265,493,758
1000,504,534,493,255,494,749
1000,524,492,482,265,500,765
1000,485,490,499,243,495,738
1000,518,489,493,258,512,770
1000,462,524,500,252,484,736
1000,510,483,499,264,497,761
1000,500,493,494,249,518,767
1000,498,498,500,239,509,748
1000,508,511,505,256,488,744
1000,511,445,527,229,545,774
1000,495,500,490,237,515,752
1000,504,509,463,238,489,727
1000,522,507,487,251,505,756
1000,481,483,504,237,496,733
1000,505,487,484,240,513,753
1000,507,496,512,251,514,765
1000,499,495,491,251,499,750
1000,475,506,495,238,501,739
1000,494,497,481,247,482,729
1000,499,523,506,270,477,747
1000,492,512,512,259,488,747
1000,442,517,493,237,481,718
1000,510,471,507,251,515,766
1000,504,505,490,249,507,756
1000,502,489,522,237,523,760
1000,469,521,499,246,483,729
1000,490,508,522,245,511,756
1000,485,486,522,237,516,753
1000,518,516,496,270,486,756
1000,494,480,515,231,516,747
1000,503,484,487,237,518,755
1000,507,512,501,252,501,753
1000,493,495,480,231,505,736
1000,495,476,475,240,493,733
1000,491,496,499,239,507,746
1000,490,479,493,236,517,753
1000,502,516,496,253,490,743
1000,502,512,491,255,490,745
1000,479,473,489,233,495,728
1000,521,504,506,260,509,769
1000,497,522,526,259,505,764
1000,491,495,506,241,510,751
1000,526,501,498,259,500,759
1000,511,490,488,250,498,748
1000,517,488,543,251,522,773
1000,505,516,479,271,474,745
1000,483,488,497,236,510,746
1000,474,509,502,244,497,741
1000,529,464,488,241,511,752
1000,519,490,515,249,517,766
1000,482,499,520,241,515,756
1000,503,479,494,241,509,750
1000,495,491,522,228,540,768
1000,481,498,479,232,492,724
1000,525,496,501,269,490,759
1000,503,531,511,259,493,752
1000,520,534,492,272,470,742
1000,507,513,505,248,499,747
1000,507,504,510,266,496,762
1000,503,527,520,259,497,756
1000,490,497,492,246,500,746
1000,500,494,545,249,512,761
1000,489,511,498,269,485,754
1000,488,476,480,227,510,737
1000,504,520,504,251,503,754
1000,490,510,509,252,503,755
1000,488,490,512,245,499,744
1000,483,479,529,246,504,750
1000,513,493,522,255,506,761
1000,517,533,496,274,485,759
1000,482,500,526,250,501,751
1000,487,515,498,245,500,745
1000,495,509,503,254,490,744
1000,503,499,494,270,466,736
1000,513,469,507,244,529,773
1000,502,498,497,234,508,742
1000,502,495,504,243,513,756
1000,490,495,503,253,497,750
1000,484,493,481,252,483,735
1000,486,498,509,247,491,738
1000,497,498,500,248,504,752
1000,512,530,481,275,477,752
1000,513,512,505,248,520,768
1000,496,526,502,265,496,761
1000,494,518,498,249,505,754
1000,480,492,492,240,494,734
1000,500,514,534,252,502,754
1000,479,497,509,232,514,746
1000,498,502,520,252,509,761
1000,496,482,486,229,497,726
1000,471,507,515,251,496,747
1000,517,518,496,270,478,748
1000,498,478,478,238,510,748
1000,490,522,501,258,489,747
1000,486,483,511,241,498,739
1000,477,491,483,219,511,730
1000,491,495,549,226,544,770
1000,510,502,501,256,512,768
1000,489,519,508,250,493,743
1000,499,498,512,249,512,761
1000,497,529,501,282,476,758
1000,525,488,507,231,535,766
1000,504,492,535,241,535,776
1000,495,512,482,244,481,725
1000,501,521,500,253,504,757
1000,504,492,507,247,508,755
1000,460,497,522,232,494,726
1000,488,512,495,247,501,748
1000,494,505,489,250,490,740
1000,501,480,452,240,476,716
1000,535,476,485,253,509,762
1000,515,511,495,273,483,756
1000,488,490,541,250,509,759
1000,519,508,491,264,489,753
1000,494,565,491,278,464,742
1000,471,518,498,248,481,729
1000,507,501,475,251,497,748
1000,504,464,512,235,515,750
1000,490,496,478,236,509,745
1000,472,515,502,233,498,731
1000,509,502,510,241,512,753
1000,521,515,490,276,476,752
1000,523,474,529,242,530,772
1000,506,498,542,246,531,777
1000,489,495,482,233,513,746
1000,502,506,500,246,508,754
1000,472,505,533,233,522,755
1000,518,506,494,254,502,756
1000,488,490,519,236,518,754
1000,513,485,507,237,522,759
1000,493,478,527,233,535,768
1000,515,522,517,266,504,770
1000,498,502,473,247,490,737
1000,498,497,502,237,514,751
1000,515,477,488,247,502,749
1000,460,510,501,237,498,735
1000,524,508,529,256,512,768
1000,440,500,526,220,523,743
1000,488,503,482,241,502,743
1000,495,486,523,237,530,767
1000,517,502,527,265,509,774
1000,543,497,540,260,534,794
1000,535,502,486,268,489,757
1000,492,522,502,256,493,749
1000,494,521,492,238,517,755
1000,515,462,503,229,520,749
1000,500,511,505,248,507,755
1000,507,504,517,253,516,769
1000,510,481,491,240,517,757
1000,492,521,520,262,505,767
1000,496,499,474,243,491,734
1000,477,515,504,233,504,737
1000,505,518,495,256,502,758
1000,491,496,486,236,519,755
1000,513,504,483,239,521,760
1000,470,486,496,239,479,718
1000,504,490,489,240,506,746
1000,507,507,497,245,504,749
1000,486,486,487,238,490,728
1000,486,508,501,239,507,746
1000,474,506,492,232,497,729
1000,481,504,514,250,497,747
1000,497,516,503,266,485,751
1000,505,503,489,260,496,756
1000,507,482,501,256,515,771
1000,500,486,515,243,502,745
1000,506,486,488,233,516,749
1000,505,488,498,242,501,743
1000,503,492,497,241,507,748
1000,479,489,497,240,508,748
1000,472,508,501,242,492,734
1000,501,491,532,240,519,759
1000,512,491,487,245,508,753
1000,496,513,483,254,490,744
1000,478,495,506,233,522,755
1000,522,475,498,252,513,765
1000,477,521,492,261,491,752
1000,498,503,474,244,490,734
1000,514,495,491,248,506,754
1000,495,518,548,252,519,771
1000,502,500,487,246,501,747
1000,466,479,489,214,508,722
1000,532,501,501,257,527,784
1000,501,487,506,241,509,750
1000,489,478,485,234,503,737
1000,537,527,514,273,487,760
1000,518,524,495,277,483,760
1000,492,480,507,242,490,732
1000,478,497,496,242,496,738
1000,482,510,512,248,510,758
1000,481,492,499,231,504,735
1000,512,472,512,245,520,765
1000,501,500,512,267,488,755
1000,515,493,530,250,516,766
1000,511,483,498,264,488,752
1000,500,493,487,246,506,752
1000,506,492,516,241,522,763
1000,514,492,449,247,495,742
1000,491,502,498,240,501,741
1000,482,489,506,230,516,746
1000,502,516,512,260,504,764
1000,473,473,509,219,518,737
1000,482,490,498,244,494,738
1000,494,497,514,245,505,750
1000,489,525,520,257,522,779
1000,538,498,463,268,482,750
1000,510,480,462,233,524,757
1000,505,500,528,251,529,780
1000,489,504,484,265,476,741
1000,499,494,516,264,494,758
1000,489,498,496,252,484,736
1000,508,488,480,247,487,734
1000,497,495,503,259,494,753
1000,503,485,483,238,498,736
1000,520,524,493,265,497,762
1000,502,483,497,244,503,747
1000,496,474,537,236,535,771
1000,529,486,498,245,518,763
1000,488,507,492,259,475,734
1000,504,499,489,253,506,759
1000,499,498,493,250,504,754
1000,485,496,487,257,484,741
1000,513,514,494,256,508,764
1000,503,536,504,267,491,758
1000,487,487,515,244,516,760
1000,507,536,499,278,480,758
1000,489,461,512,226,528,754
1000,479,517,510,251,498,749
1000,502,507,476,239,491,730
1000,510,489,508,240,524,764
1000,508,499,493,265,483,748
1000,491,499,500,243,498,741
1000,506,471,483,236,498,734
1000,516,485,496,249,511,760
1000,501,486,516,235,526,761
1000,507,513,482,264,483,747
1000,491,508,506,256,499,755
1000,491,500,475,237,492,729
1000,511,481,511,235,536,771
1000,499,500,504,252,512,764
1000,498,520,497,250,489,739
1000,529,508,516,274,504,778
1000,494,505,508,241,520,761
1000,507,510,476,260,471,731
1000,491,493,528,253,496,749
1000,507,499,476,247,493,740
1000,508,504,487,252,487,739
1000,504,477,499,241,516,757
1000,510,527,487,265,487,752
1000,496,476,524,254,503,757
1000,512,502,501,247,502,749
1000,492,482,506,233,520,753
1000,489,474,513,234,503,737
1000,451,514,486,227,475,702
1000,500,491,476,246,500,746
1000,499,499,500,238,510,748
1000,450,500,531,227,502,729
1000,503,468,518,227,525,752
1000,495,518,514,259,489,748
1000,495,490,507,248,495,743
1000,481,495,483,240,486,726
1000,503,502,498,244,497,741
1000,476,455,501,210,524,734
1000,511,506,466,268,484,752
1000,483,471,501,234,515,749
1000,512,499,501,270,494,764
1000,500,495,505,256,509,765
1000,514,504,528,275,502,777
1000,487,499,497,245,498,743
1000,531,492,490,271,495,766
1000,478,500,509,225,509,734
1000,506,506,502,258,497,755
1000,484,522,489,263,468,731
1000,472,489,484,226,504,730
1000,498,510,503,252,482,734
1000,488,512,498,252,492,744
1000,496,516,491,242,502,744
1000,479,514,507,244,504,748
1000,520,487,483,253,492,745
1000,520,478,497,249,514,763
1000,506,480,506,246,500,746
1000,510,532,500,284,489,773
1000,492,522,498,254,490,744
1000,503,511,517,251,510,761
1000,462,521,484,256,475,731
1000,504,489,530,242,525,767
1000,497,508,508,258,493,751
1000,501,494,516,245,518,763
1000,518,492,510,254,518,772
1000,502,518,503,257,497,754
1000,496,522,488,268,476,744
1000,499,466,504,214,524,738
1000,465,496,496,246,495,741
1000,512,520,525,274,486,760
1000,470,493,516,240,494,734
1000,520,491,492,259,510,769
1000,491,505,488,247,496,743
1000,486,483,505,239,515,754
1000,517,491,494,255,488,743
1000,511,481,472,257,487,744
1000,504,507,495,267,481,748
1000,493,503,520,247,508,755
1000,471,482,480,224,504,728
1000,482,480,495,237,507,744
1000,511,502,496,263,496,759
1000,502,475,485,240,501,741
1000,485,507,536,246,513,759
1000,492,516,488,257,488,745
1000,523,514,513,281,499,780
1000,478,472,509,229,509,738
1000,523,510,540,271,507,778
1000,495,520,505,259,495,754
1000,507,496,467,256,467,723
1000,502,506,505,257,507,764
1000,511,521,511,256,507,763
1000,533,480,497,252,519,771
1000,509,505,535,264,503,767
1000,486,484,501,236,507,743
1000,494,513,478,253,476,729
1000,512,493,509,249,519,768
1000,507,480,503,249,493,742
1000,479,484,517,238,498,736
1000,508,447,524,234,540,774
1000,493,508,508,245,500,745
1000,513,514,476,257,481,738
1000,508,488,495,237,516,753
1000,501,520,482,257,491,748
1000,506,515,510,277,490,767
1000,506,502,466,240,485,725
1000,504,499,493,263,481,744
1000,502,481,493,251,503,754
1000,506,512,513,255,495,750
1000,512,486,487,257,486,743
1000,518,503,507,254,517,771
1000,496,485,467,242,479,721
1000,521,460,500,257,502,759
1000,502,500,500,244,500,744
1000,495,488,537,240,535,775
1000,499,490,487,256,484,740
1000,502,513,477,265,479,744
1000,483,511,503,247,498,745
1000,530,494,484,266,491,757
1000,493,510,469,248,484,732
1000,507,498,487,253,493,746
1000,539,512,518,268,508,776
1000,499,514,465,261,474,735
1000,489,505,471,246,480,726
1000,479,509,517,230,521,751
1000,493,521,506,253,497,750
1000,503,472,500,252,500,752
1000,513,485,514,249,513,762
1000,497,513,501,267,475,742
1000,518,493,515,246,520,766
1000,482,519,538,256,503,759
1000,484,499,486,240,500,740
1000,514,521,517,263,522,785
1000,494,480,506,246,502,748
1000,514,502,533,256,522,778
1000,483,472,488,237,504,741
1000,513,514,503,271,492,763
1000,497,513,496,260,494,754
1000,486,492,494,245,500,745
1000,488,503,500,240,515,755
1000,511,503,477,263,482,745
1000,511,522,486,271,487,758
1000,484,524,511,253,506,759
1000,497,493,495,237,511,748
1000,510,490,511,251,511,762
1000,480,520,494,244,492,736
1000,510,469,493,240,511,751
1000,508,496,478,253,485,738
1000,507,482,476,252,488,740
1000,511,511,498,252,495,747
1000,507,511,513,257,494,751
1000,503,496,517,239,513,752
1000,517,507,506,247,527,774
1000,501,530,482,253,488,741
1000,515,519,493,261,495,756
1000,515,517,475,276,475,751
1000,446,484,505,227,494,721
1000,500,519,497,262,491,753
1000,506,471,505,234,524,758
1000,509,505,477,265,479,744
1000,496,492,490,247,480,727
1000,496,505,505,260,491,751
1000,487,491,498,237,507,744
1000,485,502,490,236,508,744
1000,476,497,512,237,504,741
1000,466,503,477,226,478,704
1000,499,494,496,242,494,736
1000,506,500,530,245,534,779
1000,530,505,499,274,493,767
1000,512,516,499,274,481,755
1000,503,505,527,255,505,760
1000,471,527,476,242,481,723
1000,481,491,528,224,512,736
1000,491,482,513,232,528,760
1000,494,491,461,240,485,725
1000,491,504,515,248,499,747
1000,518,518,524,270,500,770
1000,496,480,475,235,499,734
1000,516,495,495,253,501,754
1000,514,501,499,247,510,757
1000,496,516,516,248,506,754
1000,499,519,507,253,506,759
1000,517,505,503,255,496,751
1000,489,511,489,246,501,747
1000,486,498,518,243,503,746
1000,489,527,482,253,473,726
1000,520,538,481,270,477,747
1000,505,490,515,246,509,755
1000,490,515,508,262,474,736
1000,485,500,481,243,509,752
1000,509,516,532,258,507,765
1000,496,506,491,261,473,734
1000,499,509,478,255,480,735
1000,510,522,495,264,488,752
1000,515,474,516,249,527,776
1000,472,497,522,237,514,751
1000,465,480,495,227,504,731
1000,486,494,510,244,502,746
1000,511,456,491,230,513,743
1000,507,483,521,244,525,769
1000,503,515,488,272,467,739
1000,515,507,494,264,495,759
1000,492,471,518,225,525,750
1000,497,508,502,261,494,755
1000,509,496,503,258,497,755
1000,489,499,518,249,508,757
1000,512,502,510,257,507,764
1000,510,524,496,267,496,763
1000,529,522,491,267,484,751
1000,483,518,474,239,488,727
1000,494,485,481,237,506,743
1000,478,511,482,243,479,722
1000,508,490,524,244,523,767
1000,502,518,492,256,491,747
1000,502,517,495,251,490,741
1000,531,507,509,279,498,777
1000,508,512,519,268,493,761
1000,475,501,492,234,498,732
1000,486,482,506,212,547,759
1000,500,511,490,254,485,739
1000,470,509,505,233,510,743
1000,512,519,512,263,494,757
1000,481,506,507,244,509,753
1000,491,502,527,241,522,763
1000,508,488,507,255,510,765
1000,474,504,526,243,502,745
1000,492,521,495,258,478,736
1000,502,508,484,260,485,745
1000,512,505,518,262,507,769
1000,516,498,521,257,518,775
1000,474,508,502,230,500,730
1000,500,485,498,246,502,748
1000,502,500,515,253,528,781
1000,503,488,521,250,517,767
1000,511,498,482,236,513,749
1000,477,491,493,237,495,732
1000,507,491,504,248,520,768
1000,541,499,519,274,517,791
1000,497,485,481,245,492,737
1000,491,492,507,234,509,743
1000,479,513,480,257,459,716
1000,502,520,476,262,468,730
1000,524,522,510,269,497,766
1000,522,497,520,254,509,763
1000,483,488,507,226,515,741
1000,519,546,492,276,488,764
1000,501,509,480,266,474,740
1000,514,517,518,274,490,764
1000,480,505,460,229,483,712
1000,473,500,507,228,519,747
1000,505,443,478,225,512,737
1000,494,525,503,261,477,738
1000,496,501,489,248,493,741
1000,491,481,499,238,520,758
1000,503,524,493,261,494,755
1000,516,494,500,257,508,765
1000,497,489,519,242,514,756
1000,512,485,487,241,497,738
1000,483,524,518,246,502,748
1000,553,518,489,284,497,781
1000,511,479,482,243,499,742
1000,483,499,490,252,492,744
1000,492,517,523,252,497,749
1000,525,508,510,262,512,774
1000,496,507,521,253,510,763
1000,505,484,496,239,521,760
1000,508,495,488,256,492,748
1000,484,504,511,256,484,740
1000,520,504,477,271,485,756
1000,493,512,488,243,509,752
1000,520,510,493,259,495,754
1000,483,508,488,247,481,728
1000,515,504,494,254,498,752
1000,517,506,498,266,495,761
1000,511,499,501,259,485,744
1000,495,512,502,243,511,754
1000,514,497,503,264,484,748
1000,497,506,492,253,489,742
1000,518,511,490,251,497,748
1000,507,522,521,261,515,776
1000,491,494,527,239,520,759
1000,504,505,489,242,513,755
1000,489,519,518,266,484,750
1000,517,490,485,242,515,757
1000,517,516,507,281,495,776
1000,477,485,509,230,516,746
1000,493,491,509,233,516,749
1000,476,510,490,232,500,732
1000,512,509,483,262,486,748
1000,506,495,505,254,504,758
1000,502,510,502,257,493,750
1000,520,492,524,250,528,778
1000,517,496,515,259,511,770
1000,512,487,481,236,509,745
1000,470,506,506,223,513,736
1000,489,490,470,234,490,724
1000,514,502,493,247,507,754
1000,507,499,478,248,491,739
1000,505,494,497,258,498,756
1000,491,530,485,257,479,736
1000,513,486,527,245,528,773
1000,523,516,470,262,480,742
1000,500,495,526,248,505,753
1000,513,487,490,251,500,751
1000,503,504,504,256,486,742
1000,498,505,507,243,512,755
1000,500,505,503,251,493,744
1000,518,516,518,267,501,768
1000,483,502,494,257,489,746
1000,507,481,498,241,511,752
1000,504,511,515,264,508,772
1000,487,507,479,240,503,743
1000,524,478,481,253,513,766
1000,535,530,530,289,504,793
1000,506,510,501,255,499,754
1000,517,483,472,258,484,742
1000,512,492,476,261,498,759
1000,535,506,510,271,498,769
1000,524,523,507,267,495,762
1000,522,501,507,254,505,759
1000,502,494,492,248,508,756
1000,497,520,487,251,495,746
1000,478,475,512,234,508,742
1000,500,494,510,248,513,761
1000,523,507,517,269,506,775
1000,505,498,501,251,501,752
1000,492,511,521,246,518,764
1000,479,501,468,260,461,721
1000,519,502,478,254,491,745
1000,533,468,503,265,516,781
1000,489,494,499,231,522,753
1000,500,506,509,255,503,758
1000,493,509,482,250,485,735
1000,519,494,503,256,499,755
1000,521,484,488,249,500,749
1000,528,517,488,278,470,748
1000,481,509,537,249,508,757
1000,515,498,494,258,490,748
1000,482,477,495,219,511,730
1000,479,477,452,237,481,718
1000,519,484,500,255,502,757
1000,516,488,505,247,500,747
1000,510,497,472,264,468,732
1000,503,491,499,231,520,751
1000,516,486,524,240,545,785
1000,496,539,484,283,454,737
1000,511,505,506,254,488,742
1000,483,527,472,257,474,731
1000,491,510,489,245,497,742
1000,501,503,502,263,487,750
1000,515,505,505,257,509,766
1000,503,516,527,250,503,753
1000,515,485,485,259,483,742
1000,471,520,497,243,499,742
1000,497,507,494,245,498,743
1000,521,489,483,253,497,750
1000,514,526,526,267,508,775
1000,480,489,510,226,531,757
1000,505,500,485,260,498,758
1000,520,524,475,278,455,733
1000,481,468,503,214,527,741
1000,510,500,492,257,499,756
1000,486,482,504,225,516,741
1000,512,503,503,254,497,751
1000,493,498,487,251,486,737
1000,516,506,486,251,494,745
1000,488,520,494,251,495,746
1000,519,494,515,261,512,773
1000,516,507,495,276,493,769
1000,499,512,484,249,494,743
1000,515,499,481,266,488,754
1000,514,492,504,244,510,754
1000,472,483,501,239,511,750
1000,468,500,500,218,517,735
1000,507,499,500,235,512,747
1000,503,520,491,258,501,759
1000,474,512,503,224,513,737
1000,531,487,526,267,518,785
1000,521,502,498,264,487,751
1000,487,509,487,248,488,736
1000,492,513,496,236,508,744
1000,501,497,483,251,494,745
1000,490,494,522,239,522,761
1000,528,490,490,263,494,757
1000,467,477,495,210,508,718
1000,500,521,513,259,499,758
1000,518,496,506,261,504,765
1000,528,497,482,257,508,765
1000,503,481,511,242,504,746
1000,521,516,516,277,479,756
1000,505,499,534,251,500,751
1000,514,491,495,241,510,751
1000,504,481,495,237,517,754
1000,505,523,495,260,486,746
1000,514,520,481,259,477,736
1000,491,514,507,253,488,741
1000,483,504,504,251,492,743
1000,520,487,506,258,511,769
1000,498,495,502,245,514,759
1000,487,491,501,237,510,747
1000,502,495,511,257,501,758
1000,497,505,497,250,509,759
1000,513,517,517,266,505,771
1000,474,473,502,221,527,748
1000,498,508,483,250,492,742
1000,492,518,484,263,474,737
1000,512,500,495,254,513,767
1000,491,516,489,249,500,749
1000,497,516,507,258,492,750
1000,517,497,499,264,510,774
1000,471,508,520,247,494,741
1000,508,495,530,253,517,770
1000,520,484,489,255,506,761
1000,496,540,485,256,476,732
1000,507,498,515,261,506,767
1000,488,492,514,234,526,760
1000,520,501,497,258,494,752
1000,492,485,482,243,497,740
1000,481,495,468,228,490,718
1000,478,480,496,220,510,730
1000,515,498,494,264,491,755
1000,523,486,534,258,526,784
1000,495,461,518,226,520,746
1000,465,517,490,245,468,713
1000,477,482,485,244,487,731
1000,509,511,488,254,492,746
1000,500,523,507,274,482,756
1000,509,501,520,263,502,765
1000,485,494,509,225,519,744
1000,491,489,490,228,514,742
1000,484,534,490,267,466,733
1000,494,512,501,251,485,736
1000,512,497,485,258,502,760
1000,497,501,481,248,494,742
1000,519,508,510,255,504,759
1000,519,503,482,261,494,755
1000,510,480,523,239,526,765
1000,500,510,477,263,464,727
1000,474,490,537,233,519,752
1000,484,478,466,238,489,727
1000,493,509,489,255,484,739
1000,481,464,471,210,502,712
1000,511,495,467,241,500,741
1000,490,503,519,252,496,748
1000,469,495,485,226,503,729
1000,522,523,521,271,492,763
1000,507,503,496,248,512,760
1000,505,475,494,229,509,738
1000,494,489,520,245,517,762
1000,498,516,490,266,472,738
1000,526,499,514,265,492,757
1000,489,503,485,246,493,739
1000,503,492,523,240,508,748
1000,488,507,512,244,499,743
1000,489,516,504,253,487,740
1000,510,530,503,266,486,752
1000,513,504,488,254,488,742
1000,497,523,495,256,493,749
1000,505,483,533,245,500,745
1000,522,488,477,227,525,752
1000,496,492,508,244,518,762
1000,494,503,499,269,484,753
1000,499,502,505,251,499,750
1000,505,498,501,257,520,777
1000,505,512,478,266,467,733
1000,492,501,499,248,490,738
1000,492,514,510,273,478,751
1000,512,496,526,251,510,761
1000,487,496,508,241,502,743
1000,497,508,493,250,499,749
1000,514,510,482,260,506,766
1000,478,513,507,257,477,734
1000,531,508,499,282,491,773
1000,494,481,524,242,514,756
1000,500,509,497,253,496,749
1000,517,516,507,278,477,755
1000,492,510,516,261,491,752
1000,520,514,524,269,503,772
1000,513,501,490,257,484,741
1000,484,515,517,244,515,759
1000,480,490,490,226,516,742
1000,499,503,501,245,515,760
1000,523,483,491,247,518,765
1000,484,511,490,247,503,750
1000,517,475,475,244,503,747
1000,515,521,482,284,453,737
1000,503,497,492,257,495,752
1000,499,500,497,253,497,750
1000,502,514,488,273,464,737
1000,505,527,514,262,495,757
1000,519,525,511,279,481,760
1000,518,504,498,268,484,752
1000,477,506,533,234,519,753
1000,498,503,472,249,482,731
1000,492,495,529,243,512,755
1000,513,479,529,247,535,782
1000,492,480,499,240,508,748
1000,510,514,492,262,482,744
1000,486,522,476,262,461,723
1000,505,508,503,257,488,745
1000,504,479,521,251,520,771
1000,484,486,482,241,495,736
1000,513,480,517,237,535,772
1000,484,506,519,253,515,768
1000,518,537,462,284,447,731
1000,490,496,499,237,513,750
1000,492,509,487,251,498,749
1000,502,479,513,255,494,749
1000,492,520,532,262,508,770
1000,515,533,491,283,477,760
1000,509,516,496,261,500,761
1000,486,485,484,240,492,732
1000,503,528,498,263,480,743
1000,495,466,487,236,504,740
1000,491,492,519,253,493,746
1000,535,505,517,262,515,777
1000,493,512,505,256,492,748
1000,509,511,492,247,499,746
1000,502,490,532,245,525,770
1000,505,499,494,254,492,746
1000,475,482,483,217,515,732
1000,524,491,523,269,512,781
1000,501,487,491,243,504,747
1000,503,524,519,274,496,770
1000,504,484,461,237,509,746
1000,493,484,488,233,510,743
1000,492,507,499,255,481,736
1000,491,504,488,247,477,724
1000,501,488,529,250,525,775
1000,492,518,485,258,476,734
1000,490,496,493,248,491,739
1000,494,489,486,248,492,740
1000,507,481,505,251,504,755
1000,484,495,492,239,507,746
1000,510,505,528,262,497,759
1000,496,502,511,242,512,754
1000,523,501,478,265,473,738
1000,501,493,509,257,477,734
1000,477,493,491,232,498,730
1000,498,518,511,244,509,753
1000,517,498,492,252,499,751
1000,475,483,518,230,517,747
1000,482,500,490,250,476,726
1000,496,497,499,243,494,737
1000,493,511,508,256,501,757
1000,500,516,520,264,489,753
1000,521,485,488,261,486,747
1000,512,512,492,259,482,741
1000,514,491,515,263,496,759
1000,521,508,478,260,493,753
1000,491,465,486,239,490,729
1000,534,501,509,268,494,762
1000,491,474,513,234,525,759
1000,483,469,532,241,499,740
1000,488,480,489,238,492,730
1000,487,522,495,264,470,734
1000,490,470,528,240,525,765
1000,495,527,487,259,486,745
1000,494,503,523,247,512,759
1000,489,527,519,252,508,760
1000,486,474,458,233,477,710
1000,496,507,483,261,480,741
1000,528,516,485,272,479,751
1000,478,512,511,253,485,738
1000,518,497,484,262,498,760
1000,476,485,493,242,482,724
1000,495,490,474,241,492,733
1000,484,483,487,234,498,732
1000,507,507,479,257,483,740
1000,501,521,486,254,494,748
1000,495,509,501,246,514,760
1000,515,478,526,242,535,777
1000,522,504,517,265,510,775
1000,518,503,487,263,484,747
1000,507,480,521,240,533,773
1000,501,518,494,255,486,741
1000,505,488,532,249,520,769
1000,512,490,493,258,507,765
1000,496,487,501,243,501,744
1000,520,527,477,293,460,753
1000,516,486,498,259,493,752
1000,472,516,482,253,474,727
1000,500,513,489,259,486,745
1000,505,491,519,245,515,760
1000,507,490,513,246,514,760
1000,522,490,497,263,496,759
1000,505,493,479,258,473,731
1000,492,509,503,241,506,747
1000,505,523,515,271,495,766
1000,487,497,501,243,499,742
1000,515,509,471,260,469,729
1000,532,488,520,252,514,766
1000,489,489,482,231,500,731
1000,509,493,517,244,517,761
1000,530,502,513,268,511,779
1000,480,499,509,248,501,749
1000,480,533,494,253,483,736
1000,491,506,494,244,509,753
1000,515,440,484,222,531,753
1000,509,511,496,273,483,756
1000,506,486,512,243,516,759
1000,503,499,495,260,492,752
1000,507,488,484,248,496,744
1000,506,480,471,252,493,745
1000,526,498,514,268,512,780
1000,495,518,504,256,497,753
1000,510,501,514,272,504,776
1000,503,494,491,254,503,757
1000,503,506,511,256,510,766
1000,517,498,495,249,509,758
1000,499,508,508,256,504,760
1000,496,504,503,254,496,750
1000,493,520,505,245,502,747
1000,490,494,473,257,464,721
1000,499,494,508,239,509,748
1000,495,503,488,262,489,751
1000,500,507,477,259,468,727
1000,502,491,491,259,481,740
1000,518,496,507,255,501,756
1000,497,485,477,237,501,738
1000,521,517,490,275,486,761
1000,492,515,521,254,495,749
1000,477,493,510,237,497,734
1000,508,492,500,250,508,758
1000,500,506,486,261,490,751
1000,479,491,502,239,510,749
1000,471,510,488,248,476,724
1000,523,503,492,260,501,761
1000,518,518,516,274,486,760
1000,479,493,488,245,495,740
1000,478,499,498,234,489,723
1000,488,463,482,221,504,725
1000,491,493,490,248,499,747
1000,501,516,480,251,486,737
1000,532,482,482,259,500,759
1000,518,504,497,262,502,764
1000,483,487,509,238,520,758
1000,483,493,526,238,523,761
1000,512,495,500,247,511,758
1000,494,491,486,240,509,749
1000,490,468,479,219,519,738
1000,483,503,497,245,494,739
1000,477,496,495,238,504,742
1000,500,482,487,229,518,747
1000,537,470,497,240,530,770
1000,516,513,498,274,473,747
1000,492,518,504,250,481,731
1000,489,510,481,243,502,745
1000,495,499,508,266,481,747
1000,492,516,488,260,476,736
1000,534,498,526,254,526,780
1000,505,504,494,255,498,753
1000,490,456,496,232,511,743
1000,498,500,508,230,519,749
1000,492,506,513,247,499,746
1000,484,489,487,236,512,748
1000,486,514,507,234,509,743
1000,514,519,514,265,504,769
1000,488,485,511,227,522,749
1000,483,532,514,258,489,747
1000,532,515,480,282,473,755
1000,460,498,524,236,508,744
1000,521,506,490,270,483,753
1000,478,526,497,247,502,749
1000,516,483,495,250,511,761
1000,496,474,506,233,520,753
1000,505,522,492,261,483,744
1000,505,489,472,245,502,747
1000,471,483,501,236,510,746
1000,509,509,511,260,499,759
1000,508,489,501,250,504,754
1000,481,499,501,239,508,747
1000,520,506,504,261,494,755
1000,513,482,470,248,494,742
1000,493,490,466,243,493,736
1000,494,497,508,238,512,750
1000,513,499,474,269,478,747
1000,489,521,515,259,498,757
1000,490,480,530,233,533,766
1000,508,501,490,257,482,739
1000,473,513,535,244,522,766
1000,524,477,485,247,501,748
1000,507,508,499,243,510,753
1000,504,497,483,254,481,735
1000,508,499,496,246,507,753
1000,498,497,490,234,510,744
1000,508,539,511,267,501,768
1000,511,476,509,237,517,754
1000,480,503,481,246,480,726
1000,488,530,492,265,483,748
1000,510,506,517,265,479,744
1000,486,508,514,258,499,757
1000,504,464,495,228,534,762
1000,491,503,516,256,488,744
1000,509,499,516,257,513,770
1000,519,496,487,256,490,746
1000,484,485,503,230,512,742
1000,481,520,535,251,512,763
1000,500,492,468,236,504,740
1000,505,503,485,246,501,747
1000,512,466,512,229,540,769
1000,494,494,502,250,490,740
1000,498,525,502,277,471,748
1000,488,498,486,241,494,735
1000,508,500,510,241,518,759
1000,506,483,495,240,497,737
1000,487,495,529,245,516,761
1000,480,488,517,239,513,752
1000,497,495,508,245,516,761
1000,500,488,502,242,503,745
1000,483,497,501,235,519,754
1000,491,519,464,259,489,748
1000,490,499,499,241,522,763
1000,514,503,483,246,502,748
1000,507,486,529,253,524,777
1000,498,492,480,247,481,728
1000,500,485,492,238,519,757
1000,510,493,487,252,491,743
1000,526,495,497,268,486,754
1000,494,518,489,249,488,737
1000,482,492,528,245,504,749
1000,486,492,480,234,510,744
1000,485,506,499,260,492,752
1000,500,494,516,250,509,759
1000,503,503,478,259,479,738
1000,514,502,490,252,476,728
1000,498,517,520,263,496,759
1000,477,504,491,238,512,750
1000,503,527,482,253,512,765
1000,484,499,487,248,469,717
1000,512,529,555,275,503,778
1000,508,510,530,278,490,768
1000,492,509,507,237,513,750
1000,497,476,536,240,521,761
1000,519,489,514,262,494,756
1000,487,481,509,233,515,748
1000,481,481,528,239,529,768
1000,475,520,517,241,506,747
1000,519,506,523,256,507,763
1000,504,512,507,258,499,757
1000,494,491,489,249,486,735
1000,499,522,510,260,485,745
1000,491,517,512,264,489,753
1000,511,531,536,261,516,777
1000,485,498,485,235,500,735
1000,480,508,521,245,501,746
1000,492,486,514,249,493,742
1000,519,481,459,239,506,745
1000,497,497,501,246,493,739
1000,476,505,499,235,512,747
1000,493,525,490,262,480,742
1000,521,509,488,275,492,767
1000,522,522,484,286,471,757
1000,497,503,494,255,483,738
1000,510,512,524,260,499,759
1000,499,515,514,254,526,780
1000,524,473,485,261,494,755
1000,505,498,517,260,501,761
1000,491,466,502,224,519,743
1000,487,466,478,231,491,722
1000,504,489,501,266,483,749
1000,511,502,505,250,518,768
1000,501,504,486,244,509,753
1000,481,494,495,231,502,733
1000,470,491,513,240,501,741
1000,527,502,507,269,501,770
1000,465,499,513,230,506,736
1000,503,503,496,242,500,742
1000,502,492,506,251,503,754
1000,506,498,489,249,496,745
1000,523,515,508,273,502,775
1000,489,512,522,248,510,758
1000,513,538,513,273,491,764
1000,494,498,494,248,504,752
1000,501,476,498,244,503,747
1000,502,499,505,244,498,742
1000,514,505,482,258,496,754
1000,516,510,513,271,497,768
1000,482,509,504,237,512,749
1000,473,509,519,239,511,750
1000,498,504,489,253,488,741
1000,504,497,506,249,518,767
1000,483,512,491,240,496,736
1000,523,501,506,258,516,774
1000,505,523,502,266,485,751
1000,508,488,500,247,509,756
1000,500,486,475,244,493,737
1000,492,498,514,247,513,760
1000,505,493,506,239,520,759
1000,472,497,523,233,519,752
1000,516,514,482,272,484,756
1000,501,535,505,281,479,760
1000,521,496,491,266,502,768
1000,508,522,463,266,468,734
1000,499,491,508,249,490,739
1000,521,496,495,260,497,757
1000,490,511,504,250,508,758
1000,483,481,526,228,539,767
1000,494,484,470,226,503,729
1000,507,498,507,239,517,756
1000,509,505,500,242,497,739
1000,511,506,504,258,507,765
1000,486,489,505,240,507,747
1000,492,492,512,239,525,764
1000,500,471,518,235,515,750
1000,509,509,535,269,510,779
1000,495,489,488,251,498,749
1000,508,490,513,264,484,748
1000,492,480,484,237,510,747
1000,508,496,488,248,501,749
1000,504,478,488,241,505,746
1000,505,502,507,244,507,751
1000,480,512,519,239,511,750
1000,504,493,518,242,524,766
1000,498,496,492,246,491,737
1000,489,512,486,262,487,749
1000,509,504,477,274,475,749
1000,527,501,490,264,483,747
1000,483,498,488,250,480,730
1000,476,509,510,220,526,746
1000,498,502,528,249,502,751
1000,495,491,509,238,499,737
1000,497,493,516,266,505,771
1000,503,504,471,249,492,741
1000,501,502,471,246,495,741
1000,515,505,530,254,512,766
1000,485,501,504,239,511,750
1000,502,496,504,250,510,760
1000,513,504,499,265,487,752
1000,490,484,505,239,513,752
1000,491,498,524,254,501,755
1000,484,483,487,229,517,746
1000,466,487,515,220,515,735
1000,513,489,509,256,500,756
1000,530,486,511,260,507,767
1000,516,502,514,271,500,771
1000,469,510,500,238,499,737
1000,529,510,519,270,500,770
1000,495,496,482,235,508,743
1000,505,515,490,261,478,739
1000,499,479,501,238,510,748
1000,510,489,482,245,491,736
1000,513,510,473,273,477,750
1000,479,499,487,240,508,748
1000,498,528,494,268,472,740
1000,486,474,528,243,523,766
1000,494,480,508,245,518,763
1000,486,524,509,244,507,751
1000,477,505,491,235,496,731
1000,513,491,494,253,514,767
1000,492,495,517,246,510,756
1000,510,483,488,252,493,745
1000,495,502,511,247,523,770
1000,502,500,499,253,510,763
1000,509,480,499,246,524,770
1000,484,510,517,249,504,753
1000,503,511,520,250,517,767
1000,462,482,507,214,512,726
1000,518,501,512,247,517,764
1000,486,493,493,229,509,738
1000,495,500,506,235,511,746
1000,501,492,509,244,518,762
1000,513,466,516,231,543,774
1000,515,494,520,256,520,776
1000,514,510,484,258,500,758
1000,489,494,506,232,515,747
1000,477,507,504,247,492,739
1000,513,474,510,231,538,769
1000,499,501,497,254,491,745
1000,537,515,512,287,482,769
1000,499,492,472,243,492,735
1000,481,472,498,227,511,738
1000,501,503,513,256,510,766
1000,519,479,494,241,519,760
1000,493,504,505,244,512,756
1000,486,480,493,227,505,732
1000,509,483,483,247,491,738
1000,498,506,510,243,505,748
1000,499,512,513,252,519,771
1000,503,496,498,258,483,741
1000,522,515,503,262,500,762
1000,512,487,505,242,525,767
1000,515,489,505,246,520,766
1000,514,519,500,276,491,767
1000,500,464,463,233,488,721
1000,492,490,509,227,533,760
1000,514,485,503,229,529,758
1000,503,514,525,262,498,760
1000,518,524,531,287,493,780
1000,508,513,511,251,495,746
1000,513,490,479,238,501,739
1000,501,493,484,243,492,735
1000,504,502,485,257,477,734
1000,482,507,498,233,501,734
1000,517,488,477,246,503,749
1000,496,488,489,226,523,749
1000,460,484,496,218,507,725
1000,508,483,508,247,524,771
1000,509,523,479,270,481,751
1000,468,495,474,238,471,709
1000,529,523,514,273,491,764
1000,480,488,505,239,499,738
1000,515,511,491,258,504,762
1000,479,508,492,258,484,742
1000,513,516,497,259,486,745
1000,498,469,519,232,533,765
1000,509,504,506,259,496,755
1000,479,489,498,238,501,739
1000,511,517,487,245,515,760
1000,471,510,486,243,469,712
1000,470,508,498,237,491,728
1000,477,497,487,255,464,719
1000,515,493,493,253,507,760
1000,485,500,487,260,483,743
1000,474,526,496,240,492,732
1000,506,492,518,249,517,766
1000,516,489,511,262,503,765
1000,482,514,476,236,495,731
1000,504,490,497,248,498,746
1000,492,485,488,226,504,730
1000,493,494,509,245,504,749
1000,498,477,487,245,487,732
1000,515,471,475,234,517,751
1000,517,509,502,270,497,767
1000,485,485,515,234,526,760
1000,481,508,477,243,490,733
1000,490,512,515,249,506,755
1000,484,503,509,236,514,750
1000,499,519,496,259,479,738
1000,524,508,513,266,511,777
1000,502,494,525,247,524,771
1000,518,513,520,263,497,760
1000,500,504,529,252,532,784
1000,489,513,510,252,504,756
1000,512,496,502,263,514,777
1000,524,482,490,263,489,752
1000,486,474,506,232,507,739
1000,510,537,503,277,481,758
1000,491,493,508,243,521,764
1000,509,507,481,254,502,756
1000,496,508,512,255,498,753
1000,504,521,489,269,475,744
1000,508,513,503,259,494,753
1000,481,493,501,248,501,749
1000,507,476,519,239,533,772
1000,488,505,492,247,490,737
1000,501,503,512,253,517,770
1000,528,513,484,271,490,761
1000,503,499,529,243,540,783
1000,478,499,528,228,521,749
1000,484,487,519,239,507,746
1000,509,507,521,263,498,761
1000,518,469,499,256,502,758
1000,476,485,490,223,501,724
1000,503,473,473,238,497,735
1000,503,522,502,255,491,746
1000,519,496,483,261,483,744
1000,496,517,504,264,493,757
1000,475,486,490,217,513,730
1000,534,481,481,251,517,768
1000,488,537,468,246,497,743
1000,508,504,481,250,505,755
1000,496,484,497,229,510,739
1000,524,510,496,274,487,761
1000,495,507,525,245,524,769
1000,500,489,503,250,511,761
1000,493,514,509,255,501,756
1000,485,499,508,247,488,735
1000,473,492,474,234,494,728
1000,518,488,511,242,519,761
1000,506,505,501,253,498,751
1000,499,485,491,230,526,756
1000,459,512,493,223,508,731
1000,473,466,496,231,490,721
1000,493,507,503,261,494,755
1000,490,534,489,261,486,747
1000,504,499,492,255,497,752
1000,509,509,486,250,494,744
1000,475,541,468,261,460,721
1000,482,483,467,244,490,734
1000,524,501,496,251,512,763
1000,516,501,510,259,504,763
1000,505,510,516,267,492,759
1000,494,523,482,259,483,742
1000,510,482,514,245,532,777
1000,485,511,499,247,484,731
1000,487,512,498,260,478,738
1000,509,522,490,252,503,755
1000,489,512,496,241,491,732
1000,495,491,479,244,495,739
1000,520,543,497,283,475,758
1000,504,531,494,257,490,747
1000,490,499,523,251,507,758
1000,507,518,515,262,493,755
1000,504,525,515,276,481,757
1000,477,501,519,226,526,752
1000,485,495,513,234,505,739
1000,507,495,481,245,506,751
1000,503,514,485,269,463,732
1000,486,517,494,248,473,721
1000,516,487,504,234,526,760
1000,496,514,505,248,504,752
1000,517,508,509,260,509,769
1000,513,512,496,259,492,751
1000,513,500,505,262,502,764
1000,504,504,477,242,495,737
1000,500,539,472,266,479,745
1000,494,475,481,244,509,753
1000,519,509,497,260,485,745
1000,504,480,520,240,525,765
1000,489,457,503,220,533,753
1000,464,518,466,238,480,718
1000,507,505,522,252,504,756
1000,503,500,495,248,499,747
1000,496,515,496,267,469,736
1000,474,496,503,237,518,755
1000,523,496,487,252,490,742
1000,482,521,489,253,489,742
1000,503,482,498,240,529,769
1000,498,518,506,271,476,747
1000,517,486,508,248,521,769
1000,514,498,518,265,491,756
1000,538,489,508,263,503,766
1000,483,494,521,239,522,761
1000,504,500,498,249,481,730
1000,497,497,510,235,514,749
1000,521,494,513,243,526,769
1000,483,488,494,239,504,743
1000,503,491,512,234,524,758
1000,502,501,494,236,504,740
1000,505,511,503,269,483,752
1000,505,513,501,272,487,759
1000,498,518,507,259,493,752
1000,494,486,520,234,532,766
1000,480,513,497,246,489,735
1000,473,518,478,255,485,740
1000,492,481,516,253,509,762
1000,501,512,506,255,486,741
1000,505,481,495,246,493,739
1000,499,478,530,232,519,751
1000,517,505,510,267,505,772
1000,487,523,497,250,489,739
1000,514,498,497,245,512,757
1000,514,498,509,254,516,770
1000,500,486,491,240,509,749
1000,495,502,503,262,495,757
1000,505,485,498,249,507,756
1000,522,484,501,265,505,770
1000,503,478,502,250,501,751
1000,500,504,505,259,488,747
1000,515,497,516,251,499,750
1000,520,483,498,254,489,743
1000,512,471,511,235,526,761
1000,517,493,503,250,517,767
1000,516,492,523,254,522,776
1000,497,519,508,255,498,753
1000,482,498,486,244,485,729
1000,517,510,501,258,480,738
1000,500,501,490,247,497,744
1000,472,493,503,227,518,745
1000,508,516,486,275,479,754
1000,521,495,485,258,512,770
1000,488,506,502,253,495,748
1000,486,509,516,248,489,737
1000,497,493,524,248,524,772
1000,508,494,499,251,508,759
1000,477,488,484,229,500,729
1000,488,541,511,256,491,747
1000,496,486,498,235,507,742
1000,528,501,467,260,492,752
1000,488,505,465,248,483,731
1000,506,520,503,252,489,741
1000,503,493,485,243,500,743
1000,502,473,524,239,522,761
1000,508,506,513,248,504,752
1000,521,504,487,257,500,757
1000,502,505,499,255,501,756
1000,475,509,514,237,520,757
1000,519,529,510,279,487,766
1000,484,489,477,235,503,738
1000,513,504,493,268,490,758
1000,513,472,496,243,520,763
1000,477,520,510,260,474,734
1000,479,531,515,252,502,754
1000,512,480,525,246,534,780
1000,481,484,508,242,504,746
1000,494,468,514,230,537,767
1000,519,499,467,269,474,743
1000,534,493,525,277,509,786
1000,500,489,490,248,497,745
1000,486,487,488,240,492,732
1000,499,517,505,242,494,736
1000,489,523,534,245,516,761
1000,505,494,477,233,505,738
1000,534,492,497,254,516,770
1000,477,525,502,255,486,741
1000,469,485,528,228,517,745
1000,518,530,488,278,471,749
1000,512,497,514,261,506,767
1000,503,517,483,248,506,754
1000,478,512,505,247,491,738
1000,507,528,514,272,472,744
1000,498,488,508,251,508,759
1000,501,513,496,260,474,734
1000,468,483,505,228,496,724
1000,476,502,511,226,505,731
1000,520,476,492,250,497,747
1000,489,516,491,238,501,739
1000,503,528,542,270,503,773
1000,504,483,474,249,508,757
1000,499,520,516,264,497,761
1000,481,502,521,255,497,752
1000,498,477,513,240,508,748
1000,495,502,510,237,503,740
1000,513,494,504,259,491,750
1000,476,526,525,249,506,755
1000,519,504,505,254,507,761
1000,516,485,513,244,520,764
1000,507,486,494,256,497,753
1000,514,511,492,261,488,749
1000,488,484,462,241,483,724
1000,489,516,483,247,497,744
1000,503,493,478,256,477,733
1000,490,479,495,243,498,741
1000,502,496,490,257,480,737
1000,494,488,502,233,505,738
1000,492,513,481,243,491,734
1000,501,508,484,250,488,738
1000,491,500,481,248,488,736
1000,507,517,500,263,490,753
1000,476,498,507,231,498,729
1000,504,472,492,253,490,743
1000,504,518,507,260,500,760
1000,477,501,521,240,507,747
1000,485,487,502,246,488,734
1000,513,498,488,259,498,757
1000,528,543,526,273,499,772
1000,498,519,508,259,491,750
1000,497,495,488,250,484,734
1000,474,478,505,233,517,750
1000,519,510,526,253,521,774
1000,489,480,504,242,502,744
1000,494,506,510,259,491,750
1000,506,503,497,250,504,754
1000,512,467,468,231,509,740
1000,483,495,497,239,489,728
1000,500,501,507,245,514,759
1000,501,534,494,257,498,755
1000,480,481,511,233,523,756
1000,471,511,486,234,508,742
1000,515,484,506,246,509,755
1000,502,492,491,237,511,748
1000,477,501,505,239,501,740
1000,480,514,507,266,472,738
1000,496,513,503,247,502,749
1000,480,473,482,222,515,737
1000,496,473,494,228,507,735
1000,511,501,482,246,498,744
1000,504,498,489,254,498,752
1000,509,500,504,258,492,750
1000,506,491,497,240,511,751
1000,478,478,502,229,507,736
1000,511,517,487,267,479,746
1000,506,497,489,248,483,731
1000,485,485,468,245,476,721
1000,532,482,532,250,519,769
1000,516,510,479,266,489,755
1000,495,486,498,234,521,755
1000,474,498,501,250,495,745
1000,496,479,509,231,518,749
1000,519,510,491,264,491,755
1000,478,514,517,245,506,751
1000,484,514,467,231,493,724
1000,496,478,519,240,519,759
1000,510,511,525,255,527,782
1000,483,513,480,258,470,728
1000,506,549,503,276,486,762
1000,487,490,495,229,513,742
1000,531,520,495,274,483,757
1000,501,490,491,238,500,738
1000,487,503,477,241,485,726
1000,483,499,519,224,530,754
1000,537,525,522,290,483,773
1000,483,512,490,248,484,732
1000,487,521,484,253,483,736
1000,509,492,492,245,505,750
1000,476,499,494,231,509,740
1000,477,490,506,237,484,721
1000,506,497,510,240,515,755
1000,522,511,504,264,501,765
1000,491,522,484,257,473,730
1000,507,528,502,260,495,755
1000,488,501,503,256,482,738
1000,517,487,478,264,479,743
1000,505,505,513,253,518,771
1000,477,500,502,230,508,738
1000,516,494,488,260,492,752
1000,512,517,503,267,492,759
1000,516,481,471,246,482,728
1000,505,501,496,260,486,746
1000,481,502,512,238,517,755
1000,483,517,526,256,498,754
1000,479,520,506,248,506,754
1000,491,488,509,245,506,751
1000,473,502,498,225,514,739
1000,503,480,506,237,523,760
1000,496,498,514,247,503,750
1000,499,492,508,244,508,752
1000,530,516,497,287,471,758
1000,517,518,469,264,483,747
1000,493,527,507,237,527,764
1000,526,474,511,246,515,761
1000,504,483,489,250,490,740
1000,516,510,501,261,483,744
1000,506,487,490,250,496,746
1000,521,498,507,253,519,772
1000,510,486,503,249,510,759
1000,502,530,510,257,507,764
1000,517,472,513,243,522,765
1000,548,514,518,289,482,771
1000,487,496,502,250,492,742
1000,475,500,506,225,512,737
1000,522,479,504,262,507,769
1000,490,517,519,255,495,750
1000,502,522,483,271,484,755
1000,509,510,521,256,512,768
1000,498,503,501,249,501,750
1000,483,500,495,250,493,743
1000,512,496,499,244,503,747
1000,496,493,518,244,519,763
1000,513,485,507,250,497,747
1000,499,494,469,262,465,727
1000,494,514,501,261,484,745
1000,494,501,526,236,516,752
1000,520,499,526,258,502,760
1000,492,521,493,267,477,744
1000,483,493,490,236,508,744
1000,496,503,488,261,466,727
1000,515,500,530,251,510,761
1000,518,499,491,250,511,761
1000,495,519,537,251,523,774
1000,499,500,510,263,500,763
1000,498,513,478,249,489,738
1000,484,506,518,235,517,752
1000,473,491,506,244,497,741
1000,502,511,517,259,518,777
1000,499,499,501,246,496,742
1000,463,497,480,227,485,712
1000,519,534,505,284,487,771
1000,503,498,511,252,502,754
1000,491,468,515,247,505,752
1000,519,502,472,264,498,762
1000,506,508,495,265,493,758
1000,499,524,530,264,497,761
1000,503,516,505,261,500,761
1000,508,494,510,256,496,752
1000,498,525,491,264,471,735
1000,510,495,514,249,509,758
1000,484,500,482,242,491,733
1000,533,515,478,286,476,762
1000,476,474,505,218,518,736
1000,508,520,506,271,486,757
1000,486,494,526,231,526,757
1000,511,489,506,258,500,758
1000,462,501,501,236,495,731
1000,503,534,521,270,471,741
1000,521,487,496,237,524,761
1000,515,530,509,273,485,758
1000,508,462,511,239,516,755
1000,491,500,495,247,496,743
1000,484,507,490,241,490,731
1000,492,497,483,247,494,741
1000,526,470,507,239,546,785
1000,485,505,515,238,509,747
1000,499,523,488,253,501,754
1000,526,484,494,261,496,757
1000,534,504,526,280,503,783
1000,496,506,510,256,502,758
1000,521,530,530,278,494,772
1000,469,487,502,237,507,744
1000,500,486,487,229,518,747
1000,493,507,498,250,490,740
1000,493,507,479,233,494,727
1000,507,518,491,266,492,758
1000,512,487,490,261,492,753
1000,476,503,467,239,477,716
1000,504,493,479,237,494,731
1000,493,523,533,254,494,748
1000,502,487,503,242,510,752
1000,493,492,507,249,516,765
1000,492,488,508,245,508,753
1000,504,501,487,259,474,733
1000,500,479,505,238,514,752
1000,503,528,473,268,481,749
1000,503,502,479,252,493,745
1000,492,502,526,255,508,763
1000,497,502,527,255,512,767
1000,503,510,470,261,482,743
1000,496,504,515,252,515,767
1000,484,457,501,215,525,740
1000,511,525,476,265,454,719
1000,498,499,494,231,511,742
1000,475,490,517,244,503,747
1000,455,486,492,230,498,728
1000,491,493,501,230,516,746
1000,502,471,499,246,506,752
1000,496,498,464,244,490,734
1000,501,479,470,238,504,742
1000,510,494,468,263,478,741
1000,482,474,514,217,532,749
1000,515,482,509,241,511,752
1000,500,494,508,245,503,748
1000,476,464,503,232,513,745
1000,495,477,495,249,494,743
1000,501,497,512,246,523,769
1000,505,536,504,277,488,765
1000,492,517,498,261,482,743
1000,483,511,500,238,509,747
1000,512,489,494,242,524,766
1000,491,514,515,247,515,762
1000,496,476,486,223,509,732
1000,515,533,481,262,487,749
1000,483,512,507,241,505,746
1000,500,501,506,246,523,769
1000,513,506,484,256,499,755
1000,499,492,517,245,506,751
1000,521,508,480,278,470,748
1000,454,508,479,229,489,718
1000,490,514,487,252,483,735
1000,499,514,482,248,488,736
1000,498,517,511,259,492,751
1000,498,482,475,246,479,725
1000,490,510,485,260,486,746
1000,486,501,552,249,520,769
1000,491,480,500,243,491,734
1000,510,475,499,243,530,773
1000,512,479,498,248,508,756
1000,491,507,489,245,504,749
1000,483,503,519,244,514,758
1000,491,511,501,252,488,740
1000,491,497,495,244,507,751
1000,471,480,536,220,536,756
1000,480,489,511,227,517,744
1000,480,487,494,235,501,736
1000,494,474,519,238,522,760
1000,480,527,509,254,488,742
1000,520,508,498,255,494,749
1000,478,495,497,245,492,737
1000,518,485,499,250,514,764
1000,489,509,459,243,483,726
1000,502,524,520,262,506,768
1000,476,500,509,233,509,742
1000,508,509,491,262,485,747
1000,509,523,488,264,484,748
1000,508,501,475,262,476,738
1000,506,510,504,255,503,758
1000,509,486,514,256,504,760
1000,513,512,493,269,480,749
1000,494,502,500,259,475,734
1000,501,477,535,238,534,772
1000,489,500,511,247,508,755
1000,494,517,499,257,506,763
1000,503,508,516,261,492,753
1000,504,477,514,236,535,771
1000,483,519,485,260,487,747
1000,518,491,499,266,491,757
1000,527,485,520,250,520,770
1000,526,493,499,258,511,769
1000,507,506,488,255,488,743
1000,469,511,501,227,515,742
1000,505,494,475,246,500,746
1000,486,535,483,253,477,730
1000,516,496,514,262,498,760
1000,502,487,527,228,525,753
1000,489,517,514,244,498,742
1000,509,492,491,257,503,760
1000,497,496,517,244,517,761
1000,513,514,482,256,490,746
1000,521,494,518,263,505,768
1000,502,503,485,257,484,741
1000,477,491,515,232,512,744
1000,518,475,535,248,533,781
1000,514,513,530,252,516,768
1000,529,487,507,258,526,784
1000,491,528,508,263,472,735
1000,489,501,505,244,501,745
1000,469,489,475,236,488,724
1000,510,504,513,258,510,768
1000,489,519,495,248,491,739
1000,484,471,483,218,512,730
1000,494,500,505,235,502,737
1000,484,489,501,237,510,747
1000,486,536,505,262,475,737
1000,505,524,494,265,474,739
1000,518,496,485,275,482,757
1000,516,475,476,254,496,750
1000,497,514,499,248,495,743
1000,531,480,500,247,511,758
1000,490,536,483,268,461,729
1000,504,511,507,252,511,763
1000,471,520,537,261,485,746
1000,512,481,526,250,515,765
1000,494,505,517,239,505,744
1000,489,489,497,234,512,746
1000,505,511,499,256,496,752
1000,483,504,528,239,517,756
1000,516,525,498,263,488,751
1000,494,499,487,236,504,740
1000,499,481,503,248,507,755
1000,500,512,510,240,520,760
1000,504,507,504,250,495,745
1000,518,508,491,266,490,756
1000,488,477,503,225,522,747
1000,512,493,495,251,492,743
1000,501,510,514,263,504,767
1000,480,512,515,251,507,758
1000,503,510,503,262,504,766
1000,479,475,511,227,537,764
1000,480,504,473,238,495,733
1000,486,491,519,237,508,745
1000,467,506,537,232,513,745
1000,508,522,497,255,504,759
1000,489,492,511,229,525,754
1000,498,487,499,236,525,761
1000,508,496,483,256,492,748
1000,492,485,501,229,519,748
1000,517,514,499,257,485,742
1000,488,508,504,262,492,754
1000,474,495,519,243,494,737
1000,497,499,497,254,484,738
1000,502,528,486,257,510,767
1000,529,525,522,271,514,785
1000,509,515,503,281,468,749
1000,508,509,510,254,507,761
1000,516,498,494,251,495,746
1000,496,512,499,260,478,738
1000,526,492,507,253,518,771
1000,498,500,507,251,502,753
1000,479,537,504,251,491,742
1000,521,477,507,241,525,766
1000,508,506,496,251,496,747
1000,509,515,502,265,501,766
1000,513,494,499,245,500,745
1000,506,480,484,254,476,730
1000,485,479,532,226,526,752
1000,527,514,508,275,482,757
1000,501,469,505,247,505,752
1000,472,496,489,246,491,737
1000,504,509,511,246,528,774
1000,494,478,490,219,531,750
1000,493,479,507,228,526,754
1000,498,510,480,253,480,733
1000,495,488,477,230,504,734
1000,488,521,494,241,491,732
1000,494,504,503,244,503,747
1000,517,487,513,244,522,766
1000,500,495,493,257,495,752
1000,503,514,490,252,499,751
1000,504,494,496,234,501,735
1000,513,534,502,276,481,757
1000,508,515,523,256,508,764
1000,537,493,469,262,502,764
1000,520,440,513,228,537,765
1000,502,543,488,273,465,738
1000,510,499,523,246,505,751
1000,519,512,485,275,489,764
1000,501,481,503,241,511,752
1000,510,506,495,262,503,765
1000,504,458,511,218,536,754
1000,489,485,519,241,511,752
1000,508,490,492,257,486,743
1000,505,477,502,238,513,751
1000,493,516,517,237,522,759
1000,520,489,476,246,502,748
1000,478,498,515,228,508,736
1000,496,504,485,245,490,735
1000,495,487,510,237,529,766
1000,495,506,503,253,506,759
1000,494,514,471,267,476,743
1000,501,488,487,237,507,744
1000,516,506,487,264,500,764
1000,486,512,506,252,488,740
1000,496,508,514,259,488,747
1000,462,502,508,228,509,737
1000,498,526,508,256,502,758
1000,520,521,502,273,498,771
1000,534,493,493,264,506,770
1000,513,484,481,251,508,759
1000,481,503,510,248,496,744
1000,487,508,520,240,524,764
1000,508,494,492,242,503,745
1000,502,517,464,250,479,729
1000,487,481,493,225,516,741
1000,504,498,498,249,500,749
1000,488,489,495,239,511,750
1000,494,492,478,236,503,739
1000,499,505,482,245,504,749
1000,495,520,530,255,516,771
1000,517,486,486,269,483,752
1000,478,509,495,236,503,739
1000,520,516,504,279,476,755
1000,490,499,506,239,515,754
1000,473,466,506,213,536,749
1000,515,478,520,245,519,764
1000,504,508,489,265,484,749
1000,506,506,507,255,508,763
1000,525,484,484,237,519,756
1000,510,510,501,275,477,752
1000,493,492,499,234,503,737
1000,492,523,484,261,468,729
1000,500,490,490,247,500,747
1000,511,489,546,240,536,776
1000,483,501,519,244,522,766
1000,485,496,498,231,505,736
1000,461,496,488,223,509,732
1000,494,508,500,248,507,755
1000,519,527,499,277,470,747
1000,506,490,519,252,505,757
1000,500,489,517,239,514,753
1000,506,507,498,271,473,744
1000,485,516,494,253,490,743
1000,507,512,515,267,489,756
1000,477,508,527,244,506,750
1000,525,526,513,292,479,771
1000,473,502,496,249,492,741
1000,529,533,522,290,497,787
1000,489,504,497,249,497,746
1000,499,480,479,231,505,736
1000,509,499,470,253,480,733
1000,507,510,503,252,503,755
1000,531,491,510,261,506,767
1000,499,495,499,247,499,746
1000,506,491,508,233,514,747
1000,499,486,499,243,500,743
1000,504,531,507,253,499,752
1000,486,538,510,261,487,748
1000,503,514,508,262,489,751
1000,508,506,491,261,487,748
1000,483,486,497,233,514,747
1000,482,503,480,233,486,719
1000,509,487,522,241,526,767
1000,482,508,525,247,509,756
1000,473,506,505,230,492,722
1000,508,511,484,247,492,739
1000,515,499,474,250,499,749
1000,498,497,510,260,471,731
1000,500,506,519,251,501,752
1000,471,495,474,228,507,735
1000,528,512,508,268,488,756
1000,474,494,503,241,498,739
1000,491,502,516,241,513,754
1000,505,490,515,248,513,761
1000,488,532,484,263,476,739
1000,479,519,514,243,516,759
1000,530,475,496,246,516,762
1000,496,488,503,230,516,746
1000,485,484,499,228,504,732
1000,524,496,476,263,484,747
1000,469,494,488,231,496,727
1000,505,496,506,259,499,758
1000,490,519,470,256,474,730
1000,492,500,496,248,508,756
1000,491,508,507,257,493,750
1000,487,529,521,252,496,748
1000,488,504,475,243,485,728
1000,499,479,524,236,528,764
1000,504,499,507,255,494,749
1000,470,516,509,243,484,727
1000,518,473,498,260,504,764
1000,486,479,505,223,513,736
1000,522,505,502,285,482,767
1000,497,496,518,248,502,750
1000,482,496,480,231,502,733
1000,504,520,478,254,475,729
1000,468,493,513,232,529,761
1000,540,499,509,283,498,781
1000,533,499,530,267,514,781
1000,498,489,494,241,509,750
1000,486,503,499,244,496,740
1000,493,488,471,246,497,743
1000,491,527,506,258,491,749
1000,516,514,494,262,487,749
1000,512,497,500,253,505,758
1000,491,514,494,236,519,755
1000,508,491,496,260,494,754
1000,495,526,475,260,481,741
1000,492,503,497,242,501,743
1000,494,511,466,249,477,726
1000,483,498,475,236,477,713
1000,497,501,509,252,500,752
1000,491,499,520,255,509,764
1000,496,512,512,256,508,764
1000,508,477,503,237,526,763
1000,523,507,531,257,521,778
1000,508,521,513,259,499,758
1000,527,510,510,277,486,763
1000,519,522,490,258,488,746
1000,506,497,516,241,516,757
1000,519,520,508,271,504,775
1000,496,489,522,235,532,767
1000,516,476,499,257,505,762
1000,481,462,516,226,529,755
1000,510,471,496,239,527,766
1000,488,492,494,237,505,742
1000,480,502,480,244,487,731
1000,503,508,471,260,477,737
1000,477,507,509,243,493,736
1000,513,484,478,246,496,742
1000,520,506,515,265,510,775
1000,506,483,503,234,518,752
1000,510,525,495,265,494,759
1000,473,517,482,240,498,738
1000,482,471,488,217,521,738
1000,498,495,484,257,485,742
1000,502,542,513,278,485,763
1000,478,488,519,241,530,771
1000,495,510,484,255,492,747
1000,497,500,520,251,501,752
1000,473,511,486,249,490,739
1000,507,512,501,263,488,751
1000,534,473,522,258,539,797
1000,505,519,512,254,485,739
1000,492,497,521,236,514,750
1000,498,494,509,241,521,762
1000,502,520,507,257,494,751
1000,503,497,484,255,489,744
1000,520,489,518,239,531,770
1000,535,491,531,258,517,775
1000,506,497,497,238,524,762
1000,520,503,487,257,497,754
1000,478,478,476,224,502,726
1000,517,475,503,247,524,771
1000,521,537,486,280,477,757
1000,525,518,518,262,507,769
1000,511,531,515,265,503,768
1000,515,495,509,255,505,760
1000,498,516,481,255,482,737
1000,488,489,502,232,509,741
1000,508,512,489,277,470,747
1000,507,501,513,263,491,754
1000,508,509,474,270,480,750
1000,489,514,521,260,501,761
1000,465,473,495,222,504,726
1000,478,503,503,241,487,728
1000,498,508,488,245,514,759
1000,517,502,512,268,493,761
1000,508,500,447,250,470,720
1000,517,503,479,241,502,743
1000,505,486,501,247,517,764
1000,505,491,491,260,486,746
1000,512,505,501,263,497,760
1000,501,489,525,245,516,761
1000,495,505,511,249,498,747
1000,498,512,523,272,492,764
1000,510,506,481,247,503,750
1000,515,518,492,266,492,758
1000,492,484,520,220,540,760
1000,515,498,511,265,488,753
1000,481,484,499,225,530,755
1000,477,509,513,237,505,742
1000,481,498,513,239,500,739
1000,503,509,491,247,506,753
1000,495,490,486,235,494,729
1000,479,503,454,245,472,717
1000,510,518,499,262,495,757
1000,482,487,516,219,525,744
1000,525,526,524,291,490,781
1000,494,515,509,247,521,768
1000,482,488,498,228,505,733
1000,504,486,493,246,514,760
1000,499,479,478,246,494,740
1000,490,477,507,250,492,742
1000,505,488,495,238,507,745
1000,499,504,527,234,514,748
1000,537,488,508,253,519,772
1000,495,504,472,249,493,742
1000,500,516,484,266,464,730
1000,519,474,485,246,506,752
1000,513,532,490,292,456,748
1000,504,497,505,262,489,751
1000,491,533,494,263,476,739
1000,505,491,505,250,505,755
1000,500,487,484,242,508,750
1000,493,510,522,241,521,762
1000,503,491,496,247,499,746
1000,478,519,510,255,485,740
1000,509,519,510,269,487,756
1000,535,498,487,264,499,763
1000,507,480,531,249,519,768
1000,530,506,479,270,484,754
1000,514,512,486,262,488,750
1000,491,486,523,246,507,753
1000,526,470,497,248,511,759
1000,488,504,523,242,515,757
1000,488,497,489,234,513,747
1000,507,530,485,267,478,745
1000,489,486,501,242,507,749
1000,473,490,493,229,508,737
1000,513,488,528,246,523,769
1000,513,527,507,265,480,745
1000,499,506,486,250,484,734
1000,509,501,508,253,503,756
1000,526,536,506,282,483,765
1000,500,513,549,256,512,768
1000,480,498,513,245,500,745
1000,534,467,491,256,502,758
1000,508,495,495,251,509,760
1000,528,504,482,264,499,763
1000,465,502,510,235,498,733
1000,511,491,499,240,522,762
1000,489,496,505,246,510,756
1000,457,472,512,217,504,721
1000,518,507,489,269,480,749
1000,514,490,504,259,491,750
1000,511,476,519,248,518,766
1000,503,503,511,251,509,760
1000,518,508,526,252,523,775
1000,469,515,501,245,492,737
1000,498,485,523,250,502,752
1000,530,514,498,259,499,758
1000,505,498,506,250,498,748
1000,483,501,489,242,492,734
1000,494,496,466,248,498,746
1000,500,481,462,236,486,722
1000,495,510,475,260,488,748
1000,523,484,469,247,492,739
1000,500,515,503,262,491,753
1000,500,498,493,236,523,759
1000,496,495,491,245,485,730
1000,503,494,491,250,486,736
1000,505,483,512,230,517,747
1000,496,520,510,259,484,743
1000,504,494,509,232,539,771
1000,487,526,470,258,461,719
1000,486,493,479,249,496,745
1000,494,497,496,242,493,735
1000,510,479,507,237,529,766
1000,502,495,535,248,527,775
1000,503,504,500,247,510,757
1000,529,498,480,258,486,744
1000,506,485,514,242,497,739
1000,503,507,461,253,483,736
1000,508,522,505,262,485,747
1000,490,497,499,242,507,749
1000,493,503,496,252,496,748
1000,511,465,504,223,544,767
1000,491,516,496,253,495,748
1000,481,505,499,231,502,733
1000,516,491,514,265,505,770
1000,484,511,483,257,493,750
1000,515,492,509,249,506,755
1000,533,480,480,270,480,750
1000,532,508,516,262,511,773
1000,497,489,492,253,493,746
1000,519,498,508,258,514,772
1000,481,502,515,244,494,738
1000,499,522,487,264,484,748
1000,532,500,494,269,493,762
1000,533,500,511,264,522,786
1000,490,481,513,235,514,749
1000,523,532,498,271,497,768
1000,494,507,483,260,472,732
1000,534,510,495,276,480,756
1000,478,509,522,237,523,760
1000,509,524,516,278,480,758
1000,479,519,481,255,470,725
1000,479,489,490,232,501,733
1000,485,494,480,235,489,724
1000,526,490,503,259,505,764
1000,510,518,500,266,496,762
1000,519,481,484,254,508,762
1000,531,501,476,260,480,740
1000,517,487,491,249,510,759
1000,472,501,487,255,479,734
1000,496,491,525,248,522,770
1000,497,508,498,263,473,736
1000,507,492,526,235,532,767
1000,502,509,501,263,480,743
1000,478,524,489,245,497,742
1000,514,482,492,253,513,766
1000,486,515,496,241,499,740
1000,497,518,495,264,474,738
1000,466,500,500,225,510,735
1000,512,498,483,257,487,744
1000,481,514,495,243,479,722
1000,492,489,487,249,494,743
1000,499,493,527,244,531,775
1000,526,493,489,268,480,748
1000,489,508,491,255,489,744
1000,488,506,483,251,499,750
1000,506,533,509,262,488,750
1000,486,506,504,235,499,734
1000,507,517,550,276,497,773
1000,493,475,492,231,513,744
1000,491,515,507,251,484,735
1000,488,493,513,237,502,739
1000,488,481,502,224,521,745
1000,515,480,534,234,538,772
1000,487,482,506,235,508,743
1000,497,515,480,244,500,744
1000,503,512,493,255,490,745
1000,496,476,512,241,512,753
1000,531,513,512,265,508,773
1000,470,478,517,237,516,753
1000,507,481,509,238,516,754
1000,484,483,465,245,483,728
1000,527,507,489,266,496,762
1000,471,494,461,222,482,704
1000,483,490,484,231,516,747
1000,493,481,493,238,500,738
1000,533,504,491,264,497,761
1000,510,449,491,233,535,768
1000,488,481,520,221,534,755
1000,486,516,473,256,463,719
1000,519,517,510,273,495,768
1000,500,478,489,232,529,761
1000,517,509,490,256,492,748
1000,518,489,483,251,485,736
1000,500,524,516,270,493,763
1000,479,520,494,253,489,742
1000,505,504,467,258,483,741
1000,500,518,500,258,500,758
1000,494,498,483,249,495,744
1000,521,530,514,267,486,753
1000,534,520,507,264,501,765
1000,488,510,503,244,507,751
1000,492,476,523,237,524,761
1000,492,485,502,236,501,737
1000,500,483,507,250,511,761
1000,526,468,483,250,497,747
1000,512,488,510,254,503,757
1000,502,491,511,244,517,761
1000,514,509,510,251,508,759
1000,519,525,515,265,508,773
1000,500,491,479,236,489,725
1000,514,518,508,269,497,766
1000,505,498,503,264,490,754
1000,487,503,511,244,497,741
1000,486,486,476,242,479,721
1000,474,515,483,244,474,718
1000,492,529,521,268,507,775
1000,511,496,494,248,497,745
1000,512,500,509,258,503,761
1000,503,503,521,260,491,751
1000,493,515,500,253,500,753
1000,498,508,521,254,502,756
1000,494,503,489,238,505,743
1000,475,534,492,243,481,724
1000,538,495,518,267,497,764
1000,498,484,513,238,512,750
1000,521,499,486,267,487,754
1000,507,499,495,250,504,754
1000,494,519,503,256,491,747
1000,497,492,502,246,510,756
1000,501,493,507,240,517,757
1000,496,487,514,232,520,752
1000,501,513,500,272,478,750
1000,499,492,485,233,507,740
1000,514,489,491,250,507,757
1000,502,504,502,253,511,764
1000,503,532,514,252,512,764
1000,518,520,504,280,494,774
1000,509,500,520,260,502,762
1000,493,520,466,254,458,712
1000,506,476,514,234,524,758
1000,486,511,500,261,481,742
1000,513,494,517,248,511,759
1000,489,484,495,229,526,755
1000,486,478,485,232,504,736
1000,524,521,495,278,476,754
1000,531,500,501,270,499,769
1000,490,510,479,261,476,737
1000,480,482,487,236,503,739
1000,510,505,495,247,502,749
1000,499,490,500,240,492,732
1000,523,507,537,282,498,780
1000,494,495,490,249,486,735
1000,502,491,505,248,498,746
1000,513,487,495,259,504,763
1000,505,510,515,247,514,761
1000,490,516,493,248,486,734
1000,473,519,500,251,485,736
1000,508,492,502,233,514,747
1000,495,522,496,256,485,741
1000,484,517,502,242,499,741
1000,505,502,490,259,490,749
1000,513,499,505,259,508,767
1000,518,504,483,256,485,741
1000,507,517,506,260,498,758
1000,473,509,500,258,482,740
1000,535,479,512,265,513,778
1000,500,474,521,250,513,763
1000,504,488,489,255,508,763
1000,490,503,510,240,502,742
1000,501,499,507,261,500,761
1000,520,502,518,261,514,775
1000,488,500,503,237,513,750
1000,525,499,488,268,494,762
1000,496,474,511,240,521,761
1000,515,473,483,248,495,743
1000,478,518,489,264,464,728
1000,509,508,492,259,495,754
1000,506,515,474,261,481,742
1000,495,472,484,233,509,742
1000,524,473,495,256,522,778
1000,504,518,484,258,481,739
1000,529,513,505,274,491,765
1000,461,535,487,242,490,732
1000,523,496,490,265,493,758
1000,485,477,493,228,526,754
1000,525,499,461,269,472,741
1000,488,503,489,256,483,739
1000,503,533,487,283,473,756
1000,500,492,501,247,495,742
1000,517,505,525,260,496,756
1000,469,489,474,236,493,729
1000,499,475,489,232,512,744
1000,500,505,502,266,491,757
1000,528,525,503,282,487,769
1000,528,497,480,263,474,737
1000,497,509,508,262,491,753
1000,511,482,511,252,510,762
1000,477,500,503,236,513,749
1000,522,498,506,265,490,755
1000,501,498,536,259,515,774
1000,499,512,506,270,470,740
1000,482,528,494,267,459,726
1000,495,498,483,247,483,730
1000,511,509,499,283,472,755
1000,506,518,502,283,475,758
1000,485,516,511,244,497,741
1000,507,498,509,254,502,756
1000,508,499,511,260,507,767
1000,523,516,471,271,477,748
1000,452,524,505,234,498,732
1000,494,499,536,262,491,753
1000,522,504,466,257,490,747
1000,491,539,494,251,494,745
1000,495,501,489,255,491,746
1000,508,492,497,248,500,748
1000,495,520,502,252,491,743
1000,484,489,527,234,517,751
1000,505,484,525,226,533,759
1000,507,501,488,239,507,746
1000,503,493,512,250,501,751
1000,497,484,510,238,508,746
1000,496,503,502,240,510,750
1000,485,510,491,239,503,742
1000,486,489,484,239,505,744
1000,486,487,520,233,522,755
1000,535,481,489,274,499,773
1000,482,497,492,240,487,727
1000,526,490,496,256,510,766
1000,491,486,511,244,519,763
1000,480,497,516,228,531,759
1000,498,477,509,236,513,749
1000,506,495,500,243,502,745
1000,502,487,501,239,493,732
1000,524,502,501,261,493,754
1000,499,489,484,247,499,746
1000,478,513,487,254,472,726
1000,487,500,507,234,505,739
1000,472,521,512,244,510,754
1000,502,497,488,248,498,746
1000,491,498,463,253,469,722
1000,500,514,496,257,480,737
1000,512,475,523,257,511,768
1000,500,497,529,248,521,769
1000,488,493,495,262,477,739
1000,520,522,487,270,485,755
1000,508,485,525,243,514,757
1000,504,494,523,254,490,744
1000,517,507,504,265,496,761
1000,511,499,504,243,527,770
1000,498,484,499,243,503,746
1000,515,495,499,258,503,761
1000,501,498,496,248,497,745
1000,469,501,514,237,510,747
1000,503,496,508,247,518,765
1000,478,480,531,244,505,749
1000,508,504,500,276,476,752
1000,481,489,499,221,520,741
1000,519,523,494,273,463,736
1000,494,496,502,234,515,749
1000,530,495,489,260,514,774
1000,481,520,530,248,505,753
1000,524,496,502,260,509,769
1000,505,499,507,252,505,757
1000,494,503,495,248,500,748
1000,473,490,513,244,509,753
1000,520,523,487,271,482,753
1000,507,472,504,232,520,752
1000,480,498,498,236,508,744
1000,502,522,485,278,456,734
1000,522,506,519,270,514,784
1000,495,514,497,259,475,734
1000,488,516,480,242,489,731
1000,500,472,503,232,514,746
1000,500,480,492,232,506,738
1000,500,502,523,252,501,753
1000,492,496,513,237,512,749
1000,500,516,504,259,486,745
1000,499,518,509,257,495,752
1000,506,509,505,250,509,759
1000,508,502,503,272,464,736
1000,500,509,494,264,489,753
1000,502,467,495,246,505,751
1000,484,506,501,245,497,742
1000,497,536,508,272,464,736
1000,506,504,488,252,486,738
1000,530,530,519,271,510,781
1000,505,482,489,240,508,748
1000,515,512,508,256,498,754
1000,527,522,490,285,476,761
1000,495,531,500,262,492,754
1000,517,489,492,250,501,751
1000,486,519,543,250,510,760
1000,486,486,501,224,509,733
1000,487,513,498,248,506,754
1000,506,478,508,244,510,754
1000,494,538,476,257,474,731
1000,513,498,494,258,508,766
1000,493,528,517,261,487,748
1000,487,512,511,250,498,748
1000,507,473,491,235,515,750
1000,505,488,495,246,504,750
1000,476,473,500,231,496,727
1000,504,508,514,251,508,759
1000,476,506,494,230,512,742
1000,495,498,480,250,472,722
1000,524,514,488,267,503,770
1000,473,507,499,248,491,739
1000,527,491,518,258,520,778
1000,508,517,502,258,498,756
1000,502,497,509,239,505,744
1000,550,513,516,283,508,791
1000,502,525,524,283,465,748
1000,504,478,486,229,517,746
1000,509,502,508,257,501,758
1000,523,480,454,246,481,727
1000,466,502,517,233,499,732
1000,501,514,523,261,496,757
1000,502,472,529,226,551,777
1000,511,501,505,251,505,756
1000,513,500,505,256,501,757
1000,520,486,516,245,524,769
1000,461,474,509,224,523,747
1000,515,532,488,289,458,747
1000,497,491,546,230,536,766
1000,502,479,494,242,511,753
1000,506,525,517,282,466,748
1000,474,527,521,244,498,742
1000,484,499,513,241,510,751
1000,521,490,509,249,527,776
1000,497,474,510,243,514,757
1000,494,499,465,226,498,724
1000,499,499,495,258,505,763
1000,474,505,511,249,491,740
1000,482,502,482,242,485,727
1000,491,510,481,257,472,729
1000,498,484,517,243,506,749
1000,524,494,488,254,498,752
1000,506,489,471,247,485,732
1000,508,483,515,244,521,765
1000,461,499,489,232,501,733
1000,500,526,473,254,496,750
1000,499,505,485,242,496,738
1000,528,514,483,279,478,757
1000,515,517,474,276,478,754
1000,490,500,495,251,484,735
1000,530,495,522,267,521,788
1000,484,480,489,231,507,738
1000,495,477,523,237,525,762
1000,500,490,512,232,522,754
1000,490,486,517,224,531,755
1000,487,505,508,252,486,738
1000,517,494,506,234,540,774
1000,518,497,498,266,506,772
1000,489,492,480,259,473,732
1000,495,524,508,268,468,736
1000,531,472,516,258,506,764
1000,504,534,503,277,475,752
1000,507,472,469,235,489,724
1000,507,509,503,250,509,759
1000,537,469,482,255,505,760
1000,490,497,502,254,505,759
1000,489,488,481,250,489,739
1000,480,512,505,254,491,745
1000,504,504,492,246,509,755
1000,495,506,493,246,503,749
1000,513,525,515,277,479,756
1000,536,501,518,278,508,786
1000,489,495,510,242,511,753
1000,479,511,480,248,485,733
1000,507,500,504,255,504,759
1000,492,503,528,246,517,763
1000,517,514,487,262,482,744
1000,474,523,514,244,487,731
1000,517,469,510,240,525,765
1000,503,500,494,259,480,739
1000,501,463,490,237,509,746
1000,498,496,536,257,519,776
1000,487,487,517,237,518,755
1000,509,479,528,242,513,755
1000,476,517,508,244,500,744
1000,542,488,528,271,509,780
1000,466,491,487,234,493,727
1000,514,485,512,244,520,764
1000,473,486,484,234,503,737
1000,494,474,480,234,502,736
1000,491,507,514,252,518,770
1000,479,495,473,237,476,713
1000,518,501,505,280,493,773
1000,503,486,511,245,518,763
1000,498,485,493,239,501,740
1000,497,484,508,241,512,753
1000,520,472,511,251,519,770
1000,524,527,486,276,470,746
1000,506,529,497,271,464,735
1000,506,498,500,236,524,760
1000,510,480,482,242,493,735
1000,525,500,506,266,508,774
1000,464,526,505,242,482,724
1000,501,477,523,242,527,769
1000,519,511,479,258,503,761
1000,507,515,513,272,484,756
1000,511,515,461,261,488,749
1000,495,510,502,255,482,737
1000,500,472,507,225,529,754
1000,513,499,495,257,501,758
1000,514,476,495,240,513,753
1000,505,484,503,247,513,760
1000,511,476,544,239,534,773
1000,495,525,509,270,489,759
1000,479,503,495,240,502,742
1000,508,524,534,260,504,764
1000,530,480,493,258,522,780
1000,514,535,489,267,490,757
1000,486,492,501,248,492,740
1000,521,489,480,257,492,749
1000,510,507,517,262,494,756
1000,489,493,504,240,500,740
1000,496,507,473,247,480,727
1000,496,509,540,237,534,771
1000,487,487,515,241,505,746
1000,500,511,488,249,484,733
1000,482,467,496,218,519,737
1000,507,500,494,257,484,741
1000,508,490,517,243,517,760
1000,485,504,501,238,497,735
1000,472,491,487,221,505,726
1000,501,490,513,240,516,756
1000,481,499,496,234,494,728
1000,509,488,486,256,495,751
1000,525,493,491,252,512,764
1000,528,498,522,273,512,785
1000,489,526,515,265,489,754
1000,488,520,513,246,502,748
1000,479,511,506,245,504,749
1000,481,503,499,243,481,724
1000,485,490,521,235,531,766
1000,504,476,522,251,506,757
1000,491,492,514,239,520,759
1000,501,528,486,264,489,753
1000,512,500,484,255,485,740
1000,490,519,506,253,506,759
1000,523,479,487,250,502,752
1000,500,488,487,234,496,730
1000,487,493,513,236,505,741
1000,474,494,502,231,521,752
1000,520,482,516,241,528,769
1000,498,505,490,252,494,746
1000,518,493,493,259,481,740
1000,508,509,521,259,517,776
1000,536,506,495,281,485,766
1000,508,468,499,227,535,762
1000,519,507,478,264,484,748
1000,525,503,538,260,515,775
1000,530,504,490,261,490,751
1000,491,481,488,217,519,736
1000,493,530,496,267,477,744
1000,507,513,507,256,496,752
1000,514,487,489,259,497,756
1000,509,465,484,230,506,736
1000,499,490,462,250,486,736
1000,534,505,497,271,497,768
1000,497,506,495,266,477,743
1000,518,487,501,256,509,765
1000,484,539,501,258,477,735
1000,516,462,503,229,525,754
1000,508,490,506,251,497,748
1000,497,482,509,230,517,747
1000,515,498,491,266,480,746
1000,510,517,517,273,491,764
1000,511,508,524,264,503,767
1000,516,494,485,258,481,739
1000,483,491,495,239,493,732
1000,484,499,487,231,515,746
1000,470,510,527,238,511,749
1000,493,494,486,245,481,726
1000,513,483,456,234,499,733
1000,497,527,500,248,504,752
1000,473,515,496,243,485,728
1000,490,480,536,221,542,763
1000,509,494,499,260,498,758
1000,459,507,504,237,489,726
1000,501,498,496,263,476,739
1000,515,451,504,250,496,746
1000,481,497,493,239,494,733
1000,535,494,502,247,519,766
1000,499,487,490,237,519,756
1000,484,493,507,247,503,750
1000,501,496,501,246,514,760
1000,485,502,494,245,481,726
1000,513,488,536,257,522,779
1000,514,514,503,267,501,768
1000,537,477,507,262,527,789
1000,538,481,500,243,534,777
1000,502,523,515,269,496,765
1000,517,477,509,237,522,759
1000,480,521,479,227,489,716
1000,515,496,501,264,483,747
1000,510,486,493,261,481,742
1000,491,489,508,247,507,754
1000,528,531,499,262,495,757
1000,510,488,470,252,491,743
1000,503,528,520,278,485,763
1000,522,484,478,258,484,742
1000,505,474,502,233,517,750
1000,484,511,472,253,461,714
1000,519,504,509,259,496,755
1000,523,499,486,268,506,774
1000,507,470,535,237,517,754
1000,462,519,525,231,530,761
1000,491,508,485,239,499,738
1000,505,483,532,241,532,773
1000,499,496,532,250,505,755
1000,494,507,493,267,483,750
1000,534,509,498,276,487,763
1000,506,469,514,235,535,770
1000,510,516,525,248,501,749
1000,488,487,506,243,496,739
1000,506,489,501,252,507,759
1000,503,516,512,248,518,766
1000,485,513,493,251,477,728
1000,494,480,498,232,527,759
1000,502,493,478,222,528,750
1000,495,485,493,239,489,728
1000,511,493,507,263,492,755
1000,484,493,492,238,505,743
1000,497,487,505,237,515,752
1000,504,504,469,250,478,728
1000,523,492,519,260,516,776
1000,510,511,502,267,508,775
1000,507,509,512,243,511,754
1000,481,510,494,240,503,743
1000,516,504,510,257,508,765
1000,496,504,493,246,507,753
1000,505,516,495,251,495,746
1000,499,484,496,255,495,750
1000,470,483,516,238,503,741
1000,483,511,501,258,486,744
1000,494,491,514,246,520,766
1000,504,489,497,231,516,747
1000,486,512,503,270,484,754
1000,493,487,495,238,502,740
1000,492,516,500,249,488,737
1000,515,511,503,250,517,767
1000,505,491,500,250,495,745
1000,508,495,514,240,518,758
1000,517,500,510,253,519,772
1000,508,490,481,242,499,741
1000,501,521,515,264,486,750
1000,482,488,501,244,512,756
1000,477,503,499,233,511,744
1000,520,485,495,256,499,755
1000,513,467,499,252,508,760
1000,494,499,528,243,515,758
1000,495,515,505,262,488,750
1000,514,496,499,254,512,766
1000,470,495,517,224,513,737
1000,503,501,508,261,502,763
1000,509,501,478,252,492,744
1000,484,498,476,255,471,726
1000,496,514,500,264,472,736
1000,485,510,516,252,506,758
1000,508,482,513,242,528,770
1000,508,497,511,261,507,768
1000,497,499,486,251,490,741
1000,488,478,537,238,519,757
1000,487,489,500,245,500,745
1000,497,525,493,254,490,744
1000,526,498,506,244,520,764
1000,480,482,499,220,530,750
1000,514,523,493,271,476,747
1000,510,485,543,234,534,768
1000,502,507,503,253,499,752
1000,512,479,527,245,531,776
1000,479,496,496,240,507,747
1000,486,501,476,241,470,711
1000,508,504,480,261,482,743
1000,497,493,488,251,503,754
1000,494,512,486,247,499,746
1000,500,497,529,258,509,767
1000,503,495,490,250,488,738
1000,493,493,491,244,498,742
1000,466,522,499,252,479,731
1000,513,500,519,250,507,757
1000,518,459,491,235,536,771
1000,456,507,506,236,505,741
1000,497,511,504,252,489,741
1000,488,492,505,236,521,757
1000,485,505,503,251,493,744
1000,493,522,502,260,479,739
1000,476,502,498,253,485,738
1000,489,519,484,237,489,726
1000,487,499,537,268,493,761
1000,497,489,464,239,502,741
1000,524,513,512,275,489,764
1000,466,497,480,234,485,719
1000,500,522,517,260,492,752
1000,502,516,507,271,485,756
1000,500,510,514,242,522,764
1000,506,504,521,252,514,766
1000,496,489,508,239,510,749
1000,494,485,512,238,501,739
1000,505,492,507,237,508,745
1000,509,493,504,255,492,747
1000,471,503,486,236,499,735
1000,502,524,490,270,482,752
1000,482,492,490,246,502,748
1000,515,504,478,267,483,750
1000,521,488,496,251,507,758
1000,511,491,501,254,503,757
1000,491,477,508,235,515,750
1000,498,472,504,227,544,771
1000,494,507,510,256,506,762
1000,486,467,478,215,509,724
1000,500,504,485,249,493,742
1000,507,471,506,225,532,757
1000,489,498,532,245,509,754
1000,515,474,486,243,485,728
1000,499,512,517,254,502,756
1000,503,488,507,255,492,747
1000,490,543,499,264,486,750
1000,494,501,517,253,493,746
1000,485,491,493,233,492,725
1000,496,486,488,236,500,736
1000,492,506,502,243,518,761
1000,482,491,498,230,500,730
1000,484,521,494,260,494,754
1000,483,483,486,229,506,735
1000,520,495,489,258,500,758
1000,511,492,509,242,505,747
1000,500,508,522,247,495,742
1000,475,484,524,217,548,765
1000,509,483,515,233,532,765
1000,479,505,500,248,493,741
1000,498,513,503,272,480,752
1000,500,499,483,249,514,763
1000,491,503,498,247,510,757
1000,472,522,495,227,490,717
1000,512,502,477,246,514,760
1000,490,497,484,241,501,742
1000,490,504,504,238,501,739
1000,513,505,515,260,493,753
1000,489,478,513,231,520,751
1000,498,512,517,266,486,752
1000,499,497,499,236,515,751
1000,495,480,509,241,504,745
1000,492,518,486,256,475,731
1000,483,470,492,230,506,736
1000,495,504,507,262,493,755
1000,489,497,485,254,489,743
1000,490,488,508,237,516,753
1000,481,518,499,244,499,743
1000,515,471,492,235,517,752
1000,512,478,511,253,504,757
1000,503,502,527,258,499,757
1000,501,499,520,258,499,757
1000,510,489,514,255,503,758
1000,514,511,504,273,489,762
1000,513,480,497,251,495,746
1000,501,536,483,263,489,752
1000,512,491,516,247,507,754
1000,485,528,501,267,475,742
1000,502,529,500,281,467,748
1000,513,516,508,257,511,768
1000,496,513,523,255,504,759
1000,502,500,480,263,475,738
1000,503,485,523,230,526,756
1000,519,522,485,269,493,762
1000,510,495,510,262,504,766
1000,500,480,498,250,509,759
1000,504,492,503,232,509,741
1000,485,499,502,241,482,723
1000,516,478,488,246,503,749
1000,509,521,505,280,471,751
1000,526,508,527,266,502,768
1000,478,510,523,250,493,743
1000,505,485,475,245,495,740
1000,508,502,516,253,515,768
1000,529,498,504,266,496,762
1000,507,501,498,254,493,747
1000,512,488,527,256,524,780
1000,507,498,520,262,503,765
1000,475,492,497,240,495,735
1000,497,491,522,237,513,750
1000,478,483,513,234,519,753
1000,492,502,490,241,515,756
1000,507,483,506,257,491,748
1000,509,487,499,234,514,748
1000,532,525,500,273,503,776
1000,547,500,493,275,504,779
1000,512,494,506,262,508,770
1000,486,495,502,246,484,730
1000,522,485,516,262,510,772
1000,496,509,517,248,511,759
1000,508,491,513,247,504,751
1000,485,508,487,250,486,736
1000,485,512,510,237,502,739
1000,481,524,499,253,477,730
1000,519,525,496,276,492,768
1000,487,516,502,248,493,741
1000,513,482,501,249,498,747
1000,527,516,505,257,514,771
1000,513,505,497,254,507,761
1000,531,477,494,250,515,765
1000,518,479,502,245,524,769
1000,499,503,508,239,515,754
1000,495,477,514,225,523,748
1000,485,503,515,251,499,750
1000,507,476,510,241,520,761
1000,519,504,506,256,495,751
1000,518,496,515,241,538,779
1000,494,493,525,248,511,759
1000,506,485,523,241,530,771
1000,485,498,508,242,498,740
1000,489,529,522,261,494,755
1000,498,500,494,251,504,755
1000,497,518,529,252,517,769
1000,496,537,494,284,477,761
1000,498,485,507,234,532,766
1000,502,488,506,243,510,753
1000,467,476,513,219,520,739
1000,512,487,458,262,475,737
1000,531,483,507,260,506,766
1000,510,495,504,259,490,749
1000,494,500,508,241,509,750
1000,504,529,518,256,502,758
1000,503,509,500,265,473,738
1000,500,513,505,253,506,759
1000,515,493,498,249,525,774
1000,510,477,491,244,521,765
1000,533,494,531,259,506,765
1000,500,494,473,234,498,732
1000,510,503,504,269,492,761
1000,504,503,476,261,474,735
1000,504,498,473,253,492,745
1000,499,496,517,245,518,763
1000,515,514,502,263,497,760
1000,491,504,520,246,503,749
1000,503,517,487,263,487,750
1000,480,512,507,242,494,736
1000,510,526,489,273,472,745
1000,543,527,517,302,486,788
1000,506,506,497,261,483,744
1000,494,504,481,244,494,738
1000,496,517,505,255,496,751
1000,506,499,506,259,498,757
1000,506,486,513,239,505,744
1000,509,499,541,262,513,775
1000,486,492,486,243,485,728
1000,515,490,495,240,496,736
1000,490,487,497,229,520,749
1000,512,510,510,251,520,771
1000,519,516,467,266,476,742
1000,517,495,494,260,494,754
1000,524,504,513,254,509,763
1000,510,504,492,254,507,761
1000,508,490,484,240,494,734
1000,491,500,503,241,507,748
1000,520,496,498,266,493,759
1000,487,516,490,249,499,748
1000,522,513,491,268,489,757
1000,499,517,502,254,498,752
1000,509,508,526,254,504,758
1000,493,501,451,257,468,725
1000,478,479,513,227,528,755
1000,479,472,503,219,522,741
1000,493,531,516,258,486,744
1000,488,481,473,226,508,734
1000,494,504,524,255,497,752
1000,514,510,489,279,471,750
1000,472,503,504,233,502,735
1000,507,498,522,255,504,759
1000,516,492,524,246,525,771
1000,496,515,502,251,494,745
1000,483,504,512,225,516,741
1000,508,496,496,244,520,764
1000,485,501,510,243,505,748
1000,499,513,526,253,506,759
1000,521,493,490,253,504,757
1000,501,500,511,262,503,765
1000,472,499,487,244,480,724
1000,510,494,508,253,493,746
1000,499,506,501,269,477,746
1000,519,512,482,274,477,751
1000,512,512,489,261,501,762
1000,503,519,502,262,501,763
1000,500,506,534,245,514,759
1000,492,488,462,233,500,733
1000,486,487,485,260,483,743
1000,481,485,506,232,511,743
1000,515,488,510,250,509,759
1000,516,478,486,249,499,748
1000,469,511,494,222,505,727
1000,503,482,512,238,520,758
1000,481,488,514,231,512,743
1000,509,487,508,243,511,754
1000,494,499,509,252,493,745
1000,538,490,485,260,500,760
1000,523,510,513,253,505,758
1000,495,505,506,254,506,760
1000,512,511,530,262,519,781
1000,456,502,505,229,508,737
1000,509,490,525,250,519,769
1000,490,512,478,253,478,731
1000,527,507,526,279,505,784
1000,515,536,516,274,481,755
1000,498,525,519,271,491,762
1000,486,476,488,240,502,742
1000,506,478,489,231,518,749
1000,490,497,502,258,492,750
1000,500,508,499,258,493,751
1000,491,485,514,245,508,753
1000,512,535,499,267,486,753
1000,477,493,498,217,516,733
1000,505,472,514,249,503,752
1000,497,467,483,224,532,756
1000,500,515,496,256,490,746
1000,525,474,510,252,507,759
1000,493,498,488,252,489,741
1000,514,492,495,259,513,772
1000,512,518,484,261,499,760
1000,494,480,501,231,508,739
1000,507,484,501,230,522,752
1000,504,464,536,253,523,776
1000,487,493,475,230,486,716
1000,513,515,483,263,488,751
1000,478,524,529,238,520,758
1000,522,476,467,260,480,740
1000,501,524,511,256,503,759
1000,476,510,485,240,489,729
1000,520,531,501,282,476,758
1000,522,522,477,284,458,742
1000,493,477,526,240,520,760
1000,505,499,494,260,494,754
1000,484,511,478,246,484,730
1000,507,523,499,260,492,752
1000,499,493,501,243,505,748
1000,553,485,480,269,496,765
1000,502,504,490,250,498,748
1000,538,502,538,267,517,784
1000,484,489,499,224,524,748
1000,495,502,518,257,508,765
1000,493,509,504,249,516,765
1000,512,497,480,257,492,749
1000,471,487,527,232,526,758
1000,496,479,500,244,504,748
1000,514,490,494,246,519,765
1000,506,524,475,286,448,734
1000,494,495,485,257,477,734
1000,498,500,486,254,488,742
1000,449,522,513,232,500,732
1000,514,525,489,268,481,749
1000,485,509,505,237,504,741
1000,513,530,494,273,482,755
1000,484,481,496,225,517,742
1000,524,481,512,256,515,771
1000,504,496,486,249,494,743
1000,489,530,515,246,502,748
1000,485,518,490,244,506,750
1000,483,489,483,251,484,735
1000,518,457,497,234,534,768
1000,477,511,492,246,497,743
1000,503,492,497,243,495,738
1000,508,502,514,254,508,762
1000,503,528,502,260,486,746
1000,511,500,500,255,495,750
1000,508,486,511,258,492,750
1000,470,500,492,241,490,731
1000,518,518,504,269,498,767
1000,509,489,477,248,498,746
1000,507,486,498,247,512,759
1000,504,514,498,266,492,758
1000,511,511,484,250,488,738
1000,505,487,486,260,494,754
1000,471,514,512,235,507,742
1000,466,483,485,226,498,724
1000,486,504,507,252,498,750
1000,518,487,494,244,510,754
1000,514,514,497,285,466,751
1000,499,524,537,265,494,759
1000,506,504,550,266,525,791
1000,527,509,492,264,493,757
1000,497,505,506,266,485,751
1000,491,493,522,233,533,766
1000,507,519,488,257,493,750
1000,512,478,489,247,509,756
1000,527,483,510,258,519,777
1000,502,495,499,241,499,740
1000,504,492,490,260,485,745
1000,543,471,490,259,511,770
1000,542,481,477,257,513,770
1000,515,482,518,255,516,771
1000,488,509,513,234,527,761
1000,491,497,469,252,479,731
1000,513,499,478,260,486,746
1000,499,498,507,240,530,770
1000,502,517,467,263,479,742
1000,516,517,506,262,510,772
1000,513,496,522,266,505,771
1000,508,505,473,249,489,738
1000,506,517,470,263,490,753
1000,518,506,532,263,508,771
1000,516,511,516,264,498,762
1000,512,508,502,243,501,744
1000,513,505,487,258,504,762
1000,497,475,480,228,511,739
1000,485,509,503,242,521,763
1000,506,507,528,260,507,767
1000,497,515,518,263,492,755
1000,479,489,524,241,507,748
1000,530,516,533,267,515,782
1000,475,496,513,235,508,743
1000,510,507,520,242,531,773
1000,490,485,493,232,504,736
1000,495,521,489,273,479,752
1000,501,508,478,253,491,744
1000,502,513,509,256,500,756
1000,485,482,477,235,506,741
1000,503,531,510,255,510,765
1000,496,499,509,242,509,751
1000,503,492,501,249,513,762
1000,471,476,504,225,524,749
1000,522,490,528,261,512,773
1000,521,507,485,273,482,755
1000,489,489,500,228,516,744
1000,539,538,528,290,486,776
1000,511,487,499,256,490,746
1000,514,501,505,250,511,761
1000,504,507,510,250,515,765
1000,502,494,494,248,486,734
1000,464,509,482,229,473,702
1000,503,510,454,274,448,722
1000,451,504,501,243,491,734
1000,501,532,483,267,467,734
1000,490,541,476,268,451,719
1000,482,498,474,229,502,731
1000,510,489,496,251,504,755
1000,495,497,507,241,518,759
1000,502,487,489,244,484,728
1000,523,492,518,259,508,767
1000,503,495,492,260,504,764
1000,498,487,490,239,507,746
1000,477,523,516,253,499,752
1000,506,500,490,235,525,760
1000,494,523,494,260,491,751
1000,511,505,499,260,499,759
1000,510,498,481,257,501,758
1000,481,510,498,250,498,748
1000,490,508,501,227,516,743
1000,500,521,487,258,489,747
1000,529,499,486,253,507,760
1000,499,535,499,259,480,739
1000,515,504,529,257,514,771
1000,511,485,489,247,503,750
1000,482,513,480,246,481,727
1000,507,499,497,251,497,748
1000,537,487,481,267,492,759
1000,499,490,510,244,503,747
1000,517,496,474,250,496,746
1000,481,511,511,231,516,747
1000,522,480,514,232,519,751
1000,510,502,500,252,514,766
1000,493,520,504,267,480,747
1000,504,523,485,261,485,746
1000,519,491,504,253,506,759
1000,480,524,507,253,487,740
1000,472,499,519,238,507,745
1000,498,481,515,250,486,736
1000,497,489,482,246,485,731
1000,519,485,537,251,524,775
1000,527,498,469,256,500,756
1000,496,530,480,259,471,730
1000,495,505,496,233,515,748
1000,492,490,483,237,494,731
1000,506,518,498,262,496,758
1000,515,508,492,246,521,767
1000,507,507,460,268,465,733
1000,505,512,503,249,501,750
1000,520,501,485,259,494,753
1000,490,499,504,250,490,740
1000,512,501,495,246,513,759
1000,492,504,502,250,493,743
1000,522,501,517,269,496,765
1000,505,506,483,254,481,735
1000,499,470,479,229,492,721
1000,504,508,523,256,505,761
1000,515,528,518,278,489,767
1000,488,503,486,254,490,744
1000,497,463,486,223,521,744
1000,480,502,492,257,488,745
1000,486,488,525,230,532,762
1000,490,460,518,222,540,762
1000,509,520,502,271,490,761
1000,499,520,491,254,498,752
1000,482,507,488,250,481,731
1000,528,486,502,272,500,772
1000,494,529,491,263,483,746
1000,502,505,522,272,497,769
1000,524,503,484,285,479,764
1000,468,485,495,212,522,734
1000,533,506,533,277,503,780
1000,528,511,524,253,515,768
1000,475,505,491,223,501,724
1000,497,508,502,240,520,760
1000,529,497,503,267,505,772
1000,531,535,489,284,472,756
1000,487,491,502,239,508,747
1000,479,495,494,237,518,755
1000,491,513,506,245,495,740
1000,506,523,506,263,489,752
1000,492,521,474,252,478,730
1000,503,459,483,227,536,763
1000,490,498,497,242,488,730
1000,514,476,491,249,504,753
1000,490,493,532,246,519,765
1000,525,508,498,268,486,754
1000,508,488,494,252,489,741
1000,504,491,489,240,519,759
1000,511,475,496,245,508,753
1000,511,499,501,260,499,759
1000,514,499,450,237,495,732
1000,482,503,480,249,491,740
1000,506,501,505,264,491,755
1000,529,493,522,254,525,779
1000,469,507,520,250,499,749
1000,501,471,520,237,529,766
1000,521,469,508,257,513,770
1000,501,467,517,230,527,757
1000,493,495,503,247,493,740
1000,521,497,501,262,504,766
1000,501,513,492,259,494,753
1000,502,496,481,253,490,743
1000,485,502,505,245,494,739
1000,510,502,504,257,489,746
1000,485,493,474,253,468,721
1000,470,538,487,241,478,719
1000,498,506,514,249,518,767
1000,521,507,488,270,489,759
1000,499,482,487,241,496,737
1000,478,503,493,251,484,735
1000,492,500,485,248,497,745
1000,502,486,506,231,522,753
1000,475,512,483,245,483,728
1000,511,514,498,261,496,757
1000,494,520,484,264,470,734
1000,497,522,519,268,497,765
1000,527,506,524,250,545,795
1000,486,513,496,250,494,744
1000,474,478,487,240,493,733
1000,497,486,511,249,505,754
1000,512,510,512,271,496,767
1000,493,486,488,244,486,730
1000,500,493,494,257,483,740
1000,481,470,490,220,517,737
1000,501,494,493,235,520,755
1000,525,504,495,266,507,773
1000,495,529,516,274,478,752
1000,525,519,521,274,505,779
1000,517,520,517,280,481,761
1000,496,491,506,243,522,765
1000,517,487,496,259,497,756
1000,487,517,508,241,514,755
1000,466,502,480,241,471,712
1000,474,511,496,242,515,757
1000,487,517,496,247,497,744
1000,493,474,512,243,492,735
1000,510,483,507,245,516,761
1000,502,511,515,267,482,749
1000,485,502,526,243,519,762
1000,504,486,530,260,510,770
1000,519,505,482,255,486,741
1000,502,501,513,249,500,749
1000,505,490,510,244,529,773
1000,527,526,509,272,493,765
1000,505,496,498,257,493,750
1000,515,489,485,252,497,749
1000,494,486,484,236,497,733
1000,511,521,496,276,471,747
1000,521,474,502,255,493,748
1000,490,488,506,240,494,734
1000,496,502,517,249,513,762
1000,523,513,473,266,493,759
1000,477,464,518,224,525,749
1000,490,502,507,251,495,746
1000,504,504,502,243,518,761
1000,528,506,477,267,488,755
1000,486,470,497,221,523,744
1000,511,484,477,245,491,736
1000,484,477,475,236,490,726
1000,508,506,483,248,511,759
1000,529,509,508,258,506,764
1000,479,499,514,220,527,747
1000,512,505,483,267,491,758
1000,547,484,527,265,523,788
1000,503,445,493,217,511,728
1000,483,498,508,229,525,754
1000,491,478,514,236,528,764
1000,511,500,506,252,504,756
1000,515,488,521,242,528,770
1000,491,470,505,246,499,745
1000,474,480,504,236,494,730
1000,497,495,489,243,524,767
1000,484,516,496,257,489,746
1000,490,496,482,243,498,741
1000,466,503,521,225,517,742
1000,512,494,497,256,499,755
1000,480,482,499,246,505,751
1000,500,482,500,232,515,747
1000,484,495,486,249,470,719
1000,492,499,509,243,501,744
1000,505,489,504,248,496,744
1000,501,504,486,242,495,737
1000,504,510,514,247,514,761
1000,499,494,476,255,479,734
1000,525,481,518,256,520,776
1000,517,515,510,262,511,773
1000,500,516,495,247,495,742
1000,489,499,500,256,486,742
1000,472,493,533,225,534,759
1000,508,467,500,236,519,755
1000,504,493,464,238,496,734
1000,508,515,514,264,511,775
1000,502,513,498,264,491,755
1000,499,489,494,246,499,745
1000,469,489,482,232,489,721
1000,498,491,517,238,525,763
1000,518,507,487,264,505,769
1000,497,485,478,240,515,755
1000,538,496,501,260,503,763
1000,513,513,488,277,469,746
1000,504,516,497,255,497,752
1000,476,501,492,236,484,720
1000,518,519,496,274,485,759
1000,493,518,525,263,489,752
1000,502,488,482,239,501,740
1000,507,457,496,232,518,750
1000,488,490,508,235,514,749
1000,496,504,478,255,492,747
1000,478,499,515,249,486,735
1000,530,506,521,271,497,768
1000,528,514,496,275,489,764
1000,518,522,467,275,461,736
1000,467,506,520,234,519,753
1000,494,499,490,241,514,755
1000,497,500,506,247,521,768
1000,505,493,491,243,499,742
1000,492,501,489,256,487,743
1000,515,477,491,234,521,755
1000,488,485,505,232,492,724
1000,512,507,510,255,487,742
1000,497,513,513,262,495,757
1000,503,489,513,252,501,753
1000,499,492,497,240,503,743
1000,502,500,495,257,491,748
1000,521,525,505,257,498,755
1000,501,516,492,264,467,731
1000,519,504,455,266,463,729
1000,491,498,501,237,501,738
1000,509,471,531,243,511,754
1000,499,503,517,245,521,766
1000,502,501,504,257,498,755
1000,519,516,491,278,475,753
1000,475,481,533,223,529,752
1000,511,505,506,260,525,785
1000,504,509,485,268,465,733
1000,475,481,516,216,528,744
1000,505,483,510,241,503,744
1000,489,486,498,230,506,736
1000,491,524,518,258,504,762
1000,512,501,520,254,525,779
1000,499,525,506,251,502,753
1000,487,502,489,247,500,747
1000,516,486,482,257,487,744
1000,496,474,498,245,494,739
1000,504,490,503,241,507,748
1000,504,482,495,258,492,750
1000,524,487,494,255,509,764
1000,511,533,482,264,495,759
1000,479,491,475,227,501,728
1000,470,495,469,223,497,720
1000,476,505,509,237,518,755
1000,497,504,496,246,516,762
1000,474,529,505,260,487,747
1000,488,473,497,230,511,741
1000,521,513,512,268,497,765
1000,513,481,496,259,492,751
1000,499,501,511,251,520,771
1000,489,526,503,249,482,731
1000,529,523,490,274,491,765
1000,460,477,523,206,530,736
1000,520,481,495,258,485,743
1000,495,482,504,242,519,761
1000,514,526,517,269,481,750
1000,480,495,465,233,481,714
1000,526,476,484,259,506,765
1000,488,515,497,256,489,745
1000,499,530,499,262,490,752
1000,540,489,494,253,511,764
1000,487,499,497,245,501,746
1000,529,541,513,301,465,766
1000,520,511,517,268,499,767
1000,526,471,519,241,532,773
1000,501,517,520,262,496,758
1000,485,510,503,249,492,741
1000,528,510,489,277,471,748
1000,491,483,512,238,513,751
1000,491,502,515,237,506,743
1000,463,508,516,247,502,749
1000,474,517,500,239,496,735
1000,523,506,512,282,483,765
1000,504,488,492,256,490,746
1000,479,537,493,261,472,733
1000,499,521,521,270,492,762
1000,499,492,483,261,482,743
1000,470,500,491,240,489,729
1000,502,485,503,257,490,747
1000,490,503,491,254,477,731
1000,492,506,500,240,496,736
1000,511,498,511,239,532,771
1000,483,491,486,243,497,740
1000,506,503,518,243,518,761
1000,499,499,517,253,502,755
1000,518,523,494,278,471,749
1000,512,492,521,251,519,770
1000,503,503,519,245,514,759
1000,489,491,521,222,535,757
1000,497,465,486,216,525,741
1000,493,498,506,253,497,750
1000,509,506,500,257,497,754
1000,492,489,496,249,486,735
1000,498,490,499,246,505,751
1000,484,486,518,241,507,748
1000,515,507,499,267,500,767
1000,516,479,523,249,535,784
1000,507,501,511,262,499,761
1000,498,490,470,242,475,717
1000,509,489,505,247,507,754
1000,496,491,515,246,507,753
1000,495,519,510,251,500,751
1000,515,512,496,250,498,748
1000,507,499,498,261,487,748
1000,517,520,477,265,477,742
1000,515,488,506,255,507,762
1000,504,513,483,245,487,732
1000,476,478,516,226,528,754
1000,497,506,499,250,496,746
1000,503,522,500,258,498,756
1000,500,492,504,267,483,750
1000,497,502,496,265,488,753
1000,484,482,486,248,492,740
1000,515,519,513,273,497,770
1000,506,478,480,240,515,755
1000,487,490,475,237,493,730
1000,496,520,506,256,486,742
1000,514,492,502,250,516,766
1000,493,473,487,224,513,737
1000,492,514,505,263,473,736
1000,501,494,498,257,482,739
1000,523,488,517,269,497,766
1000,530,494,530,271,513,784
1000,508,500,514,250,516,766
1000,484,492,524,228,527,755
1000,479,525,495,260,491,751
1000,489,528,495,265,478,743
1000,515,498,506,255,496,751
1000,508,474,496,239,525,764
1000,484,510,510,258,493,751
1000,489,523,525,248,525,773
1000,508,502,482,260,472,732
1000,523,494,494,259,501,760
1000,491,498,519,254,506,760
1000,471,483,497,216,507,723
1000,509,472,468,235,513,748
1000,480,503,490,252,491,743
1000,495,486,483,230,502,732
1000,486,488,523,246,505,751
1000,516,506,517,259,505,764
1000,508,480,496,242,510,752
1000,483,515,483,249,481,730
1000,510,478,465,245,502,747
1000,478,473,505,225,518,743
1000,517,504,494,267,499,766
1000,499,492,488,239,507,746
1000,489,502,519,237,521,758
1000,488,515,507,251,489,740
1000,521,497,495,256,493,749
1000,493,533,531,267,504,771
1000,490,496,510,242,500,742
1000,497,496,465,253,458,711
1000,506,497,512,254,502,756
1000,509,492,507,241,517,758
1000,514,497,534,266,512,778
1000,478,481,500,212,522,734
1000,502,532,493,256,490,746
1000,490,479,506,231,505,736
1000,507,497,521,252,513,765
1000,510,497,495,265,494,759
1000,507,500,493,252,500,752
1000,509,516,499,263,489,752
1000,508,483,512,252,498,750
1000,481,509,478,250,467,717
1000,499,491,489,240,507,747
1000,475,485,537,232,515,747
1000,478,482,492,234,514,748
1000,496,504,518,249,528,777
1000,510,466,493,241,512,753
1000,517,494,498,273,486,759
1000,494,489,479,243,487,730
1000,509,497,493,273,466,739
1000,479,508,503,230,517,747
1000,514,505,490,263,483,746
1000,508,486,523,258,506,764
1000,503,518,484,267,482,749
1000,510,482,509,241,510,751
1000,475,519,496,251,483,734
1000,500,526,515,271,474,745
1000,530,492,488,256,503,759
1000,489,488,518,235,516,751
1000,475,487,504,248,493,741
1000,517,488,491,248,496,744
1000,493,523,525,254,499,753
1000,493,477,489,238,490,728
1000,512,512,495,281,472,753
1000,507,489,478,255,491,746
1000,529,544,507,293,473,766
1000,516,494,485,260,489,749
1000,547,508,510,272,499,771
1000,535,513,474,267,487,754
1000,494,484,513,243,525,768
1000,510,524,489,274,485,759
1000,470,482,506,220,516,736
1000,484,478,501,236,499,735
1000,537,513,508,282,489,771
1000,500,498,489,256,492,748
1000,499,512,485,251,484,735
1000,535,463,523,251,519,770
1000,496,519,512,269,494,763
1000,478,507,506,251,482,733
1000,494,507,512,248,497,745
1000,516,500,491,260,500,760
1000,522,513,495,263,492,755
1000,500,481,542,233,539,772
1000,481,502,502,252,501,753
1000,496,511,493,252,486,738
1000,502,493,486,250,508,758
1000,495,502,530,253,509,762
1000,503,496,484,248,496,744
1000,483,502,469,241,492,733
1000,488,499,504,237,518,755
1000,484,472,487,213,530,743
1000,494,522,497,263,486,749
1000,514,526,526,273,505,778
1000,505,498,504,259,486,745
1000,516,479,498,276,481,757
1000,519,498,502,249,524,773
1000,498,485,511,242,513,755
1000,518,503,505,272,482,754
1000,505,504,485,238,499,737
1000,474,521,505,241,494,735
1000,538,510,484,261,508,769
1000,482,485,495,240,493,733
1000,493,508,499,268,477,745
1000,497,499,488,249,493,742
1000,511,509,488,241,518,759
1000,465,518,511,228,510,738
1000,489,510,497,243,507,750
1000,507,519,482,261,472,733
1000,511,493,472,245,495,740
1000,503,496,507,253,499,752
1000,514,509,487,259,500,759
1000,515,479,495,257,497,754
1000,473,490,488,220,504,724
1000,474,508,504,242,487,729
1000,506,485,508,244,498,742
1000,501,508,496,243,504,747
1000,480,495,505,237,493,730
1000,485,496,507,252,481,733
1000,501,516,499,255,494,749
1000,496,491,530,236,524,760
1000,491,516,493,251,490,741
1000,490,502,499,251,486,737
1000,466,511,483,228,502,730
1000,498,498,522,238,523,761
1000,477,523,500,247,489,736
1000,514,468,485,247,496,743
1000,507,519,498,254,501,755
1000,490,526,478,249,496,745
1000,503,473,512,245,513,758
1000,524,500,459,242,504,746
1000,498,497,485,233,527,760
1000,500,460,499,241,498,739
1000,501,515,524,255,512,767
1000,498,491,476,240,488,728
1000,487,508,514,246,502,748
1000,496,523,525,250,517,767
1000,485,511,503,242,495,737
1000,513,499,496,246,516,762
1000,527,504,508,262,522,784
1000,500,483,533,227,543,770
1000,493,481,481,237,508,745
1000,517,508,482,271,474,745
1000,474,538,502,259,477,736
1000,510,497,506,249,504,753
1000,494,515,498,252,487,739
1000,521,484,507,259,493,752
1000,493,518,500,264,468,732
1000,521,492,510,271,492,763
1000,499,490,498,250,496,746
1000,484,503,508,230,520,750
1000,538,513,501,283,491,774
1000,502,511,485,249,492,741
1000,517,502,515,266,499,765
1000,519,501,528,254,526,780
1000,504,494,505,247,500,747
1000,497,497,494,249,500,749
1000,496,489,503,243,517,760
1000,526,509,498,282,479,761
1000,498,548,493,268,487,755
1000,517,486,497,264,504,768
1000,516,511,502,244,508,752
1000,531,493,475,266,484,750
1000,514,485,530,242,529,771
1000,506,471,497,231,514,745
1000,482,511,480,237,482,719
1000,489,503,496,243,490,733
1000,463,510,517,240,511,751
1000,499,500,527,247,511,758
1000,492,487,501,238,501,739
1000,492,489,503,239,491,730
1000,463,479,506,228,515,743
1000,510,508,502,257,492,749
1000,486,507,502,236,514,750
1000,524,495,481,260,486,746
1000,505,486,484,233,515,748
1000,506,493,498,249,504,753
1000,487,474,490,221,515,736
1000,502,505,499,252,489,741
1000,515,527,518,279,478,757
1000,509,532,475,297,442,739
1000,498,500,521,255,499,754
1000,502,501,500,249,502,751
1000,488,492,491,253,490,743
1000,504,508,498,239,511,750
1000,523,473,498,260,491,751
1000,525,488,508,253,510,763
1000,509,481,500,240,513,753
1000,466,499,501,229,508,737
1000,492,500,502,236,510,746
1000,484,518,481,272,446,718
1000,536,493,503,270,498,768
1000,490,503,507,246,509,755
1000,493,496,502,248,504,752
1000,495,526,497,266,476,742
1000,518,505,507,262,512,774
1000,490,533,481,252,471,723
1000,507,493,499,258,492,750
1000,495,490,518,256,499,755
1000,486,501,516,247,507,754
1000,485,478,503,243,505,748
1000,517,513,477,272,479,751
1000,495,490,508,237,523,760
1000,486,536,486,259,467,726
1000,478,503,502,258,488,746
1000,481,504,527,234,512,746
1000,510,508,501,250,512,762
1000,477,509,485,241,493,734
1000,486,507,498,252,486,738
1000,512,514,473,262,486,748
1000,530,496,510,262,499,761
1000,503,520,490,261,491,752
1000,496,519,508,248,511,759
1000,490,492,488,236,506,742
1000,500,510,522,263,489,752
1000,498,527,475,260,463,723
1000,490,524,500,255,491,746
1000,485,515,502,263,473,736
1000,518,526,499,262,507,769
1000,506,502,477,257,482,739
1000,500,497,492,254,496,750
1000,483,489,493,241,488,729
1000,489,501,525,243,522,765
1000,478,491,475,231,494,725
1000,467,495,480,243,479,722
1000,505,497,491,252,502,754
1000,485,501,495,244,488,732
1000,498,498,502,249,501,750
1000,497,503,521,253,500,753
1000,512,496,500,248,510,758
1000,512,483,493,245,499,744
1000,517,493,501,248,507,755
1000,499,506,488,261,473,734
1000,508,493,501,257,488,745
1000,532,491,494,253,511,764
1000,509,504,496,247,520,767
1000,488,509,481,247,507,754
1000,502,485,491,232,503,735
1000,510,476,480,246,509,755
1000,512,483,505,252,499,751
1000,507,526,473,260,495,755
1000,490,491,478,223,494,717
1000,502,514,505,254,510,764
1000,503,510,523,255,491,746
1000,484,487,504,237,507,744
1000,508,491,502,235,509,744
1000,512,507,498,260,477,737
1000,519,532,491,272,493,765
1000,483,499,472,244,492,736
1000,487,529,500,257,475,732
1000,492,513,492,260,487,747
1000,511,494,506,268,505,773
1000,494,533,521,262,492,754
1000,508,524,491,264,493,757
1000,493,480,511,245,485,730
1000,490,500,518,241,507,748
1000,506,503,500,260,494,754
1000,513,517,509,266,495,761
1000,509,497,486,252,499,751
1000,505,515,503,256,500,756
1000,492,454,513,220,538,758
1000,519,497,500,258,500,758
1000,488,495,497,238,513,751
1000,526,532,483,269,475,744
1000,487,517,500,257,494,751
1000,481,515,521,234,509,743
1000,508,508,496,257,494,751
1000,515,511,497,265,505,770
1000,534,493,481,262,474,736
1000,479,517,505,243,508,751
1000,489,499,519,241,514,755
1000,524,493,489,257,493,750
1000,494,510,490,269,467,736
1000,486,485,513,256,487,743
1000,522,506,507,255,505,760
1000,491,519,517,252,496,748
1000,488,486,494,241,510,751
1000,497,514,495,251,479,730
1000,494,520,478,263,463,726
1000,518,504,494,254,498,752
1000,500,498,510,254,510,764
1000,492,498,468,245,477,722
1000,513,521,495,276,477,753
1000,498,498,497,243,492,735
1000,491,493,511,236,516,752
1000,499,488,480,251,481,732
1000,504,532,533,270,491,761
1000,490,495,493,252,499,751
1000,488,542,515,263,507,770
1000,534,484,490,263,493,756
1000,469,523,521,242,511,753
1000,473,507,509,242,506,748
1000,512,482,481,240,490,730
1000,489,494,500,237,499,736
1000,495,516,502,261,493,754
1000,481,486,530,246,521,767
1000,524,496,495,259,514,773
1000,485,520,498,260,474,734
1000,472,503,498,252,479,731
1000,476,508,498,231,500,731
1000,502,509,506,257,500,757
1000,490,473,516,216,528,744
1000,486,501,501,244,497,741
1000,485,489,477,245,494,739
1000,487,500,496,254,487,741
1000,509,496,518,256,509,765
1000,510,521,499,261,483,744
1000,516,514,480,258,481,739
1000,502,513,507,252,485,737
1000,504,482,507,232,529,761
1000,514,499,486,257,484,741
1000,509,486,514,249,500,749
1000,486,479,506,241,509,750
1000,504,482,536,247,527,774
1000,475,477,487,223,522,745
1000,501,497,465,242,482,724
1000,503,508,514,258,508,766
1000,504,495,517,243,525,768
1000,499,514,492,246,509,755
1000,505,519,522,265,497,762
1000,485,490,485,246,488,734
1000,480,490,497,228,509,737
1000,499,506,492,246,509,755
1000,505,509,481,266,482,748
1000,517,494,480,251,503,754
1000,527,500,505,276,515,791
1000,485,515,519,247,498,745
1000,506,497,517,262,498,760
1000,512,534,481,271,476,747
1000,521,534,500,280,479,759
1000,515,512,487,274,484,758
1000,454,510,489,232,495,727
1000,500,507,469,243,486,729
1000,476,495,486,228,496,724
1000,502,498,493,245,498,743
1000,498,512,505,264,480,744
1000,490,525,502,253,494,747
1000,492,492,500,248,509,757
1000,470,504,512,222,510,732
1000,505,514,511,256,503,759
1000,491,486,490,237,499,736
1000,472,487,500,233,504,737
1000,509,512,505,255,495,750
1000,500,505,528,261,501,762
1000,470,492,499,238,492,730
1000,489,475,493,229,509,738
1000,477,504,503,247,475,722
1000,503,513,494,257,486,743
1000,485,527,533,250,515,765
1000,523,495,502,255,494,749
1000,505,542,515,261,502,763
1000,500,491,507,239,508,747
1000,508,490,494,258,496,754
1000,541,530,522,286,507,793
1000,480,509,477,236,494,730
1000,523,526,490,267,480,747
1000,495,514,514,256,495,751
1000,483,494,498,242,487,729
1000,494,511,487,255,493,748
1000,497,487,473,246,496,742
1000,500,500,498,238,506,744
1000,498,501,514,264,493,757
1000,498,496,492,243,498,741
1000,496,482,500,234,509,743
1000,498,497,494,259,481,740
1000,494,483,496,249,486,735
1000,523,501,534,266,510,776
1000,503,489,497,254,499,753
1000,491,511,498,245,514,759
1000,490,495,507,242,498,740
1000,487,475,501,233,498,731
1000,532,492,538,283,497,780
1000,488,497,518,237,518,755
1000,531,521,499,266,476,742
1000,502,477,518,229,543,772
1000,474,522,515,262,485,747
1000,495,515,506,264,476,740
1000,487,471,486,238,501,739
1000,493,534,509,268,475,743
1000,515,520,492,264,498,762
1000,481,497,482,242,501,743
1000,519,487,503,264,500,764
1000,491,501,477,231,493,724
1000,513,510,467,270,473,743
1000,512,499,496,246,507,753
1000,504,510,503,265,488,753
1000,515,496,512,255,513,768
1000,520,514,509,270,514,784
1000,511,548,498,285,472,757
1000,500,480,516,223,520,743
1000,514,495,496,242,500,742
1000,488,512,504,247,490,737
1000,492,508,513,260,496,756
1000,494,520,501,259,495,754
1000,502,539,502,278,465,743
1000,537,514,496,289,489,778
1000,519,496,514,266,491,757
1000,477,497,515,253,495,748
1000,498,487,461,240,499,739
1000,505,511,501,272,471,743
1000,492,503,505,262,498,760
1000,506,482,515,253,509,762
1000,509,488,488,253,501,754
1000,498,495,514,251,515,766
1000,511,489,501,245,500,745
1000,484,484,501,237,502,739
1000,486,499,514,233,512,745
1000,495,514,526,266,502,768
1000,487,524,516,265,491,756
1000,491,478,498,230,503,733
1000,497,528,502,262,482,744
1000,511,505,515,266,489,755
1000,507,519,507,273,498,771
1000,518,499,506,254,500,754
1000,520,514,529,268,488,756
1000,489,518,506,249,511,760
1000,498,511,485,253,481,734
1000,494,558,510,275,480,755
1000,460,500,488,247,464,711
1000,509,512,498,259,487,746
1000,506,509,501,252,502,754
1000,524,507,496,256,526,782
1000,498,491,510,227,520,747
1000,491,492,500,238,499,737
1000,484,510,486,245,476,721
1000,473,511,477,246,485,731
1000,489,507,493,252,490,742
1000,514,478,516,254,506,760
1000,515,522,523,269,494,763
1000,512,521,495,260,495,755
1000,465,499,519,234,501,735
1000,504,474,496,233,512,745
1000,522,495,492,256,509,765
1000,502,516,507,255,507,762
1000,501,485,503,255,499,754
1000,494,523,499,252,497,749
1000,520,488,495,260,502,762
1000,513,518,492,254,498,752
1000,519,510,514,255,508,763
1000,467,508,508,228,507,735
1000,508,505,518,262,499,761
1000,530,524,482,269,492,761
1000,521,493,490,260,494,754
1000,510,470,538,238,539,777
1000,468,518,476,240,481,721
1000,505,475,518,245,520,765
1000,505,492,498,249,508,757
1000,527,501,511,272,489,761
1000,501,481,490,248,495,743
1000,501,502,508,249,509,758
1000,502,516,489,259,488,747
1000,484,501,519,239,513,752
1000,508,496,498,241,505,746
1000,483,495,480,238,486,724
1000,500,517,512,258,485,743
1000,519,499,485,251,505,756
1000,480,479,512,223,530,753
1000,515,501,501,265,498,763
1000,522,503,483,275,463,738
1000,497,519,499,248,510,758
1000,514,507,509,267,498,765
1000,495,505,448,261,457,718
1000,497,509,499,254,494,748
1000,495,538,497,266,491,757
1000,497,518,492,249,480,729
1000,520,473,501,261,499,760
1000,492,509,493,253,498,751
1000,484,512,501,253,484,737
1000,511,492,491,247,513,760
1000,506,479,505,237,516,753
1000,500,487,503,219,531,750
1000,506,506,473,255,466,721
1000,487,479,508,240,511,751
1000,510,498,495,268,472,740
1000,537,508,502,271,502,773
1000,504,483,509,244,510,754
1000,475,501,503,249,487,736
1000,492,513,515,246,505,751
1000,494,479,500,235,513,748
1000,486,513,509,257,496,753
1000,476,511,457,239,481,720
1000,493,490,493,236,506,742
1000,484,504,484,239,501,740
1000,490,506,524,238,515,753
1000,498,473,505,251,490,741
1000,516,492,498,254,496,750
1000,553,503,483,280,483,763
1000,493,473,521,236,517,753
1000,470,493,480,240,477,717
1000,515,513,507,286,479,765
1000,515,474,511,239,535,774
1000,475,499,491,238,484,722
1000,527,488,511,260,503,763
1000,513,516,519,267,493,760
1000,525,520,494,275,491,766
1000,497,499,522,258,505,763
1000,514,474,502,248,509,757
1000,497,507,528,256,507,763
1000,507,477,509,236,528,764
1000,490,490,503,237,521,758
1000,488,486,493,240,498,738
1000,495,482,507,234,512,746
1000,490,478,494,231,518,749
1000,509,527,522,261,496,757
1000,515,486,473,241,509,750
1000,518,492,477,230,531,761
1000,498,501,484,257,496,753
1000,505,490,501,232,531,763
1000,502,535,495,265,482,747
1000,487,511,504,257,490,747
1000,490,498,489,252,487,739
1000,473,503,524,236,517,753
1000,503,519,518,260,507,767
1000,512,513,522,258,493,751
1000,507,494,484,255,497,752
1000,485,486,501,249,501,750
1000,522,479,523,255,521,776
1000,495,501,472,236,502,738
1000,491,492,527,247,511,758
1000,511,505,528,252,506,758
1000,499,508,522,252,502,754
1000,481,526,476,230,512,742
1000,497,516,531,252,529,781
1000,511,502,507,258,503,761
1000,497,482,505,231,524,755
1000,506,518,507,276,486,762
1000,500,499,507,257,505,762
1000,482,478,450,241,472,713
1000,499,497,508,224,521,745
1000,491,511,483,250,499,749
1000,513,506,469,249,489,738
1000,504,498,470,243,500,743
1000,509,492,499,238,507,745
1000,503,481,482,250,491,741
1000,502,505,479,241,504,745
1000,507,487,520,239,526,765
1000,488,519,479,250,473,723
1000,461,506,495,230,499,729
1000,488,509,493,244,499,743
1000,489,499,517,224,525,749
1000,484,499,531,252,512,764
1000,514,482,523,247,519,766
1000,514,504,476,252,470,722
1000,472,472,513,217,518,735
1000,501,522,519,260,494,754
1000,476,509,478,242,480,722
1000,492,527,479,254,500,754
1000,525,502,504,257,508,765
1000,523,485,506,262,495,757
1000,487,497,512,225,516,741
1000,499,477,522,234,513,747
1000,519,500,504,265,514,779
1000,505,491,464,263,475,738
1000,483,493,469,245,481,726
1000,480,500,509,232,518,750
1000,483,489,518,230,513,743
1000,512,502,512,252,496,748
1000,492,495,518,242,505,747
1000,482,518,497,252,487,739
1000,490,502,523,231,528,759
1000,483,507,500,246,496,742
1000,505,522,508,243,502,745
1000,503,481,483,247,504,751
1000,485,517,499,258,482,740
1000,502,520,511,264,491,755
1000,516,491,476,254,495,749
1000,523,494,501,256,507,763
1000,502,528,504,251,508,759
1000,500,511,502,263,502,765
1000,489,543,521,277,472,749
1000,485,510,496,245,486,731
1000,478,520,546,240,527,767
1000,475,499,495,243,493,736
1000,493,499,486,258,480,738
1000,507,450,489,236,508,744
1000,505,492,497,257,489,746
1000,494,487,514,244,521,765
1000,508,488,499,254,504,758
1000,485,503,468,249,479,728
1000,479,499,500,230,499,729
1000,516,487,504,266,505,771
1000,477,484,484,234,493,727
1000,506,483,496,254,491,745
1000,484,490,503,224,523,747
1000,531,496,492,266,474,740
1000,514,512,512,267,500,767
1000,487,513,499,258,478,736
1000,491,512,497,263,473,736
1000,494,500,495,250,476,726
1000,481,503,510,241,503,744
1000,517,506,504,266,487,753
1000,482,494,530,241,514,755
1000,501,503,488,260,484,744
1000,496,479,510,252,498,750
1000,503,519,515,269,493,762
1000,530,509,473,264,498,762
1000,500,476,495,253,506,759
1000,484,512,503,253,495,748
1000,520,501,510,277,504,781
1000,516,506,524,255,505,760
1000,494,503,484,259,492,751
1000,506,532,496,275,480,755
1000,494,509,506,252,505,757
1000,516,532,488,255,497,752
1000,503,520,475,259,469,728
1000,521,485,499,254,506,760
1000,492,496,501,240,533,773
1000,502,497,519,247,522,769
1000,491,519,505,254,496,750
1000,515,509,493,264,491,755
1000,493,522,517,253,504,757
1000,488,480,502,241,500,741
1000,514,501,531,252,532,784
1000,484,507,511,258,485,743
1000,512,522,499,263,490,753
1000,526,491,506,269,509,778
1000,510,507,498,263,498,761
1000,517,500,499,249,499,748
1000,505,478,482,249,485,734
1000,487,519,482,260,481,741
1000,499,492,486,256,508,764
1000,518,519,499,265,501,766
1000,525,515,468,267,477,744
1000,503,493,507,255,511,766
1000,490,522,512,254,508,762
1000,488,509,484,251,485,736
1000,515,504,507,255,513,768
1000,496,517,489,256,487,743
1000,481,496,518,239,516,755
1000,503,463,499,230,528,758
1000,506,486,517,231,531,762
1000,496,500,484,258,484,742
1000,499,492,492,264,495,759
1000,501,532,513,260,497,757
1000,484,519,503,248,488,736
1000,506,534,505,274,480,754
1000,507,495,487,267,480,747
1000,507,479,493,250,499,749
1000,482,491,528,242,513,755
1000,491,500,515,243,504,747
1000,478,514,503,252,489,741
1000,524,508,473,265,470,735
1000,526,509,507,262,508,770
1000,510,496,513,250,514,764
1000,508,497,483,252,486,738
1000,487,497,536,259,501,760
1000,500,492,532,256,514,770
1000,512,501,506,255,506,761
1000,472,522,489,238,491,729
1000,488,492,498,233,516,749
1000,464,478,473,224,486,710
1000,498,503,481,239,490,729
1000,503,508,497,250,506,756
1000,482,496,475,256,469,725
1000,514,505,494,257,490,747
1000,501,488,531,236,518,754
1000,501,521,531,266,490,756
1000,511,506,512,257,500,757
1000,512,534,501,272,491,763
1000,509,504,478,269,482,751
1000,532,484,495,246,515,761
1000,484,509,499,238,508,746
1000,486,499,477,241,488,729
1000,491,498,535,245,505,750
1000,517,485,490,248,495,743
1000,492,488,476,233,505,738
1000,518,502,494,263,493,756
1000,493,500,485,243,484,727
1000,508,507,488,265,483,748
1000,496,509,490,256,481,737
1000,486,491,493,243,487,730
1000,529,494,476,266,484,750
1000,484,502,504,235,509,744
1000,529,515,510,277,491,768
1000,498,530,503,247,507,754
1000,513,491,475,255,487,742
1000,486,492,493,258,487,745
1000,513,496,504,253,503,756
1000,505,508,494,263,494,757
1000,472,509,495,232,487,719
1000,491,476,497,236,510,746
1000,493,504,488,252,479,731
1000,513,513,519,252,511,763
1000,482,478,517,225,516,741
1000,494,505,491,249,489,738
1000,484,509,493,251,491,742
1000,507,508,500,248,512,760
1000,521,510,498,265,499,764
1000,501,510,514,262,493,755
1000,507,494,509,258,501,759
1000,501,517,500,266,485,751
1000,510,484,502,249,501,750
1000,510,526,503,265,488,753
1000,506,507,482,249,488,737
1000,525,508,498,268,490,758
1000,517,494,512,267,506,773
1000,477,499,488,222,503,725
1000,482,512,507,241,502,743
1000,519,497,510,261,503,764
1000,502,499,491,262,485,747
1000,491,511,494,253,483,736
1000,514,486,519,250,521,771
1000,503,504,494,248,503,751
1000,515,512,499,266,497,763
1000,476,491,492,231,505,736
1000,501,500,511,242,507,749
1000,527,523,506,264,503,767
1000,531,500,509,271,506,777
1000,501,497,482,247,497,744
1000,517,499,486,258,499,757
1000,517,454,502,243,523,766
1000,487,497,506,250,495,745
1000,504,487,496,243,501,744
1000,477,520,521,247,507,754
1000,501,508,485,256,498,754
1000,518,504,501,267,496,763
1000,496,491,518,256,493,749
1000,509,507,473,263,477,740
1000,485,481,513,234,521,755
1000,491,518,514,237,523,760
1000,514,519,483,261,498,759
1000,511,497,503,260,487,747
1000,499,491,522,250,523,773
1000,491,452,485,226,515,741
1000,485,523,484,250,482,732
1000,499,502,507,236,520,756
1000,509,506,513,263,490,753
1000,501,521,495,246,504,750
1000,492,500,506,260,499,759
1000,487,508,479,239,504,743
1000,495,521,495,250,498,748
1000,491,474,499,232,521,753
1000,502,507,478,255,479,734
1000,498,497,483,261,468,729
1000,501,507,471,273,463,736
1000,490,496,516,244,515,759
1000,516,523,494,263,490,753
1000,495,488,535,238,537,775
1000,526,493,486,266,486,752
1000,493,506,508,266,467,733
1000,517,527,491,266,478,744
1000,495,495,492,236,508,744
1000,482,492,501,238,491,729
1000,513,490,486,248,513,761
1000,504,501,518,259,501,760
1000,487,512,482,246,499,745
1000,510,501,476,266,486,752
1000,506,482,515,263,496,759
1000,504,499,503,264,470,734
1000,471,509,489,244,494,738
1000,506,505,495,259,505,764
1000,533,508,504,258,514,772
1000,480,522,502,252,484,736
1000,495,487,534,241,529,770
1000,501,501,512,255,495,750
1000,499,519,480,277,471,748
1000,492,467,505,224,520,744
1000,505,515,512,260,490,750
1000,488,507,500,256,471,727
1000,477,520,523,241,501,742
1000,508,481,492,237,511,748
1000,510,494,502,261,510,771
1000,520,490,496,260,507,767
1000,491,497,488,231,511,742
1000,512,512,491,255,480,735
1000,522,545,509,278,491,769
1000,527,522,504,271,478,749
1000,540,493,511,251,519,770
1000,516,497,513,258,499,757
1000,503,512,499,269,490,759
1000,491,500,496,246,481,727
1000,489,528,492,265,471,736
1000,510,511,503,272,491,763
1000,516,492,509,257,515,772
1000,475,491,503,246,501,747
1000,506,512,516,263,508,771
1000,489,496,506,241,504,745
1000,501,503,495,258,486,744
1000,517,482,533,249,515,764
1000,481,497,523,219,536,755
1000,521,501,505,248,525,773
1000,501,468,523,226,549,775
1000,508,517,510,273,477,750
1000,488,488,498,243,497,740
1000,502,522,501,266,480,746
1000,500,499,499,266,489,755
1000,513,526,521,263,515,778
1000,508,487,478,258,480,738
1000,480,506,492,250,482,732
1000,493,468,495,222,514,736
1000,499,477,495,231,518,749
1000,480,499,489,226,520,746
1000,527,494,479,285,462,747
1000,493,530,479,262,472,734
1000,498,523,504,260,499,759
1000,492,482,501,231,523,754
1000,505,502,495,247,510,757
1000,494,526,494,262,480,742
1000,535,528,503,272,500,772
1000,531,483,498,254,520,774
1000,504,509,491,262,490,752
1000,516,504,490,258,498,756
1000,503,505,505,245,521,766
1000,514,507,511,264,498,762
1000,490,506,508,252,493,745
1000,527,481,492,266,486,752
1000,513,469,504,244,526,770
1000,506,470,462,235,483,718
1000,492,495,520,233,515,748
1000,502,518,483,257,494,751
1000,483,490,478,247,481,728
1000,477,509,467,245,476,721
1000,514,489,506,257,491,748
1000,487,481,519,241,517,758
1000,493,502,497,247,501,748
1000,500,482,505,246,502,748
1000,523,497,502,263,501,764
1000,515,500,504,256,503,759
1000,507,503,498,251,488,739
1000,499,495,497,247,488,735
1000,486,507,482,250,476,726
1000,499,537,513,270,487,757
1000,488,484,477,239,494,733
1000,494,514,501,258,481,739
1000,503,455,500,200,544,744
1000,519,521,479,280,451,731
1000,485,510,500,241,505,746
1000,495,491,490,246,497,743
1000,507,494,474,253,486,739
1000,499,511,486,262,489,751
1000,472,516,477,247,482,729
1000,513,497,532,262,492,754
1000,469,516,494,233,503,736
1000,505,476,515,233,526,759
1000,499,499,520,249,505,754
1000,494,464,524,233,540,773
1000,528,491,477,268,491,759
1000,485,482,497,241,497,738
1000,502,494,506,253,498,751
1000,502,520,508,259,495,754
1000,492,498,502,259,485,744
1000,505,506,509,249,515,764
1000,494,494,493,255,487,742
1000,477,502,478,239,494,733
1000,524,504,504,266,505,771
1000,540,495,519,261,520,781
1000,522,502,490,262,493,755
1000,486,505,521,238,515,753
1000,468,470,476,207,513,720
1000,494,484,462,236,502,738
1000,501,478,508,231,541,772
1000,487,503,493,243,507,750
1000,491,505,487,241,503,744
1000,498,510,466,261,467,728
1000,476,481,506,216,534,750
1000,481,507,467,253,462,715
1000,498,477,506,238,521,759
1000,476,508,470,240,493,733
1000,471,503,495,245,485,730
1000,490,470,467,220,522,742
1000,503,482,523,244,523,767
1000,486,522,511,252,491,743
1000,537,505,491,290,491,781
1000,490,492,508,249,513,762
1000,472,502,499,250,491,741
1000,508,489,473,242,504,746
1000,472,487,478,223,486,709
1000,506,523,507,265,481,746
1000,492,508,518,248,500,748
1000,496,518,519,240,514,754
1000,493,481,508,249,506,755
1000,504,480,499,244,499,743
1000,473,499,495,246,485,731
1000,472,502,494,248,493,741
1000,506,486,469,243,482,725
1000,510,495,497,259,502,761
1000,512,503,515,244,527,771
1000,495,508,526,253,502,755
1000,504,508,470,240,516,756
1000,480,506,502,244,498,742
1000,494,509,513,248,501,749
1000,487,502,473,241,491,732
1000,469,496,492,237,487,724
1000,506,502,531,258,513,771
1000,486,501,505,229,526,755
1000,505,515,522,249,524,773
1000,493,504,493,245,509,754
1000,504,522,497,252,499,751
1000,509,504,508,266,493,759
1000,509,492,501,254,500,754
1000,508,486,526,245,522,767
1000,498,502,511,248,499,747
1000,519,474,521,239,530,769
1000,493,502,506,256,488,744
1000,501,496,455,252,477,729
1000,509,515,503,257,491,748
1000,508,520,489,269,483,752
1000,499,481,482,234,514,748
1000,486,530,473,262,460,722
1000,467,494,505,225,520,745
1000,493,508,496,238,501,739
1000,499,499,509,242,524,766
1000,487,506,493,245,492,737
1000,510,523,501,271,464,735
1000,474,498,508,236,510,746
1000,503,499,482,241,506,747
1000,478,482,458,230,487,717
1000,487,501,505,252,489,741
1000,511,477,503,251,499,750
1000,503,537,527,284,488,772
1000,497,505,493,254,490,744
1000,491,491,491,239,505,744
1000,494,477,528,235,521,756
1000,492,511,486,254,480,734
1000,496,489,466,238,487,725
1000,491,506,493,267,490,757
1000,495,511,469,257,483,740
1000,492,483,481,247,494,741
1000,519,502,495,264,482,746
1000,493,499,504,256,484,740
1000,482,498,507,249,489,738
1000,506,494,514,260,498,758
1000,531,500,502,269,497,766
1000,495,510,504,251,493,744
1000,482,491,519,240,522,762
1000,491,489,513,255,494,749
1000,504,492,479,255,479,734
1000,526,507,479,251,494,745
1000,493,499,524,239,520,759
1000,518,504,500,259,500,759
1000,484,555,492,274,465,739
1000,496,496,488,246,505,751
1000,502,509,501,245,504,749
1000,505,501,482,248,495,743
1000,496,525,505,264,480,744
1000,491,497,492,248,504,752
1000,504,485,509,244,528,772
1000,486,499,500,239,499,738
1000,523,487,508,253,522,775
1000,498,494,529,236,531,767
1000,475,486,507,218,520,738
1000,498,500,483,256,490,746
1000,521,533,527,281,486,767
1000,455,492,490,224,501,725
1000,484,511,503,256,485,741
1000,507,492,473,240,493,733
1000,506,469,475,233,500,733
1000,496,503,511,256,479,735
1000,511,520,521,263,497,760
1000,494,496,504,243,512,755
1000,524,489,498,244,519,763
1000,510,487,530,255,522,777
1000,505,478,503,233,511,744
1000,492,476,479,241,481,722
1000,488,504,497,228,509,737
1000,518,466,480,238,502,740
1000,514,505,519,267,494,761
1000,491,503,509,252,486,738
1000,511,477,533,241,527,768
1000,512,493,497,264,491,755
1000,527,514,498,271,484,755
1000,489,479,483,232,503,735
1000,484,483,498,229,516,745
1000,508,501,487,251,499,750
1000,471,495,491,235,513,748
1000,482,489,492,234,515,749
1000,476,492,514,241,500,741
1000,534,524,491,265,500,765
1000,469,498,499,243,489,732
1000,507,521,482,262,472,734
1000,475,485,524,238,514,752
1000,488,521,529,247,526,773
1000,516,507,492,265,490,755
1000,516,481,522,261,508,769
1000,535,507,496,268,501,769
1000,468,511,498,251,492,743
1000,486,470,490,234,497,731
1000,501,486,494,234,503,737
1000,490,535,513,253,496,749
1000,529,491,551,267,515,782
1000,480,520,524,251,495,746
1000,482,527,516,245,500,745
1000,488,508,470,241,489,730
1000,532,489,485,255,513,768
1000,514,505,499,250,506,756
1000,530,506,504,270,495,765
1000,496,502,509,241,495,736
1000,479,495,494,246,489,735
1000,461,510,498,239,485,724
1000,510,503,487,267,487,754
1000,471,468,517,215,519,734
1000,491,510,508,255,498,753
1000,489,496,519,236,511,747
1000,477,476,465,223,505,728
1000,483,526,498,257,477,734
1000,499,515,492,274,486,760
1000,520,512,509,276,492,768
1000,476,492,506,232,505,737
1000,489,513,527,243,513,756
1000,507,512,507,259,509,768
1000,513,483,497,259,516,775
1000,507,509,503,260,500,760
1000,499,502,472,268,468,736
1000,495,518,512,253,493,746
1000,506,501,508,253,514,767
1000,501,506,508,259,490,749
1000,475,502,505,231,508,739
1000,499,494,482,254,479,733
1000,517,506,480,266,486,752
1000,489,500,511,240,513,753
1000,500,502,488,243,501,744
1000,490,500,475,236,492,728
1000,505,528,528,257,501,758
1000,503,501,489,257,478,735
1000,492,518,522,256,500,756
1000,501,532,522,262,496,758
1000,493,493,515,234,525,759
1000,501,512,483,256,493,749
1000,522,491,511,253,540,793
1000,504,494,515,255,505,760
1000,490,508,473,243,483,726
1000,530,463,507,243,533,776
1000,502,507,470,247,496,743
1000,496,501,523,245,502,747
1000,505,507,521,252,503,755
1000,490,520,499,266,483,749
1000,498,503,506,259,496,755
1000,499,510,514,263,493,756
1000,481,512,532,253,489,742
1000,492,494,485,241,501,742
1000,486,476,508,233,515,748
1000,515,504,514,260,504,764
1000,519,484,513,261,499,760
1000,502,502,521,263,486,749
1000,521,506,499,254,493,747
1000,492,513,481,266,465,731
1000,504,504,493,256,492,748
1000,497,506,510,247,507,754
1000,530,482,510,248,520,768
1000,482,514,501,239,498,737
1000,464,501,488,234,493,727
1000,478,514,492,235,506,741
1000,494,524,482,262,468,730
1000,520,488,511,263,501,764
1000,503,460,492,236,503,739
1000,492,510,486,245,488,733
1000,487,474,509,221,533,754
1000,520,496,492,252,486,738
1000,525,483,485,258,492,750
1000,513,491,511,256,505,761
1000,501,496,489,252,497,749
1000,500,512,506,255,501,756
1000,519,507,504,255,516,771
1000,485,492,499,244,483,727
1000,518,484,489,255,516,771
1000,496,509,521,259,506,765
1000,493,495,497,240,505,745
1000,485,501,462,238,482,720
1000,489,507,526,254,520,774
1000,491,501,520,239,506,745
1000,525,523,515,275,494,769
1000,518,518,512,250,535,785
1000,490,512,501,257,496,753
1000,532,524,499,274,502,776
1000,493,500,482,252,484,736
1000,492,515,501,240,499,739
1000,508,496,505,261,510,771
1000,483,509,506,260,470,730
1000,491,507,497,261,481,742
1000,486,501,524,242,507,749
1000,523,499,521,258,517,775
1000,479,504,493,246,486,732
1000,539,491,499,267,498,765
1000,494,508,506,250,493,743
1000,496,528,509,248,500,748
1000,514,491,492,269,475,744
1000,528,515,503,271,497,768
1000,489,537,499,255,479,734
1000,475,495,514,237,510,747
1000,488,520,483,260,462,722
1000,512,512,480,263,475,738
1000,479,502,492,242,489,731
1000,502,479,481,245,501,746
1000,533,524,507,284,481,765
1000,515,491,489,251,488,739
1000,482,522,509,267,477,744
1000,500,509,503,251,504,755
1000,536,496,493,265,493,758
1000,489,514,515,264,486,750
1000,509,461,527,232,530,762
1000,503,510,476,253,482,735
1000,546,499,525,267,503,770
1000,509,497,494,243,502,745
1000,514,501,490,245,511,756
1000,513,521,519,278,482,760
1000,521,478,515,260,515,775
1000,490,486,492,236,500,736
1000,498,518,492,253,486,739
1000,512,521,463,268,483,751
1000,498,490,488,240,505,745
1000,463,495,494,231,488,719
1000,497,500,507,247,513,760
1000,493,514,501,259,498,757
1000,512,488,510,247,504,751
1000,513,483,530,251,516,767
1000,495,512,508,251,495,746
1000,485,489,501,251,488,739
1000,513,475,522,252,522,774
1000,523,508,520,255,515,770
1000,502,491,514,248,509,757
1000,509,506,508,253,521,774
1000,512,504,501,260,498,758
1000,483,476,499,236,510,746
1000,509,513,494,259,495,754
1000,501,489,487,235,516,751
1000,501,519,477,275,466,741
1000,482,487,472,243,479,722
1000,501,481,535,241,528,769
1000,524,496,486,261,508,769
1000,472,496,478,234,477,711
1000,450,511,511,229,498,727
1000,484,488,501,243,501,744
1000,496,496,512,262,486,748
1000,503,489,498,255,486,741
1000,518,503,502,253,520,773
1000,483,468,489,214,520,734
1000,479,487,524,240,510,750
1000,495,470,534,234,531,765
1000,516,496,465,247,502,749
1000,523,509,485,271,483,754
1000,501,522,506,258,490,748
1000,512,503,495,258,490,748
1000,512,522,493,273,481,754
1000,504,526,498,259,480,739
1000,498,494,501,262,501,763
1000,497,486,515,235,519,754
1000,494,493,510,229,523,752
1000,485,488,521,233,520,753
1000,521,504,529,256,533,789
1000,495,485,475,248,481,729
1000,501,494,518,258,497,755
1000,492,499,498,261,471,732
1000,489,490,493,247,503,750
1000,491,486,485,239,499,738
1000,520,509,519,258,499,757
1000,501,528,482,263,471,734
1000,495,502,539,254,506,760
1000,493,503,477,244,493,737
1000,505,505,504,255,493,748
1000,500,508,499,261,488,749
1000,504,540,525,274,493,767
1000,507,476,487,231,518,749
1000,535,487,509,260,513,773
1000,488,503,499,241,509,750
1000,507,515,509,275,475,750
1000,469,485,502,230,513,743
1000,496,495,515,249,496,745
1000,500,508,518,244,522,766
1000,523,500,499,254,516,770
1000,521,479,515,267,489,756
1000,506,510,500,270,492,762
1000,507,483,487,253,486,739
1000,510,516,502,264,493,757
1000,513,504,517,262,502,764
1000,518,475,517,234,523,757
1000,504,509,491,241,516,757
1000,493,521,480,272,473,745
1000,505,498,486,253,493,746
1000,491,532,513,262,486,748
1000,508,517,445,253,481,734
1000,504,486,513,245,522,767
1000,472,506,508,225,522,747
1000,493,471,491,227,528,755
1000,496,522,491,262,485,747
1000,497,497,513,238,522,760
1000,520,499,486,246,499,745
1000,483,518,490,253,487,740
1000,497,495,506,244,513,757
1000,512,490,483,261,492,753
1000,511,525,494,276,479,755
1000,519,484,516,257,510,767
1000,510,510,514,268,502,770
1000,515,502,470,257,494,751
1000,512,520,493,269,483,752
1000,497,516,475,254,470,724
1000,485,505,484,230,512,742
1000,484,493,486,234,506,740
1000,457,497,507,228,495,723
1000,541,507,506,271,497,768
1000,495,490,491,249,490,739
1000,510,521,547,268,520,788
1000,493,484,522,246,496,742
1000,506,488,482,252,492,744
1000,493,489,517,239,517,756
1000,495,501,505,243,506,749
1000,499,501,492,252,487,739
1000,500,489,509,241,520,761
1000,495,494,484,252,481,733
1000,494,489,498,236,504,740
1000,520,520,494,269,494,763
1000,517,485,493,252,519,771
1000,483,505,513,249,498,747
1000,519,484,497,252,499,751
1000,497,519,496,253,504,757
1000,486,481,482,253,471,724
1000,522,507,513,273,492,765
1000,505,492,529,267,486,753
1000,514,519,519,266,503,769
1000,500,473,512,231,521,752
1000,471,491,509,237,505,742
1000,517,515,522,271,492,763
1000,490,523,512,268,477,745
1000,501,493,511,245,512,757
1000,491,500,462,256,466,722
1000,502,495,509,253,496,749
1000,505,488,489,245,498,743
1000,461,492,524,222,519,741
1000,511,536,486,269,487,756
1000,498,536,507,272,478,750
1000,491,478,521,236,527,763
1000,514,495,511,237,536,773
1000,484,487,514,248,520,768
1000,516,512,498,264,494,758
1000,477,525,501,253,479,732
1000,508,483,491,250,505,755
1000,507,516,519,282,483,765
1000,547,512,504,282,488,770
1000,525,503,481,270,479,749
1000,491,505,503,260,491,751
1000,479,510,480,255,470,725
1000,494,508,487,241,488,729
1000,487,493,518,226,525,751
1000,520,507,502,266,487,753
1000,480,494,516,256,494,750
1000,505,480,511,258,498,756
1000,506,489,483,232,505,737
1000,534,520,494,286,467,753
1000,517,516,502,255,518,773
1000,514,494,475,241,515,756
1000,485,476,470,256,469,725
1000,507,531,491,269,483,752
1000,494,493,504,241,528,769
1000,497,488,503,244,505,749
1000,492,500,508,260,492,752
1000,480,491,487,218,528,746
1000,517,508,479,263,478,741
1000,495,518,476,268,475,743
1000,482,488,447,229,492,721
1000,499,500,540,257,509,766
1000,498,495,539,249,511,760
1000,483,481,500,237,501,738
1000,509,494,505,242,528,770
1000,497,514,485,244,496,740
1000,494,495,494,248,497,745
1000,498,483,517,245,511,756
1000,484,494,487,236,508,744
1000,508,505,493,255,486,741
1000,519,490,480,251,495,746
1000,492,477,508,227,533,760
1000,478,486,477,228,500,728
1000,503,480,499,243,514,757
1000,506,524,490,271,478,749
1000,475,496,482,232,491,723
1000,519,504,505,258,496,754
1000,497,528,492,243,500,743
1000,500,512,479,240,504,744
1000,511,479,520,238,535,773
1000,490,514,482,263,460,723
1000,513,508,508,262,495,757
1000,505,503,490,251,497,748
1000,494,482,505,218,546,764
1000,496,480,505,244,520,764
1000,505,486,490,238,512,750
1000,513,505,479,260,491,751
1000,504,520,523,259,514,773
1000,502,474,509,230,540,770
1000,502,514,526,261,494,755
1000,500,512,507,251,505,756
1000,487,506,504,242,516,758
1000,486,515,498,249,476,725
1000,478,460,508,235,513,748
1000,487,523,504,250,504,754
1000,505,487,511,267,491,758
1000,501,471,520,243,508,751
1000,468,469,507,219,525,744
1000,470,482,521,230,512,742
1000,487,474,498,238,517,755
1000,485,508,505,238,518,756
1000,502,488,502,243,517,760
1000,512,492,521,249,514,763
1000,517,492,486,258,478,736
1000,511,492,505,266,484,750
1000,506,492,512,235,522,757
1000,503,513,509,251,523,774
1000,509,499,464,248,482,730
1000,496,484,494,227,516,743
1000,457,499,500,225,498,723
1000,518,509,521,271,499,770
1000,485,484,502,227,519,746
1000,518,494,500,252,500,752
1000,506,493,497,242,509,751
1000,517,503,502,262,506,768
1000,497,492,519,238,521,759
1000,544,483,549,256,541,797
1000,513,486,474,245,508,753
1000,519,494,508,261,494,755
1000,526,489,495,249,516,765
1000,503,501,476,248,494,742
1000,478,501,510,242,506,748
1000,496,501,497,247,500,747
1000,507,510,509,259,492,751
1000,487,469,511,218,531,749
1000,492,489,508,240,509,749
1000,484,501,498,235,515,750
1000,521,482,535,250,528,778
1000,507,522,491,266,486,752
1000,494,512,515,248,508,756
1000,538,502,501,276,485,761
1000,524,495,498,253,508,761
1000,495,474,500,226,520,746
1000,483,497,516,225,524,749
1000,490,503,494,253,487,740
1000,512,487,492,249,511,760
1000,510,531,502,256,492,748
1000,480,474,490,231,513,744
1000,485,505,494,247,491,738
1000,522,499,492,256,494,750
1000,494,491,499,259,483,742
1000,485,493,488,252,479,731
1000,508,515,507,280,477,757
1000,450,523,498,245,478,723
1000,510,489,466,237,503,740
1000,513,505,498,259,492,751
1000,512,507,490,264,486,750
1000,476,508,477,233,500,733
1000,510,497,482,248,492,740
1000,502,517,505,246,509,755
1000,510,504,503,238,510,748
1000,488,489,500,247,498,745
1000,519,512,515,273,489,762
1000,501,490,524,231,520,751
1000,462,484,493,216,523,739
1000,498,474,495,231,511,742
1000,468,501,503,246,490,736
1000,529,488,506,253,512,765
1000,496,490,519,250,499,749
1000,485,488,503,231,522,753
1000,506,498,519,252,521,773
1000,489,478,486,240,502,742
1000,459,499,514,241,476,717
1000,512,517,499,264,494,758
1000,512,501,506,253,508,761
1000,496,491,496,240,509,749
1000,518,497,514,259,499,758
1000,467,528,506,249,483,732
1000,492,481,507,236,501,737
1000,487,500,506,242,503,745
1000,467,471,491,208,521,729
1000,492,525,505,259,489,748
1000,504,506,504,246,508,754
1000,475,502,500,255,493,748
1000,507,499,522,249,526,775
1000,499,493,504,251,509,760
1000,495,485,500,250,498,748
1000,490,501,520,230,518,748
1000,472,521,506,251,498,749
1000,525,513,513,269,501,770
1000,483,512,529,250,511,761
1000,519,486,469,249,498,747
1000,502,498,476,253,494,747
1000,539,487,493,259,506,765
1000,492,503,497,238,502,740
1000,484,512,470,241,499,740
1000,496,479,484,238,497,735
1000,522,500,479,264,481,745
1000,498,498,487,250,491,741
1000,525,497,512,258,504,762
1000,485,524,490,270,462,732
1000,516,503,488,269,483,752
1000,517,515,513,270,493,763
1000,508,500,476,248,505,753
1000,520,494,483,259,484,743
1000,502,486,508,247,511,758
1000,500,499,505,236,515,751
1000,520,478,497,244,524,768
1000,494,483,485,237,506,743
1000,504,496,509,259,499,758
1000,516,507,487,265,483,748
1000,492,516,524,254,501,755
1000,494,507,504,257,502,759
1000,519,525,470,281,451,732
1000,505,513,481,259,472,731
1000,515,500,480,279,463,742
1000,490,507,513,252,495,747
1000,508,467,498,232,524,756
1000,496,501,508,249,495,744
1000,487,528,491,255,489,744
1000,515,492,534,247,528,775
1000,507,485,524,238,527,765
1000,496,490,502,238,508,746
1000,523,510,521,264,505,769
1000,490,491,489,235,500,735
1000,474,495,531,232,514,746
1000,502,511,483,265,479,744
1000,508,521,481,269,457,726
1000,506,492,484,258,498,756
1000,494,509,495,269,465,734
1000,504,470,492,233,499,732
1000,501,503,496,258,489,747
1000,494,491,535,246,518,764
1000,506,480,491,234,522,756
1000,499,495,503,240,505,745
1000,471,519,507,251,497,748
1000,524,496,516,249,523,772
1000,501,501,480,254,500,754
1000,484,530,507,250,491,741
1000,495,487,482,254,485,739
1000,479,497,506,232,518,750
1000,491,515,532,270,496,766
1000,484,486,492,231,503,734
1000,503,492,510,245,497,742
1000,517,482,486,261,497,758
1000,473,510,465,256,449,705
1000,506,488,486,257,492,749
1000,475,477,477,228,513,741
1000,483,513,503,245,489,734
1000,491,513,490,260,484,744
1000,522,486,478,261,486,747
1000,493,475,518,229,509,738
1000,503,487,522,255,499,754
1000,507,506,506,262,481,743
1000,496,497,505,261,486,747
1000,515,504,521,258,527,785
1000,511,455,494,236,527,763
1000,507,488,481,247,479,726
1000,501,500,505,246,531,777
1000,489,490,490,232,514,746
1000,513,508,502,234,513,747
1000,498,520,512,262,496,758
1000,496,487,487,244,496,740
1000,501,498,505,234,527,761
1000,497,499,478,247,492,739
1000,497,502,494,255,497,752
1000,481,499,481,242,483,725
1000,502,527,517,250,508,758
1000,493,510,495,256,491,747
1000,503,534,508,256,484,740
1000,499,490,464,254,474,728
1000,467,514,505,234,499,733
1000,493,530,497,266,478,744
1000,479,504,500,241,495,736
1000,512,490,506,255,500,755
1000,490,494,481,245,497,742
1000,519,521,501,263,501,764
1000,473,498,506,219,525,744
1000,520,496,511,268,511,779
1000,498,518,482,251,496,747
1000,486,507,503,266,478,744
1000,489,491,487,242,499,741
1000,496,497,503,239,511,750
1000,508,495,473,245,496,741
1000,502,516,473,259,491,750
1000,496,501,510,240,520,760
1000,506,499,517,273,494,767
1000,500,484,491,240,522,762
1000,510,515,511,267,484,751
1000,488,468,514,226,533,759
1000,482,509,520,244,508,752
1000,510,497,508,252,509,761
1000,526,467,503,246,529,775
1000,487,472,526,229,531,760
1000,530,527,489,264,497,761
1000,509,522,481,263,482,745
1000,495,559,513,284,472,756
1000,493,476,489,232,512,744
1000,547,491,518,266,516,782
1000,496,485,515,241,495,736
1000,527,479,518,244,528,772
1000,521,471,511,237,537,774
1000,497,480,507,225,535,760
1000,498,493,472,241,503,744
1000,490,497,493,224,511,735
1000,481,495,481,228,508,736
1000,509,498,500,246,501,747
1000,550,488,513,276,518,794
1000,505,483,499,259,494,753
1000,490,471,498,220,514,734
1000,491,505,491,245,488,733
1000,479,497,506,237,500,737
1000,488,487,503,240,495,735
1000,489,476,507,235,501,736
1000,507,510,507,253,519,772
1000,475,496,493,232,508,740
1000,504,489,509,252,511,763
1000,492,497,512,241,522,763
1000,470,514,504,241,499,740
1000,528,511,506,273,494,767
1000,518,521,476,268,499,767
1000,503,516,487,255,482,737
1000,505,507,507,261,497,758
1000,484,501,478,241,477,718
1000,498,466,506,228,524,752
1000,495,509,502,244,519,763
1000,490,518,511,246,500,746
1000,485,525,503,258,487,745
1000,503,474,511,234,532,766
1000,487,501,505,240,502,742
1000,499,529,491,262,476,738
1000,492,493,497,245,493,738
1000,539,499,518,270,508,778
1000,505,495,470,255,476,731
1000,494,470,509,230,523,753
1000,483,496,504,241,500,741
1000,512,522,501,268,490,758
1000,491,505,512,245,498,743
1000,494,501,487,231,504,735
1000,516,497,475,263,480,743
1000,518,509,475,264,479,743
1000,520,492,485,260,485,745
1000,500,496,500,266,481,747
1000,486,515,509,267,471,738
1000,512,492,485,245,498,743
1000,481,496,509,237,507,744
1000,508,506,503,262,491,753
1000,501,505,489,260,483,743
1000,503,500,487,257,482,739
1000,508,509,506,260,496,756
1000,510,520,516,263,503,766
1000,508,487,525,257,511,768
1000,486,476,496,236,505,741
1000,502,492,518,244,519,763
1000,516,487,508,249,516,765
1000,495,493,466,251,474,725
1000,525,500,498,258,490,748
1000,483,525,516,249,511,760
1000,503,482,508,253,506,759
1000,489,471,503,232,499,731
1000,504,508,514,255,498,753
1000,499,520,531,262,507,769
1000,510,501,511,255,508,763
1000,527,475,497,243,526,769
1000,507,518,480,260,479,739
1000,500,513,511,264,491,755
1000,476,516,493,232,505,737
1000,489,491,502,242,495,737
1000,523,511,520,266,514,780
1000,485,496,496,247,499,746
1000,507,482,498,251,499,750
1000,483,500,473,228,508,736
1000,485,536,489,245,491,736
1000,480,503,519,249,502,751
1000,513,500,466,255,483,738
1000,483,483,504,239,507,746
1000,491,519,525,253,505,758
1000,516,506,512,246,515,761
1000,523,471,517,246,523,769
1000,473,498,474,246,486,732
1000,517,489,491,246,506,752
1000,524,500,512,269,500,769
1000,477,480,499,232,503,735
1000,516,505,509,268,508,776
1000,501,497,498,246,498,744
1000,504,527,507,272,489,761
1000,512,480,498,255,505,760
1000,488,485,508,247,495,742
1000,509,492,507,255,509,764
1000,491,497,481,249,495,744
1000,528,494,504,272,489,761
1000,476,517,478,248,486,734
1000,486,471,492,236,498,734
1000,518,492,522,260,500,760
1000,464,488,489,217,519,736
1000,491,491,514,238,514,752
1000,473,503,495,238,505,743
1000,490,505,476,255,472,727
1000,540,505,517,280,496,776
1000,504,509,488,263,468,731
1000,517,484,494,246,506,752
1000,493,526,468,250,485,735
1000,512,480,490,248,506,754
1000,511,497,509,263,494,757
1000,502,513,499,255,499,754
1000,514,494,484,254,483,737
1000,481,507,491,250,480,730
1000,478,516,487,230,509,739
1000,521,517,502,273,500,773
1000,501,510,506,256,488,744
1000,532,490,487,257,512,769
1000,513,518,488,267,481,748
1000,522,492,471,249,508,757
1000,461,527,522,247,496,743
1000,480,508,521,251,514,765
1000,496,483,515,232,526,758
1000,464,516,509,253,488,741
1000,500,524,485,264,493,757
1000,504,491,496,242,493,735
1000,494,515,492,259,490,749
1000,512,536,475,279,445,724
1000,527,478,477,249,511,760
1000,502,507,504,252,493,745
1000,497,499,500,245,504,749
1000,476,527,490,239,493,732
1000,484,503,500,249,495,744
1000,507,503,461,255,479,734
1000,474,494,475,238,477,715
1000,511,519,498,257,506,763
1000,477,487,483,226,507,733
1000,461,503,511,221,519,740
1000,499,518,485,266,466,732
1000,501,488,483,242,500,742
1000,467,504,519,238,501,739
1000,485,496,501,227,510,737
1000,497,534,471,269,463,732
1000,501,476,494,242,499,741
1000,507,498,507,253,510,763
1000,510,504,489,257,491,748
1000,494,510,473,251,492,743
1000,492,521,494,255,484,739
1000,490,502,509,250,490,740
1000,521,505,490,243,509,752
1000,471,509,476,239,497,736
1000,471,542,504,249,505,754
1000,513,494,507,255,507,762
1000,497,499,497,233,514,747
1000,515,528,487,281,472,753
1000,488,481,525,239,506,745
1000,525,496,509,254,512,766
1000,511,497,508,259,502,761
1000,475,504,511,241,511,752
1000,491,508,514,244,501,745
1000,518,504,524,257,512,769
1000,462,485,505,224,498,722
1000,519,521,489,270,475,745
1000,500,521,502,260,487,747
1000,505,503,486,255,480,735
1000,489,488,507,230,522,752
1000,485,489,489,241,497,738
1000,483,496,498,241,495,736
1000,482,499,510,239,509,748
1000,505,503,512,260,512,772
1000,500,500,492,246,486,732
1000,479,517,502,246,503,749
1000,483,542,511,271,485,756
1000,487,496,498,241,509,750
1000,505,488,501,254,496,750
1000,476,505,515,232,499,731
1000,496,509,494,245,494,739
1000,478,483,510,231,501,732
1000,521,497,509,254,515,769
1000,495,495,504,260,505,765
1000,500,514,517,258,502,760
1000,485,506,503,251,481,732
1000,485,490,497,242,503,745
1000,493,501,512,253,512,765
1000,505,466,519,234,536,770
1000,491,510,490,234,492,726
1000,495,507,507,252,487,739
1000,475,494,487,242,480,722
1000,516,505,518,259,509,768
1000,504,532,515,265,495,760
1000,486,530,524,247,501,748
1000,497,486,508,243,504,747
1000,509,504,491,258,491,749
1000,496,493,517,241,517,758
1000,513,529,481,266,478,744
1000,500,462,513,221,522,743
1000,466,496,490,224,498,722
1000,503,513,471,251,492,743
1000,516,523,510,267,489,756
1000,514,495,472,254,493,747
1000,526,497,512,248,521,769
1000,490,486,504,240,510,750
1000,469,515,501,250,486,736
1000,495,516,502,258,476,734
1000,488,508,516,247,504,751
1000,495,501,512,257,505,762
1000,498,530,487,257,469,726
1000,514,512,491,268,493,761
1000,470,519,504,246,497,743
1000,510,492,496,265,503,768
1000,503,510,495,256,494,750
1000,497,489,474,259,475,734
1000,498,485,528,249,506,755
1000,504,478,497,233,520,753
1000,477,507,503,250,484,734
1000,493,520,521,267,503,770
1000,497,515,459,243,476,719
1000,525,483,523,254,530,784
1000,523,509,505,267,501,768
1000,509,502,533,255,500,755
1000,490,495,505,234,523,757
1000,514,508,496,266,491,757
1000,501,517,519,258,490,748
1000,497,510,508,248,501,749
1000,520,511,495,269,504,773
1000,509,500,503,255,490,745
1000,505,478,502,250,501,751
1000,474,493,528,248,511,759
1000,467,479,531,237,523,760
1000,478,509,495,237,507,744
1000,484,518,518,259,472,731
1000,495,503,500,253,506,759
1000,502,510,511,249,507,756
1000,498,503,499,268,484,752
1000,487,500,478,245,493,738
1000,473,483,517,228,510,738
1000,459,496,489,228,486,714
1000,507,486,516,253,514,767
1000,505,502,506,236,507,743
1000,508,517,497,254,503,757
1000,505,520,497,265,487,752
1000,493,497,507,233,519,752
1000,521,513,466,273,475,748
1000,504,482,463,248,486,734
1000,477,500,488,244,485,729
1000,488,485,492,221,519,740
1000,520,513,494,274,490,764
1000,481,511,509,253,497,750
1000,503,498,497,242,504,746
1000,498,501,507,254,500,754
1000,499,490,502,254,501,755
1000,492,506,491,254,477,731
1000,526,488,500,249,515,764
1000,489,522,505,265,491,756
1000,511,507,484,270,493,763
1000,512,482,479,237,513,750
1000,483,498,485,238,488,726
1000,479,489,512,231,503,734
1000,480,486,477,229,508,737
1000,506,496,500,252,491,743
1000,471,514,516,239,504,743
1000,522,477,476,256,492,748
1000,483,487,501,241,497,738
1000,504,537,488,273,479,752
1000,525,488,509,256,511,767
1000,502,508,506,257,490,747
1000,508,499,488,243,492,735
1000,494,486,484,238,502,740
1000,497,504,501,250,508,758
1000,495,507,490,252,492,744
1000,532,477,502,243,528,771
1000,492,514,487,243,517,760
1000,490,535,493,255,480,735
1000,510,514,491,262,483,745
1000,501,491,489,251,487,738
1000,510,525,503,285,467,752
1000,495,521,498,265,483,748
1000,521,510,506,278,465,743
1000,511,491,517,233,530,763
1000,520,509,508,267,488,755
1000,487,492,487,243,493,736
1000,494,503,516,236,517,753
1000,479,489,519,250,512,762
1000,531,496,521,275,494,769
1000,498,481,507,239,510,749
1000,515,492,520,258,511,769
1000,497,496,501,239,508,747
1000,495,477,496,222,518,740
1000,521,530,521,260,503,763
1000,502,496,514,247,513,760
1000,487,509,504,236,508,744
1000,494,540,494,265,470,735
1000,480,490,502,233,496,729
1000,509,518,493,263,495,758
1000,506,504,459,255,491,746
1000,512,453,490,219,533,752
1000,493,494,515,240,501,741
1000,507,498,511,266,491,757
1000,488,511,503,255,485,740
1000,472,486,503,235,498,733
1000,486,507,498,260,475,735
1000,490,503,463,242,493,735
1000,492,512,482,254,502,756
1000,487,484,493,218,516,734
1000,498,513,513,255,503,758
1000,491,533,512,277,482,759
1000,488,505,496,253,480,733
1000,515,507,498,262,505,767
1000,491,508,486,248,486,734
1000,523,500,510,263,490,753
1000,484,486,546,245,534,779
1000,480,502,481,226,499,725
1000,500,476,531,235,517,752
1000,522,473,522,233,534,767
1000,490,487,506,233,510,743
1000,517,496,493,262,484,746
1000,480,513,470,241,487,728
1000,526,487,507,255,513,768
1000,500,519,492,259,494,753
1000,525,513,489,270,483,753
1000,518,459,516,240,529,769
1000,510,498,505,251,522,773
1000,503,477,489,246,497,743
1000,489,485,490,235,512,747
1000,520,491,508,243,534,777
1000,493,495,473,241,483,724
1000,481,493,480,233,492,725
1000,493,515,523,259,487,746
1000,478,505,511,254,493,747
1000,513,495,501,238,522,760
1000,504,500,531,260,526,786
1000,477,490,506,242,488,730
1000,493,498,494,255,477,732
1000,497,493,514,245,515,760
1000,496,478,496,236,515,751
1000,494,479,519,241,515,756
1000,471,478,487,217,518,735
1000,524,491,492,258,484,742
1000,493,487,498,240,505,745
1000,457,490,509,223,503,726
1000,513,491,513,263,499,762
1000,508,517,504,273,488,761
1000,508,500,506,260,492,752
1000,495,500,505,259,493,752
1000,527,507,519,266,501,767
1000,483,487,498,244,499,743
1000,495,496,461,237,481,718
1000,504,535,495,265,490,755
1000,497,490,488,244,499,743
1000,526,487,509,264,507,771
1000,499,497,489,244,503,747
1000,488,494,519,247,513,760
1000,512,507,509,253,507,760
1000,481,489,496,247,488,735
1000,480,506,501,239,506,745
1000,473,501,510,238,501,739
1000,504,505,523,261,513,774
1000,496,527,486,246,494,740
1000,485,530,495,245,485,730
1000,514,494,493,264,495,759
1000,512,527,535,262,521,783
1000,508,510,498,264,499,763
1000,488,510,480,257,480,737
1000,499,500,478,259,474,733
1000,485,494,508,239,510,749
1000,484,463,511,227,519,746
1000,498,491,490,253,498,751
1000,505,500,486,250,487,737
1000,501,521,499,268,478,746
1000,486,523,509,251,491,742
1000,503,503,498,240,519,759
1000,503,512,486,264,481,745
1000,485,487,500,235,518,753
1000,526,495,537,261,523,784
1000,502,472,511,226,527,753
1000,503,496,508,240,529,769
1000,501,497,481,260,485,745
1000,519,519,502,260,509,769
1000,479,495,512,238,502,740
1000,494,490,472,239,493,732
1000,491,527,510,263,487,750
1000,530,502,496,259,510,769
1000,475,472,493,214,533,747
1000,512,497,491,245,498,743
1000,490,484,492,238,492,730
1000,468,490,516,228,517,745
1000,502,536,477,265,485,750
1000,507,493,495,240,505,745
1000,491,488,506,236,531,767
1000,517,495,510,259,515,774
1000,487,523,492,249,497,746
1000,485,504,498,248,494,742
1000,507,485,490,249,502,751
1000,524,493,512,266,497,763
1000,493,487,519,243,505,748
1000,500,481,499,227,522,749
1000,516,519,490,267,482,749
1000,526,517,489,272,483,755
1000,494,456,520,229,534,763
1000,507,525,489,264,478,742
1000,507,519,506,261,496,757
1000,512,508,505,264,504,768
1000,530,508,500,266,502,768
1000,544,513,518,284,485,769
1000,502,487,483,246,502,748
1000,498,513,503,257,501,758
1000,499,506,504,240,519,759
1000,513,519,513,262,490,752
1000,508,476,476,248,482,730
1000,530,487,506,254,499,753
1000,507,502,481,262,483,745
1000,495,509,507,266,476,742
1000,468,503,491,236,506,742
1000,478,505,487,239,494,733
1000,497,488,480,230,507,737
1000,497,495,493,244,490,734
1000,492,485,492,239,503,742
1000,515,523,497,257,482,739
1000,527,497,497,265,505,770
1000,525,500,486,267,486,753
1000,495,510,485,258,493,751
1000,502,487,532,242,522,764
1000,477,495,505,232,506,738
1000,489,498,474,250,483,733
1000,483,493,522,241,514,755
1000,512,493,483,226,518,744
1000,520,486,487,250,495,745
1000,481,485,466,239,480,719
1000,527,503,511,261,506,767
1000,505,513,499,257,494,751
1000,505,503,515,248,504,752
1000,473,515,537,249,512,761
1000,517,506,497,260,499,759
1000,499,518,466,248,478,726
1000,492,515,485,240,498,738
1000,500,501,507,249,520,769
1000,510,486,504,246,528,774
1000,495,471,514,236,529,765
1000,506,493,512,256,503,759
1000,495,531,483,254,487,741
1000,483,496,521,236,526,762
1000,497,517,521,263,501,764
1000,516,498,501,248,509,757
1000,519,517,497,272,484,756
1000,514,501,493,252,496,748
1000,534,477,498,256,501,757
1000,497,497,482,254,486,740
1000,501,488,511,240,508,748
1000,503,477,511,240,514,754
1000,502,478,494,241,500,741
1000,506,461,506,247,505,752
1000,511,487,473,249,497,746
1000,506,505,507,252,501,753
1000,481,468,492,233,505,738
1000,517,503,507,261,504,765
1000,476,478,501,235,506,741
1000,512,517,533,248,516,764
1000,500,487,493,244,496,740
1000,540,509,478,273,478,751
1000,498,481,536,261,512,773
1000,512,488,504,248,522,770
1000,516,491,484,238,513,751
1000,498,498,503,250,497,747
1000,495,507,506,267,482,749
1000,484,514,475,251,471,722
1000,502,505,491,250,503,753
1000,502,500,496,250,489,739
1000,493,513,507,251,495,746
1000,496,515,523,255,522,777
1000,507,485,493,228,536,764
1000,470,520,515,236,508,744
1000,514,511,490,264,485,749
1000,535,512,480,270,489,759
1000,510,508,466,251,488,739
1000,512,516,476,269,490,759
1000,462,495,490,221,513,734
1000,501,485,524,233,545,778
1000,499,484,513,246,496,742
1000,509,480,526,244,523,767
1000,490,511,521,257,511,768
1000,498,494,491,239,501,740
1000,475,472,528,232,512,744
1000,513,487,519,256,499,755
1000,517,477,496,254,496,750
1000,507,512,496,273,482,755
1000,486,494,522,230,539,769
1000,498,532,486,269,473,742
1000,521,495,468,244,504,748
1000,508,475,536,236,520,756
1000,497,486,505,237,511,748
1000,457,519,507,235,496,731
1000,486,497,492,248,499,747
1000,477,517,506,248,491,739
1000,518,502,499,252,530,782
1000,512,502,505,267,488,755
1000,465,501,479,230,498,728
1000,506,530,518,267,507,774
1000,488,493,514,238,520,758
1000,510,519,509,253,503,756
1000,526,531,486,275,479,754
1000,489,501,488,251,492,743
1000,485,488,495,235,507,742
1000,497,484,490,245,503,748
1000,508,488,482,260,494,754
1000,489,484,517,238,516,754
1000,489,509,510,255,508,763
1000,477,530,493,265,471,736
1000,500,472,531,239,529,768
1000,493,506,522,250,504,754
1000,517,492,479,233,512,745
1000,477,478,487,217,518,735
1000,525,513,467,269,473,742
1000,509,483,492,254,503,757
1000,509,500,492,267,478,745
1000,529,487,500,254,511,765
1000,510,514,507,256,513,769
1000,513,527,486,274,473,747
1000,499,469,473,236,488,724
1000,533,491,515,255,516,771
1000,481,502,517,241,520,761
1000,480,516,521,258,495,753
1000,502,516,495,259,489,748
1000,496,516,496,258,496,754
1000,488,497,476,245,480,725
1000,490,516,477,252,481,733
1000,517,488,540,243,527,770
1000,497,537,507,278,482,760
1000,517,510,502,255,496,751
1000,496,504,492,246,498,744
1000,498,507,488,252,477,729
1000,521,494,520,259,522,781
1000,501,506,512,251,505,756
1000,490,526,473,248,487,735
1000,508,509,482,251,493,744
1000,516,504,468,276,453,729
1000,504,513,497,256,504,760
1000,505,497,497,243,500,743
1000,487,512,494,251,487,738
1000,497,498,487,237,510,747
1000,507,536,487,275,473,748
1000,528,514,496,265,495,760
1000,520,504,513,266,502,768
1000,491,489,489,227,522,749
1000,481,515,505,256,483,739
1000,515,496,531,255,514,769
1000,507,513,492,258,479,737
1000,521,516,511,263,508,771
1000,499,498,490,244,510,754
1000,497,500,523,245,513,758
1000,511,498,492,267,490,757
1000,497,508,500,246,512,758
1000,475,506,482,243,486,729
1000,490,472,495,231,506,737
1000,468,467,506,221,524,745
1000,507,503,506,238,521,759
1000,498,509,487,245,491,736
1000,507,485,504,241,508,749
1000,503,515,498,252,516,768
1000,490,515,498,256,485,741
1000,514,477,502,230,533,763
1000,480,502,503,229,510,739
1000,497,497,466,232,486,718
1000,508,497,478,263,484,747
1000,492,476,513,230,530,760
1000,488,485,496,221,526,747
1000,489,498,513,245,503,748
1000,522,487,517,248,514,762
1000,479,482,496,238,496,734
1000,490,518,510,254,487,741
1000,478,468,509,229,506,735
1000,477,476,507,236,491,727
1000,497,503,495,250,491,741
1000,511,485,517,271,490,761
1000,506,515,500,267,484,751
1000,488,525,483,250,483,733
1000,508,472,520,238,533,771
1000,482,484,512,234,511,745
1000,506,497,510,241,510,751
1000,496,526,518,261,496,757
1000,500,513,509,247,506,753
1000,500,524,515,270,495,765
1000,488,485,496,244,503,747
1000,526,472,502,241,527,768
1000,489,484,477,233,496,729
1000,500,490,493,227,504,731
1000,491,514,491,249,497,746
1000,515,530,529,278,504,782
1000,503,539,470,263,481,744
1000,508,495,515,250,525,775
1000,517,505,516,272,499,771
1000,485,494,499,232,506,738
1000,507,501,501,267,496,763
1000,463,483,472,226,485,711
1000,471,486,507,222,518,740
1000,490,514,486,248,486,734
1000,482,517,503,251,484,735
1000,510,520,492,258,489,747
1000,503,488,482,255,484,739
1000,524,505,525,275,506,781
1000,496,502,522,258,502,760
1000,508,491,508,240,527,767
1000,509,488,525,247,512,759
1000,493,519,476,257,481,738
1000,493,537,501,258,500,758
1000,483,506,498,224,523,747
1000,505,484,483,236,508,744
1000,513,498,512,256,518,774
1000,502,531,511,274,488,762
1000,513,529,498,278,470,748
1000,515,509,500,269,495,764
1000,511,515,482,269,455,724
1000,505,504,511,259,504,763
1000,502,494,525,250,513,763
1000,499,484,513,237,526,763
1000,501,505,487,242,501,743
1000,498,528,481,258,484,742
1000,482,512,515,256,474,730
1000,500,521,506,246,491,737
1000,498,483,500,231,534,765
1000,480,482,504,243,499,742
1000,499,510,484,240,504,744
1000,456,505,486,228,490,718
1000,482,493,480,246,484,730
1000,519,497,484,250,516,766
1000,487,500,520,222,515,737
1000,493,506,501,263,482,745
1000,499,518,481,261,476,737
1000,508,501,497,241,518,759
1000,512,492,501,263,494,757
1000,489,483,509,243,500,743
1000,498,513,482,239,503,742
1000,508,509,507,266,500,766
1000,515,514,498,262,503,765
1000,478,496,487,228,497,725
1000,509,496,473,246,485,731
1000,520,509,483,266,480,746
1000,504,487,500,241,510,751
1000,496,503,497,246,492,738
1000,508,526,494,261,491,752
1000,498,490,498,241,503,744
1000,489,487,498,234,510,744
1000,516,471,471,241,501,742
1000,527,477,489,259,503,762
1000,497,510,500,241,510,751
1000,497,485,508,230,511,741
1000,484,492,535,252,514,766
1000,485,482,486,236,495,731
1000,491,503,503,252,493,745
1000,512,543,508,294,455,749
1000,514,497,526,254,511,765
1000,500,494,494,246,505,751
1000,509,486,514,246,513,759
1000,488,469,512,221,520,741
1000,521,484,512,253,509,762
1000,543,477,486,256,500,756
1000,490,465,470,240,498,738
1000,498,494,487,250,502,752
1000,496,496,511,240,519,759
1000,497,492,499,246,502,748
1000,481,498,501,227,512,739
1000,503,495,488,259,480,739
1000,517,515,539,264,507,771
1000,509,485,503,243,525,768
1000,522,520,496,278,476,754
1000,490,472,499,213,530,743
1000,510,507,492,246,503,749
1000,474,492,513,243,500,743
1000,523,463,481,235,515,750
1000,488,478,501,228,522,750
1000,513,489,511,251,520,771
1000,500,497,500,238,511,749
1000,491,495,516,244,507,751
1000,497,523,499,263,490,753
1000,493,505,497,248,498,746
1000,510,493,505,252,498,750
1000,520,482,512,248,525,773
1000,491,492,495,241,496,737
1000,484,485,520,242,511,753
1000,499,464,513,230,522,752
1000,499,518,502,256,482,738
1000,483,490,530,242,536,778
1000,492,478,505,218,528,746
1000,513,502,510,248,518,766
1000,491,495,485,235,506,741
1000,476,531,520,254,497,751
1000,499,521,478,260,454,714
1000,484,533,495,253,495,748
1000,499,476,492,234,517,751
1000,492,517,466,263,484,747
1000,518,496,493,257,499,756
1000,515,494,496,266,487,753
1000,516,474,503,257,514,771
1000,513,512,497,265,495,760
1000,507,496,493,239,517,756
1000,524,505,549,264,521,785
1000,538,501,505,276,502,778
1000,490,500,518,236,524,760
1000,514,489,513,247,515,762
1000,506,525,497,250,500,750
1000,507,495,493,254,491,745
1000,501,491,509,253,511,764
1000,494,504,480,248,487,735
1000,483,504,505,232,516,748
1000,497,500,497,247,498,745
1000,506,513,555,262,516,778
1000,517,466,497,242,511,753
1000,520,511,494,260,493,753
1000,499,458,495,224,531,755
1000,541,527,479,281,469,750
1000,492,508,499,254,488,742
1000,490,499,493,249,484,733
1000,497,498,493,244,504,748
1000,512,464,505,235,531,766
1000,511,515,496,261,501,762
1000,507,497,502,253,511,764
1000,495,502,511,235,509,744
1000,470,499,541,254,513,767
1000,502,490,509,244,503,747
1000,498,506,513,241,518,759
1000,493,496,508,246,511,757
1000,514,505,487,251,485,736
1000,496,480,495,235,508,743
1000,516,528,493,275,482,757
1000,509,500,501,246,498,744
1000,518,505,500,251,510,761
1000,492,518,487,243,510,753
1000,459,494,520,220,515,735
1000,477,482,509,236,509,745
1000,487,468,505,211,539,750
1000,508,504,512,257,498,755
1000,491,500,510,252,499,751
1000,492,512,514,240,503,743
1000,502,493,518,254,501,755
1000,512,493,497,254,501,755
1000,502,525,510,248,505,753
1000,503,507,501,243,508,751
1000,504,532,501,272,484,756
1000,487,515,500,253,495,748
1000,497,515,499,259,479,738
1000,501,499,474,251,491,742
1000,498,493,495,248,496,744
1000,515,499,487,250,513,763
1000,512,509,513,266,501,767
1000,474,514,503,225,521,746
1000,518,505,512,249,516,765
1000,492,537,541,263,507,770
1000,480,498,492,229,511,740
1000,495,480,493,248,503,751
1000,486,486,493,235,506,741
1000,473,479,496,221,527,748
1000,542,521,478,284,460,744
1000,454,488,515,224,509,733
1000,513,512,528,271,502,773
1000,516,509,503,251,502,753
1000,497,508,492,251,479,730
1000,520,523,489,262,492,754
1000,492,511,513,250,500,750
1000,484,473,510,233,511,744
1000,522,482,482,239,516,755
1000,513,496,487,253,492,745
1000,465,490,513,222,522,744
1000,517,496,499,264,501,765
1000,511,519,491,256,492,748
1000,475,497,483,244,485,729
1000,496,490,509,240,513,753
1000,525,502,487,267,498,765
1000,487,519,503,252,495,747
1000,503,517,529,262,506,768
1000,515,491,513,265,503,768
1000,509,504,527,244,538,782
1000,512,487,486,266,488,754
1000,518,513,521,262,487,749
1000,491,478,492,228,524,752
1000,481,491,519,243,503,746
1000,503,509,501,252,496,748
1000,505,502,511,255,504,759
1000,514,478,466,236,502,738
1000,497,493,495,251,494,745
1000,494,485,472,233,494,727
1000,509,512,503,257,494,751
1000,485,531,513,254,496,750
1000,536,478,511,260,506,766
1000,519,517,488,264,495,759
1000,489,482,489,230,511,741
1000,462,469,523,219,521,740
1000,506,503,540,243,531,774
1000,486,480,489,226,511,737
1000,507,519,499,260,494,754
1000,497,518,489,276,470,746
1000,493,494,479,243,497,740
1000,513,479,478,253,499,752
1000,474,503,519,239,514,753
1000,509,507,491,252,501,753
1000,528,466,476,234,537,771
1000,481,515,485,246,487,733
1000,514,495,495,271,479,750
1000,501,500,484,253,487,740
1000,515,481,524,233,539,772
1000,495,472,497,224,519,743
1000,482,504,465,230,490,720
1000,472,502,518,236,508,744
1000,491,498,504,249,504,753
1000,461,492,492,219,504,723
1000,512,497,514,263,515,778
1000,506,502,485,248,498,746
1000,471,519,504,247,471,718
1000,484,509,457,257,468,725
1000,513,504,534,268,496,764
1000,505,491,486,257,489,746
1000,478,485,479,226,521,747
1000,518,474,498,259,497,756
1000,495,534,493,268,480,748
1000,495,495,521,238,526,764
1000,509,474,493,238,514,752
1000,489,518,498,249,514,763
1000,476,477,492,234,494,728
1000,505,483,525,242,527,769
1000,492,517,488,245,509,754
1000,515,523,515,284,474,758
1000,512,484,514,251,518,769
1000,504,482,528,234,536,770
1000,466,518,519,239,501,740
1000,490,489,498,243,493,736
1000,498,489,497,250,494,744
1000,499,523,479,256,485,741
1000,514,476,474,239,509,748
1000,516,484,500,259,496,755
1000,510,492,506,244,519,763
1000,480,517,533,228,535,763
1000,520,507,509,245,527,772
1000,475,489,511,243,487,730
1000,504,519,531,250,527,777
1000,491,499,528,249,507,756
1000,519,481,501,248,494,742
1000,504,512,505,255,519,774
1000,493,520,488,258,493,751
1000,506,519,504,265,504,769
1000,499,492,495,249,488,737
1000,513,501,513,255,510,765
1000,481,492,493,235,492,727
1000,511,507,499,272,495,767
1000,497,486,464,235,490,725
1000,505,517,523,266,510,776
1000,514,504,509,267,492,759
1000,480,522,500,255,492,747
1000,504,522,487,273,477,750
1000,502,510,515,250,500,750
1000,489,472,472,224,505,729
1000,502,504,504,249,484,733
1000,511,488,495,263,482,745
1000,465,509,522,236,507,743
1000,482,506,498,242,497,739
1000,488,517,524,259,506,765
1000,498,505,494,256,496,752
1000,525,513,513,281,495,776
1000,498,495,503,248,510,758
1000,500,484,470,247,489,736
1000,535,504,511,274,490,764
1000,520,518,497,280,483,763
1000,518,498,500,263,495,758
1000,478,521,495,251,490,741
1000,481,516,519,252,492,744
1000,477,514,482,257,480,737
1000,507,516,512,259,501,760
1000,467,498,506,236,506,742
1000,490,512,514,246,507,753
1000,504,521,492,255,499,754
1000,519,509,487,271,476,747
1000,519,518,461,274,459,733
1000,500,494,509,247,520,767
1000,504,503,507,255,492,747
1000,470,506,504,231,489,720
1000,495,499,504,231,510,741
1000,517,497,523,251,525,776
1000,471,520,477,247,474,721
1000,489,484,502,241,507,748
1000,501,518,483,253,485,738
1000,505,509,540,257,516,773
1000,501,496,523,248,520,768
1000,513,496,480,257,488,745
1000,502,486,498,239,518,757
1000,473,505,530,232,531,763
1000,479,541,511,257,492,749
1000,514,502,491,248,498,746
1000,512,473,496,243,521,764
1000,470,463,504,228,503,731
1000,501,494,496,249,496,745
1000,513,499,488,255,503,758
1000,478,489,491,239,497,736
1000,508,510,491,254,488,742
1000,502,487,515,259,507,766
1000,509,484,479,252,486,738
1000,504,500,498,264,476,740
1000,502,512,485,266,479,745
1000,499,498,532,254,501,755
1000,505,498,510,247,506,753
1000,481,501,513,238,503,741
1000,515,522,474,262,474,736
1000,509,515,510,259,508,767
1000,512,478,513,251,515,766
1000,507,486,483,253,477,730
1000,510,493,491,264,483,747
1000,501,516,519,257,500,757
1000,506,512,506,263,489,752
1000,510,515,505,256,507,763
1000,509,513,523,248,533,781
1000,502,511,499,256,501,757
1000,486,479,527,234,532,766
1000,508,501,489,257,501,758
1000,499,499,530,252,506,758
1000,495,504,509,248,497,745
1000,506,476,513,234,529,763
1000,504,500,488,245,493,738
1000,498,504,520,249,508,757
1000,517,494,487,255,492,747
1000,504,485,524,240,514,754
1000,542,501,512,266,515,781
1000,513,512,520,266,493,759
1000,506,501,482,256,484,740
1000,491,477,495,224,518,742
1000,488,514,499,249,489,738
1000,512,492,495,254,513,767
1000,510,485,507,236,516,752
1000,530,513,513,273,494,767
1000,488,487,509,233,508,741
1000,482,510,523,239,503,742
1000,497,486,500,237,506,743
1000,510,494,519,247,524,771
1000,482,519,505,243,503,746
1000,488,502,491,247,483,730
1000,535,530,475,276,479,755
1000,522,498,498,248,506,754
1000,493,497,469,251,484,735
1000,525,501,499,274,488,762
1000,496,487,510,238,515,753
1000,497,477,535,247,513,760
1000,508,530,524,268,498,766
1000,487,492,526,242,511,753
1000,488,517,502,249,496,745
1000,517,500,503,258,511,769
1000,471,481,488,228,499,727
1000,500,501,485,265,488,753
1000,496,506,516,248,507,755
1000,504,501,473,257,476,733
1000,530,512,498,278,476,754
1000,503,505,466,253,485,738
1000,530,494,490,257,499,756
1000,493,507,500,258,477,735
1000,489,467,494,229,518,747
1000,498,485,508,249,497,746
1000,515,503,491,259,486,745
1000,522,502,519,265,521,786
1000,505,496,526,247,518,765
1000,505,496,513,242,497,739
1000,506,493,513,261,502,763
1000,492,497,502,241,501,742
1000,502,500,524,259,521,780
1000,487,511,522,251,514,765
1000,490,518,479,263,474,737
1000,497,499,518,248,504,752
1000,485,500,539,233,529,762
1000,517,500,482,263,495,758
1000,471,498,520,240,502,742
1000,503,531,480,295,430,725
1000,485,502,474,239,490,729
1000,528,496,500,272,497,769
1000,499,526,496,270,487,757
1000,461,518,515,225,516,741
1000,492,494,465,234,493,727
1000,495,499,490,248,501,749
1000,497,508,508,253,500,753
1000,508,507,501,250,489,739
1000,467,519,502,238,501,739
1000,496,524,507,266,492,758
1000,507,509,506,258,508,766
1000,480,511,485,256,484,740
1000,496,524,505,265,488,753
1000,485,491,512,249,500,749
1000,521,504,500,267,485,752
1000,480,500,489,250,473,723
1000,527,505,480,261,494,755
1000,490,496,499,252,495,747
1000,488,485,503,238,520,758
1000,515,512,520,267,495,762
1000,550,495,486,258,497,755
1000,528,518,498,276,498,774
1000,528,498,516,259,522,781
1000,485,508,513,249,501,750
1000,490,512,477,264,474,738
1000,513,508,482,252,499,751
1000,530,515,496,286,462,748
1000,495,479,492,246,507,753
1000,520,511,478,256,493,749
1000,497,505,487,247,475,722
1000,522,488,476,246,510,756
1000,506,479,503,231,517,748
1000,502,500,511,259,497,756
1000,504,503,492,234,511,745
1000,498,520,509,253,496,749
1000,523,475,502,245,519,764
1000,520,477,480,252,503,755
1000,499,494,519,249,511,760
1000,518,488,485,257,498,755
1000,505,516,492,260,499,759
1000,499,491,521,247,504,751
1000,527,521,488,258,502,760
1000,506,512,501,261,482,743
1000,498,481,512,257,493,750
1000,515,500,525,250,523,773
1000,505,500,487,247,490,737
1000,499,500,516,247,519,766
1000,529,486,489,254,508,762
1000,539,496,487,275,486,761
1000,479,498,475,253,479,732
1000,504,502,481,249,489,738
1000,505,483,509,249,505,754
1000,502,501,506,261,497,758
1000,500,497,493,242,505,747
1000,470,514,479,244,478,722
1000,484,532,518,262,499,761
1000,511,499,496,258,498,756
1000,499,482,516,233,515,748
1000,503,478,491,251,492,743
1000,492,482,491,252,496,748
1000,514,506,490,269,470,739
1000,511,505,504,241,525,766
1000,479,513,459,245,474,719
1000,492,510,515,259,507,766
1000,483,495,489,238,497,735
1000,509,468,483,245,507,752
1000,493,520,504,253,496,749
1000,497,500,483,236,503,739
1000,508,496,468,260,472,732
1000,499,497,512,249,507,756
1000,507,499,509,249,508,757
1000,478,524,514,252,485,737
1000,514,508,476,259,489,748
1000,495,517,481,245,493,738
1000,487,492,512,241,506,747
1000,531,508,480,268,481,749
1000,497,504,513,246,501,747
1000,478,509,485,239,501,740
1000,482,471,513,230,525,755
1000,501,479,494,246,496,742
1000,519,497,481,249,480,729
1000,490,528,497,264,487,751
1000,486,521,518,253,498,751
1000,479,497,503,238,511,749
1000,496,529,503,273,460,733
1000,496,483,493,259,477,736
1000,497,502,480,246,491,737
1000,512,526,517,272,507,779
1000,517,514,494,267,474,741
1000,493,496,497,242,508,750
1000,486,508,523,239,515,754
1000,499,541,487,280,462,742
1000,496,498,473,256,477,733
1000,493,494,470,246,477,723
1000,529,499,506,259,498,757
1000,478,514,508,250,492,742
1000,506,502,507,252,504,756
1000,496,508,526,252,510,762
1000,508,525,504,261,493,754
1000,499,541,479,273,457,730
1000,523,509,502,250,516,766
1000,515,472,513,250,497,747
1000,482,496,477,247,480,727
1000,472,469,509,233,507,740
1000,475,468,491,230,487,717
1000,504,525,520,267,508,775
1000,496,504,555,255,533,788
1000,485,492,476,228,514,742
1000,516,524,502,266,475,741
1000,509,488,505,263,492,755
1000,499,495,490,244,494,738
1000,522,491,476,238,518,756
1000,501,485,543,237,537,774
1000,487,499,522,233,532,765
1000,503,513,512,258,496,754
1000,501,488,518,241,520,761
1000,499,472,490,237,516,753
1000,479,490,494,239,503,742
1000,493,512,505,255,497,752
1000,531,496,477,262,498,760
1000,495,517,487,250,490,740
1000,507,509,499,265,486,751
1000,496,479,478,234,493,727
1000,508,509,439,248,487,735
1000,499,509,534,247,508,755
1000,476,497,481,238,486,724
1000,483,498,507,231,525,756
1000,513,499,496,269,478,747
1000,506,509,483,253,480,733
1000,488,485,508,243,494,737
1000,478,527,507,252,498,750
1000,491,488,497,242,510,752
1000,486,508,505,242,516,758
1000,480,484,490,239,493,732
1000,474,484,513,234,519,753
1000,511,509,473,255,482,737
1000,480,510,494,236,494,730
1000,515,490,481,245,503,748
1000,489,490,496,244,512,756
1000,480,482,467,231,485,716
1000,465,485,503,231,494,725
1000,505,480,493,248,500,748
1000,512,492,481,264,478,742
1000,486,525,464,271,452,723
1000,529,479,506,258,487,745
1000,482,533,512,264,485,749
1000,496,497,526,229,543,772
1000,504,493,510,246,500,746
1000,515,500,508,264,496,760
1000,518,481,526,242,544,786
1000,513,495,516,245,506,751
1000,482,496,495,241,499,740
1000,515,495,491,258,496,754
1000,494,498,526,248,513,761
1000,481,487,488,224,507,731
1000,493,517,501,248,504,752
1000,463,508,489,230,503,733
1000,503,516,493,253,492,745
1000,521,515,526,259,513,772
1000,512,491,505,243,521,764
1000,520,494,492,259,490,749
1000,497,481,496,248,505,753
1000,519,506,522,258,508,766
1000,493,492,503,237,513,750
1000,507,504,502,273,476,749
1000,507,505,485,260,491,751
1000,509,498,499,250,519,769
1000,520,484,501,248,509,757
1000,516,504,512,259,500,759
1000,493,505,496,261,476,737
1000,498,505,516,248,516,764
1000,508,486,499,242,514,756
1000,499,483,528,237,529,766
1000,527,519,527,273,504,777
1000,508,484,513,231,543,774
1000,515,508,510,269,491,760
1000,509,507,497,259,504,763
1000,494,496,513,245,509,754
1000,526,495,496,254,515,769
1000,508,519,493,252,499,751
1000,504,534,484,276,468,744
1000,466,488,510,220,515,735
1000,476,505,515,224,527,751
1000,478,480,510,221,522,743
1000,506,531,505,268,499,767
1000,499,498,495,257,493,750
1000,504,481,530,249,520,769
1000,521,488,493,257,480,737
1000,509,466,523,235,535,770
1000,490,513,476,237,503,740
1000,482,473,493,212,524,736
1000,478,513,509,231,511,742
1000,493,494,490,240,493,733
1000,513,483,523,258,525,783
1000,498,502,515,248,513,761
1000,498,510,506,248,507,755
1000,510,473,489,230,536,766
1000,517,521,512,281,479,760
1000,522,535,526,274,508,782
1000,510,514,459,260,464,724
1000,490,530,508,262,491,753
1000,500,509,496,261,491,752
1000,478,530,508,246,505,751
1000,507,475,485,249,499,748
1000,500,510,493,244,505,749
1000,501,495,485,254,484,738
1000,481,508,499,252,486,738
1000,472,522,505,255,471,726
1000,505,499,483,260,485,745
1000,507,501,493,266,490,756
1000,495,488,505,250,503,753
1000,521,495,502,264,493,757
1000,505,504,512,255,505,760
1000,501,483,503,244,511,755
1000,509,472,536,234,540,774
1000,510,501,493,261,499,760
1000,487,509,505,235,517,752
1000,495,486,517,235,511,746
1000,520,500,507,252,499,751
1000,489,499,482,253,480,733
1000,504,493,523,242,532,774
1000,501,497,505,248,501,749
1000,498,504,499,233,519,752
1000,503,523,475,260,484,744
1000,479,505,500,246,494,740
1000,489,469,509,227,509,736
1000,500,514,513,247,497,744
1000,499,478,522,238,521,759
1000,489,522,527,256,512,768
1000,475,499,514,235,507,742
1000,494,485,486,235,514,749
1000,500,476,492,236,518,754
1000,508,525,486,242,495,737
1000,472,487,506,237,508,745
1000,489,537,504,257,489,746
1000,484,483,517,251,501,752
1000,491,494,474,243,494,737
1000,497,546,496,281,466,747
1000,487,527,506,257,498,755
1000,504,512,518,273,487,760
1000,487,505,521,254,494,748
1000,516,514,496,266,500,766
1000,511,494,508,251,522,773
1000,528,519,501,267,510,777
1000,498,510,484,260,489,749
1000,520,496,514,246,511,757
1000,481,495,495,250,482,732
1000,494,514,512,254,494,748
1000,534,523,531,282,504,786
1000,494,492,509,241,509,750
1000,501,496,508,241,516,757
1000,493,486,506,240,505,745
1000,462,499,504,225,508,733
1000,479,494,494,233,499,732
1000,490,493,502,245,486,731
1000,514,487,492,249,504,753
1000,506,490,506,249,506,755
1000,487,478,496,233,513,746
1000,491,484,519,232,526,758
1000,514,487,525,256,504,760
1000,502,492,488,249,488,737
1000,494,505,526,249,519,768
1000,507,524,491,276,465,741
1000,484,517,486,247,482,729
1000,474,504,492,242,479,721
1000,499,513,484,258,476,734
1000,501,490,500,242,495,737
1000,501,492,519,243,539,782
1000,512,490,489,265,475,740
1000,507,493,488,256,489,745
1000,508,490,520,247,516,763
1000,491,513,493,245,480,725
1000,521,527,510,287,472,759
1000,493,480,506,224,523,747
1000,525,534,507,282,473,755
1000,502,509,477,247,490,737
1000,466,499,520,222,525,747
1000,498,485,507,240,510,750
1000,489,497,505,237,514,751
1000,487,517,491,249,498,747
1000,492,495,530,242,517,759
1000,498,489,514,243,507,750
1000,520,498,506,250,517,767
1000,491,495,501,239,514,753
1000,512,533,490,262,496,758
1000,467,486,491,225,499,724
1000,493,503,530,242,524,766
1000,497,481,488,228,518,746
1000,500,479,509,240,511,751
1000,500,497,492,235,507,742
1000,537,493,499,258,504,762
1000,508,504,525,240,521,761
1000,513,518,518,266,490,756
1000,530,525,504,270,491,761
1000,493,496,484,246,502,748
1000,486,495,490,251,497,748
1000,512,509,500,258,506,764
1000,508,503,516,252,512,764
1000,509,504,485,247,515,762
1000,503,500,489,252,493,745
1000,494,492,534,243,520,763
1000,498,511,496,260,479,739
1000,483,475,508,238,504,742
1000,492,501,474,244,486,730
1000,505,500,472,250,487,737
1000,506,495,487,241,510,751
1000,516,500,505,256,502,758
1000,486,519,505,248,503,751
1000,513,491,511,253,499,752
1000,481,499,472,240,497,737
1000,497,508,518,262,491,753
1000,509,509,503,254,507,761
1000,506,473,506,234,535,769
1000,505,493,516,254,505,759
1000,503,507,511,264,492,756
1000,485,494,502,251,494,745
1000,494,488,498,242,519,761
1000,520,512,503,284,483,767
1000,470,477,490,229,487,716
1000,518,494,531,253,520,773
1000,521,496,505,252,502,754
1000,486,503,501,251,499,750
1000,529,480,499,243,518,761
1000,486,494,515,220,528,748
1000,508,509,514,249,496,745
1000,475,497,494,242,498,740
1000,508,500,487,267,466,733
1000,517,484,482,262,482,744
1000,494,527,499,260,477,737
1000,483,511,499,251,486,737
1000,505,484,460,235,508,743
1000,496,508,505,246,506,752
1000,508,500,472,249,485,734
1000,516,517,491,268,476,744
1000,505,508,535,257,525,782
1000,492,498,501,251,492,743
1000,516,508,509,250,509,759
1000,490,459,530,213,547,760
1000,463,492,504,223,517,740
1000,548,526,471,282,486,768
1000,506,506,510,252,508,760
1000,488,475,505,242,513,755
1000,482,514,506,252,507,759
1000,500,502,514,251,488,739
1000,492,503,498,263,482,745
1000,494,531,517,270,484,754
1000,510,489,475,252,484,736
1000,502,512,516,251,513,764
1000,537,487,498,262,507,769
1000,481,471,505,226,517,743
1000,508,502,499,256,502,758
1000,505,484,504,243,511,754
1000,510,504,488,253,498,751
1000,478,502,491,242,494,736
1000,506,501,492,270,475,745
1000,519,509,509,262,493,755
1000,519,473,507,249,520,769
1000,499,495,478,245,495,740
1000,493,483,517,242,504,746
1000,521,476,496,253,504,757
1000,492,475,501,246,496,742
1000,524,502,516,248,513,761
1000,488,531,503,264,492,756
1000,502,482,511,244,516,760
1000,506,477,494,257,504,761
1000,510,510,496,256,497,753
1000,499,503,511,257,513,770
1000,499,499,462,249,473,722
1000,522,505,490,272,489,761
1000,514,472,495,246,521,767
1000,515,484,493,256,501,757
1000,508,480,504,251,506,757
1000,520,497,511,251,495,746
1000,499,499,518,237,523,760
1000,506,482,477,255,491,746
1000,475,497,489,238,491,729
1000,514,501,490,238,502,740
1000,513,484,498,251,507,758
1000,501,486,516,239,523,762
1000,467,508,484,230,493,723
1000,476,490,517,238,510,748
1000,521,494,513,253,501,754
1000,492,467,499,227,527,754
1000,523,504,479,256,480,736
1000,474,508,528,242,515,757
1000,503,497,473,229,508,737
1000,493,501,461,257,472,729
1000,471,503,516,239,510,749
1000,489,531,478,256,486,742
1000,530,529,473,288,467,755
1000,508,533,535,275,509,784
1000,518,491,510,259,510,769
1000,507,525,500,263,503,766
1000,494,520,478,264,476,740
1000,484,534,494,262,470,732
1000,506,487,503,255,491,746
1000,509,497,484,246,507,753
1000,468,499,526,238,506,744
1000,500,495,490,245,490,735
1000,484,497,499,232,510,742
1000,481,525,502,247,499,746
1000,477,508,510,255,482,737
1000,495,502,492,251,484,735
1000,518,510,480,253,503,756
1000,515,488,499,275,485,760
1000,511,504,498,254,496,750
1000,517,502,482,267,484,751
1000,491,512,476,258,469,727
1000,524,513,487,270,499,769
1000,497,521,460,256,479,735
1000,496,455,522,223,530,753
1000,509,513,502,265,501,766
1000,509,487,530,246,524,770
1000,506,500,491,265,491,756
1000,495,499,525,243,507,750
1000,487,510,505,242,517,759
1000,512,533,473,266,471,737
1000,510,491,509,237,513,750
1000,483,518,507,239,504,743
1000,492,494,503,243,508,751
1000,513,511,521,271,504,775
1000,502,485,492,241,515,756
1000,501,495,494,250,506,756
1000,501,498,480,261,481,742
1000,502,509,478,249,488,737
1000,495,525,515,258,496,754
1000,508,519,496,266,480,746
1000,516,482,484,240,503,743
1000,516,482,512,250,524,774
1000,486,491,510,263,488,751
1000,513,512,491,266,501,767
1000,485,523,494,262,467,729
1000,536,488,491,260,501,761
1000,516,479,469,254,480,734
1000,505,519,488,266,475,741
1000,510,475,517,238,529,767
1000,475,472,512,217,518,735
1000,502,473,507,233,517,750
1000,504,508,493,252,491,743
1000,500,474,487,251,488,739
1000,479,511,489,248,492,740
1000,510,486,498,252,501,753
1000,516,492,495,250,517,767
1000,475,483,509,231,511,742
1000,506,480,473,240,495,735
1000,514,489,486,254,490,744
1000,496,499,486,254,480,734
1000,507,506,489,259,491,750
1000,524,501,506,263,482,745
1000,493,493,506,245,500,745
1000,499,505,488,247,484,731
1000,496,517,484,245,501,746
1000,516,520,481,267,477,744
1000,493,497,487,243,498,741
1000,499,467,485,216,516,732
1000,477,478,529,219,539,758
1000,542,455,474,243,526,769
1000,504,471,480,240,519,759
1000,480,492,456,250,475,725
1000,517,486,506,243,520,763
1000,497,508,516,254,499,753
1000,522,498,482,278,476,754
1000,493,494,500,247,517,764
1000,521,488,525,245,537,782
1000,480,489,474,251,478,729
1000,494,486,499,244,510,754
1000,499,482,512,241,520,761
1000,520,494,479,258,489,747
1000,479,500,492,239,487,726
1000,502,476,514,237,510,747
1000,491,483,492,231,516,747
1000,501,477,464,250,486,736
1000,494,522,501,258,493,751
1000,488,475,465,232,495,727
1000,470,518,502,229,511,740
1000,496,504,496,260,473,733
1000,497,506,520,244,510,754
1000,495,474,483,228,512,740
1000,494,480,536,238,533,771
1000,524,493,498,251,516,767
1000,507,480,504,232,526,758
1000,505,496,481,257,493,750
1000,517,478,482,246,496,742
1000,488,485,499,258,490,748
1000,486,506,496,230,513,743
1000,500,504,494,257,494,751
1000,498,508,523,252,511,763
1000,513,510,473,271,460,731
1000,510,503,477,265,478,743
1000,482,503,499,237,498,735
1000,503,504,471,244,505,749
1000,511,509,519,257,503,760
1000,510,515,495,264,486,750
1000,545,488,519,259,534,793
1000,501,523,492,280,471,751
1000,487,488,473,242,485,727
1000,497,476,480,254,474,728
1000,495,478,492,236,516,752
1000,508,509,518,256,493,749
1000,499,513,495,272,471,743
1000,509,517,483,279,458,737
1000,505,478,532,238,514,752
1000,496,482,518,244,513,757
1000,496,487,527,245,513,758
1000,503,492,518,250,523,773
1000,458,480,507,211,517,728
1000,487,497,508,234,515,749
1000,479,507,537,247,521,768
1000,508,507,505,263,516,779
1000,468,519,493,246,481,727
1000,518,494,520,230,542,772
1000,515,510,530,261,505,766
1000,500,513,490,242,498,740
1000,499,515,503,256,499,755
1000,489,489,508,245,512,757
1000,547,489,484,262,507,769
1000,480,504,489,248,498,746
1000,479,497,509,219,533,752
1000,493,498,497,236,506,742
1000,502,492,473,235,492,727
1000,489,521,487,255,476,731
1000,487,475,484,234,493,727
1000,515,499,482,265,479,744
1000,497,484,507,235,514,749
1000,524,513,499,263,487,750
1000,496,500,491,236,505,741
1000,519,489,505,252,512,764
1000,489,527,508,266,489,755
1000,492,502,485,252,503,755
1000,503,492,510,241,506,747
1000,497,523,524,262,494,756
1000,520,491,529,252,521,773
1000,498,517,504,260,486,746
1000,493,490,489,246,495,741
1000,524,507,490,257,500,757
1000,488,503,494,238,504,742
1000,509,514,482,254,495,749
1000,500,487,478,246,482,728
1000,531,484,509,252,508,760
1000,509,507,511,259,501,760
1000,475,507,514,238,511,749
1000,484,494,509,237,519,756
1000,491,467,487,221,511,732
1000,504,491,515,254,512,766
1000,504,506,514,254,508,762
1000,491,530,492,266,468,734
1000,487,532,509,269,488,757
1000,493,522,503,260,493,753
1000,512,487,489,256,508,764
1000,487,504,509,254,503,757
1000,497,499,505,242,511,753
1000,505,491,477,248,500,748
1000,493,488,513,227,532,759
1000,478,507,489,230,502,732
1000,498,483,495,241,490,731
1000,497,490,488,241,496,737
1000,489,495,512,243,496,739
1000,498,492,521,245,512,757
1000,503,499,490,250,496,746
1000,503,509,497,260,496,756
1000,506,518,483,270,466,736
1000,493,501,493,240,498,738
1000,490,527,507,257,485,742
1000,487,518,476,267,454,721
1000,502,481,460,239,490,729
1000,518,516,497,257,506,763
1000,514,513,526,266,501,767
1000,511,505,527,249,531,780
1000,495,495,500,244,508,752
1000,465,505,519,236,510,746
1000,508,513,502,263,490,753
1000,489,507,507,241,520,761
1000,501,524,482,252,494,746
1000,493,495,488,241,495,736
1000,492,517,502,268,483,751
1000,495,499,506,250,495,745
1000,459,486,500,223,498,721
1000,488,493,514,241,517,758
1000,560,477,503,259,526,785
1000,471,516,498,247,479,726
1000,477,515,499,238,505,743
1000,489,514,509,250,501,751
1000,492,485,471,235,495,730
1000,519,483,524,254,517,771
1000,508,501,523,248,528,776
1000,517,504,507,250,524,774
1000,496,505,520,251,499,750
1000,496,492,496,242,497,739
1000,489,499,511,249,495,744
1000,476,510,495,244,489,733
1000,493,481,504,246,509,755
1000,498,511,506,241,501,742
1000,522,519,482,283,478,761
1000,490,514,485,255,490,745
1000,505,504,475,250,483,733
1000,506,507,494,260,469,729
1000,494,504,488,249,493,742
1000,502,499,480,251,485,736
1000,476,513,504,236,509,745
1000,508,519,500,260,499,759
1000,523,468,488,238,517,755
1000,515,505,501,259,519,778
1000,488,507,519,258,499,757
1000,493,487,502,240,513,753
1000,494,486,514,238,525,763
1000,491,497,472,239,474,713
1000,508,470,533,250,533,783
1000,491,511,493,255,486,741
1000,471,502,474,231,492,723
1000,489,526,489,259,482,741
1000,511,526,495,276,486,762
1000,498,508,477,252,466,718
1000,491,498,471,255,479,734
1000,506,513,485,262,469,731
1000,521,491,498,256,503,759
1000,502,518,459,267,464,731
1000,507,519,481,261,482,743
1000,507,475,509,256,502,758
1000,497,465,526,228,534,762
1000,505,509,508,253,510,763
1000,467,501,501,250,480,730
1000,511,490,497,242,513,755
1000,488,489,499,231,516,747
1000,522,494,499,255,507,762
1000,499,468,525,216,549,765
1000,515,467,493,238,526,764
1000,504,487,483,233,504,737
1000,501,488,491,248,516,764
1000,481,487,495,223,506,729
1000,493,492,501,232,506,738
1000,436,477,486,215,489,704
1000,500,505,482,246,495,741
1000,486,500,516,250,496,746
1000,523,494,482,246,511,757
1000,511,507,478,267,470,737
1000,497,511,501,251,490,741
1000,486,468,490,227,504,731
1000,520,497,489,263,484,747
1000,522,525,485,282,472,754
1000,532,512,529,282,505,787
1000,498,500,486,254,492,746
1000,498,524,507,271,468,739
1000,515,518,506,266,498,764
1000,515,502,512,252,505,757
1000,506,487,490,245,498,743
1000,509,519,519,261,509,770
1000,506,509,503,243,499,742
1000,490,493,509,243,515,758
1000,486,511,479,239,476,715
1000,495,496,476,245,523,768
1000,478,484,501,228,532,760
1000,496,505,499,251,492,743
1000,483,524,499,257,479,736
1000,509,475,498,241,502,743
1000,508,518,487,283,466,749
1000,488,491,510,240,510,750
1000,509,502,502,256,495,751
1000,484,489,525,240,496,736
1000,484,499,450,234,478,712
1000,532,491,504,266,508,774
1000,509,488,512,246,515,761
1000,497,511,502,249,501,750
1000,508,514,481,267,484,751
1000,528,492,523,254,522,776
1000,505,483,510,239,524,763
1000,545,516,478,270,494,764
1000,494,474,493,229,526,755
1000,488,494,505,239,512,751
1000,492,495,470,244,480,724
1000,505,500,486,248,508,756
1000,491,490,494,248,499,747
1000,470,495,498,228,492,720
1000,492,498,522,259,492,751
1000,481,480,504,212,542,754
1000,497,501,521,249,516,765
1000,511,501,506,247,516,763
1000,547,492,486,268,491,759
1000,521,502,513,267,493,760
1000,507,507,504,249,514,763
1000,519,487,489,253,505,758
1000,530,506,489,267,502,769
1000,494,498,490,232,512,744
1000,476,490,514,237,517,754
1000,513,481,500,247,510,757
1000,509,479,495,255,501,756
1000,498,509,497,248,496,744
1000,490,504,505,252,504,756
1000,519,498,527,253,522,775
1000,495,497,512,260,497,757
1000,507,499,495,262,487,749
1000,512,479,512,257,495,752
1000,493,505,499,244,505,749
1000,475,473,483,230,496,726
1000,501,492,510,258,492,750
1000,524,502,493,260,495,755
1000,481,507,542,241,531,772
1000,520,501,489,265,498,763
1000,476,504,495,237,500,737
1000,493,498,499,246,493,739
1000,526,544,475,280,460,740
1000,499,492,511,253,512,765
1000,519,514,506,270,498,768
1000,490,518,509,251,501,752
1000,502,494,492,249,505,754
1000,532,503,504,273,507,780
1000,504,516,534,258,496,754
1000,491,511,494,258,474,732
1000,516,483,532,246,540,786
1000,480,475,510,217,524,741
1000,513,500,513,243,531,774
1000,485,494,534,242,508,750
1000,496,505,518,257,501,758
1000,499,520,472,260,484,744
1000,521,477,478,240,515,755
1000,502,535,501,262,491,753
1000,519,509,515,270,498,768
1000,507,534,496,265,478,743
1000,479,492,509,239,499,738
1000,485,492,498,229,514,743
1000,518,508,491,263,498,761
1000,510,482,532,233,537,770
1000,498,505,519,241,512,753
1000,521,496,490,250,508,758
1000,484,495,491,246,500,746
1000,514,506,494,272,479,751
1000,494,501,520,256,504,760
1000,495,501,481,241,499,740
1000,530,484,482,275,490,765
1000,517,505,516,257,518,775
1000,497,496,516,246,507,753
1000,512,490,519,259,504,763
1000,523,488,494,259,501,760
1000,504,488,514,245,515,760
1000,498,524,493,276,460,736
1000,491,492,512,249,515,764
1000,471,510,496,251,489,740
1000,498,513,485,260,476,736
1000,488,509,501,246,509,755
1000,497,505,465,242,485,727
1000,489,477,528,221,527,748
1000,497,501,485,253,475,728
1000,502,515,535,259,515,774
1000,515,518,503,258,503,761
1000,499,497,483,242,502,744
1000,492,518,522,255,502,757
1000,505,507,503,266,495,761
1000,514,513,477,266,485,751
1000,507,520,496,261,482,743
1000,521,511,507,259,499,758
1000,514,491,454,264,464,728
1000,510,522,499,272,481,753
1000,481,504,508,238,511,749
1000,509,521,503,283,466,749
1000,513,503,485,261,493,754
1000,488,506,467,243,494,737
1000,513,511,496,261,488,749
1000,508,502,488,263,488,751
1000,486,492,506,226,516,742
1000,480,511,519,254,499,753
1000,489,517,524,244,496,740
1000,479,477,505,227,517,744
1000,513,488,503,260,497,757
1000,484,483,476,230,503,733
1000,519,502,495,263,487,750
1000,510,489,505,245,518,763
1000,486,508,500,243,498,741
1000,487,492,502,243,498,741
1000,498,495,529,229,533,762
1000,531,463,541,237,536,773
1000,479,497,502,245,511,756
1000,518,488,536,259,500,759
1000,497,503,510,244,502,746
1000,487,491,480,221,508,729
1000,494,463,492,216,530,746
1000,509,508,523,255,514,769
1000,495,474,493,240,504,744
1000,504,476,490,247,500,747
1000,517,507,506,262,494,756
1000,453,514,484,244,485,729
1000,494,493,494,234,525,759
1000,471,500,508,237,499,736
1000,499,493,490,255,491,746
1000,522,501,481,261,483,744
1000,502,501,503,248,503,751
1000,493,501,466,240,491,731
1000,523,495,506,270,486,756
1000,507,510,500,266,493,759
1000,494,501,492,251,491,742
1000,504,497,488,242,503,745
1000,488,468,509,227,516,743
1000,484,495,477,248,497,745
1000,492,525,475,257,478,735
1000,495,494,499,248,498,746
1000,501,511,494,256,493,749
1000,519,511,478,267,471,738
1000,485,503,517,254,505,759
1000,499,517,501,248,500,748
1000,498,479,490,238,499,737
1000,525,533,531,304,484,788
1000,463,473,499,212,501,713
1000,498,487,539,240,520,760
1000,502,491,500,258,499,757
1000,506,482,506,236,504,740
1000,518,510,504,256,484,740
1000,510,462,496,239,513,752
1000,506,529,508,275,493,768
1000,515,493,522,248,522,770
1000,491,483,502,219,532,751
1000,523,502,534,268,515,783
1000,489,510,523,252,502,754
1000,467,517,467,245,477,722
1000,502,489,490,258,503,761
1000,504,507,500,262,487,749
1000,489,481,522,244,522,766
1000,495,505,507,230,512,742
1000,485,492,509,233,501,734
1000,494,486,496,232,511,743
1000,509,490,497,260,493,753
1000,493,506,488,248,488,736
1000,509,520,526,259,508,767
1000,490,483,472,252,473,725
1000,519,520,503,257,506,763
1000,494,512,491,246,491,737
1000,501,496,502,253,493,746
1000,505,510,509,260,503,763
1000,506,514,491,265,485,750
1000,471,479,509,218,522,740
1000,493,507,519,260,493,753
1000,500,511,498,260,471,731
1000,490,500,530,243,521,764
1000,490,467,492,234,522,756
1000,488,481,518,238,518,756
1000,523,474,513,241,526,767
1000,496,496,504,238,519,757
1000,489,519,504,256,485,741
1000,516,524,504,278,479,757
1000,518,510,482,258,489,747
1000,510,492,489,242,507,749
1000,525,530,512,269,513,782
1000,497,485,523,235,524,759
1000,506,508,516,259,496,755
1000,515,494,518,252,514,766
1000,523,490,513,263,525,788
1000,523,502,503,266,499,765
1000,507,482,479,249,487,736
1000,506,529,498,248,506,754
1000,502,498,504,256,495,751
1000,532,498,505,264,501,765
1000,528,492,513,273,499,772
1000,522,525,468,278,471,749
1000,488,524,503,258,493,751
1000,492,493,503,231,513,744
1000,494,516,511,255,520,775
1000,517,494,515,253,514,767
1000,497,489,507,230,514,744
1000,493,500,505,263,486,749
1000,489,474,513,230,520,750
1000,489,511,472,242,502,744
1000,505,491,488,253,503,756
1000,494,499,495,241,500,741
1000,507,501,494,258,485,743
1000,504,485,500,241,505,746
1000,494,503,513,233,520,753
1000,490,505,501,249,487,736
1000,494,537,483,265,466,731
1000,507,518,473,269,457,726
1000,482,515,496,247,490,737
1000,504,476,497,251,504,755
1000,493,475,499,230,531,761
1000,490,486,483,227,503,730
1000,473,511,510,238,508,746
1000,517,507,517,274,503,777
1000,519,484,527,235,540,775
1000,475,480,499,234,505,739
1000,497,490,488,231,514,745
1000,490,476,510,236,513,749
1000,487,477,505,235,499,734
1000,490,489,518,227,526,753
1000,515,498,518,259,502,761
1000,503,500,478,259,482,741
1000,510,510,510,254,499,753
1000,477,498,479,229,504,733
1000,499,483,516,245,511,756
1000,497,501,492,247,492,739
1000,508,498,508,258,499,757
1000,494,498,521,253,520,773
1000,505,520,480,259,485,744
1000,500,540,506,272,469,741
1000,507,499,479,266,476,742
1000,481,502,486,236,488,724
1000,512,512,464,266,474,740
1000,499,499,500,248,501,749
1000,518,489,497,264,493,757
1000,498,526,506,255,495,750
1000,500,500,493,264,484,748
1000,500,491,518,236,511,747
1000,511,483,476,253,482,735
1000,480,453,495,220,522,742
1000,487,498,499,241,504,745
1000,475,479,499,226,509,735
1000,494,484,483,235,495,730
1000,497,501,517,246,514,760
1000,487,492,502,260,474,734
1000,513,476,492,244,504,748
1000,485,506,492,241,497,738
1000,498,515,494,245,518,763
1000,503,492,514,254,519,773
1000,483,510,519,255,500,755
1000,509,505,491,260,469,729
1000,516,483,509,248,513,761
1000,500,489,509,243,504,747
1000,524,514,491,277,478,755
1000,502,510,512,258,510,768
1000,522,526,482,280,460,740
1000,515,520,523,264,497,761
1000,493,462,490,231,496,727
1000,486,520,514,242,515,757
1000,494,489,511,239,518,757
1000,526,480,489,256,501,757
1000,519,503,485,254,492,746
1000,514,503,511,250,506,756
1000,527,479,516,261,504,765
1000,527,514,486,266,489,755
1000,498,488,512,229,521,750
1000,512,517,482,259,499,758
1000,518,518,492,275,483,758
1000,500,484,512,240,513,753
1000,482,485,514,236,500,736
1000,493,501,480,246,493,739
1000,519,496,506,268,491,759
1000,491,528,492,271,465,736
1000,474,502,512,236,503,739
1000,496,508,488,258,479,737
1000,499,496,498,237,510,747
1000,491,499,526,255,500,755
1000,492,490,484,239,496,735
1000,508,497,510,246,509,755
1000,503,503,502,252,504,756
1000,514,492,512,256,508,764
1000,523,505,484,264,495,759
1000,491,486,495,242,496,738
1000,509,509,488,270,482,752
1000,490,516,504,245,499,744
1000,511,493,501,253,506,759
1000,507,470,507,250,513,763
1000,491,485,512,247,506,753
1000,500,521,492,262,501,763
1000,496,479,490,239,502,741
1000,496,510,495,255,496,751
1000,529,480,478,248,491,739
1000,506,524,486,249,509,758
1000,514,518,503,271,488,759
1000,485,507,501,248,495,743
1000,475,484,506,231,506,737
1000,507,505,529,255,517,772
1000,481,516,491,241,499,740
1000,497,496,518,246,517,763
1000,497,526,480,259,472,731
1000,495,483,481,229,506,735
1000,487,496,500,244,513,757
1000,481,475,504,225,514,739
1000,490,517,521,249,506,755
1000,493,510,506,250,502,752
1000,497,495,502,254,492,746
1000,459,457,499,205,529,734
1000,517,514,479,260,489,749
1000,512,505,491,262,489,751
1000,504,487,517,255,508,763
1000,492,492,516,229,527,756
1000,504,510,485,253,488,741
1000,502,508,506,260,484,744
1000,516,513,525,254,523,777
1000,522,526,495,276,474,750
1000,467,518,479,235,486,721
1000,519,514,483,277,474,751
1000,480,489,500,239,510,749
1000,505,526,495,258,492,750
1000,488,487,506,231,510,741
1000,492,489,513,241,514,755
1000,483,526,517,254,492,746
1000,498,523,501,268,476,744
1000,500,492,503,242,509,751
1000,506,506,501,264,498,762
1000,497,514,510,260,498,758
1000,526,510,512,259,519,778
1000,501,510,504,250,522,772
1000,491,515,491,270,467,737
1000,489,493,490,249,488,737
1000,446,519,507,235,487,722
1000,483,515,472,243,487,730
1000,496,539,513,265,479,744
1000,529,508,502,260,500,760
1000,504,495,473,249,487,736
1000,480,516,488,238,500,738
1000,516,496,483,237,513,750
1000,473,532,484,254,476,730
1000,523,505,484,278,461,739
1000,477,495,514,245,501,746
1000,520,490,503,248,512,760
1000,492,493,521,260,499,759
1000,505,506,505,246,490,736
1000,505,500,506,255,483,738
1000,498,483,499,240,505,745
1000,492,492,490,239,503,742
1000,476,513,521,246,495,741
1000,500,513,496,255,487,742
1000,511,517,515,269,478,747
1000,517,512,506,266,498,764
1000,524,522,503,265,502,767
1000,491,482,478,239,498,737
1000,476,495,505,234,519,753
1000,506,505,504,262,496,758
1000,482,496,501,235,496,731
1000,512,507,514,260,495,755
1000,491,497,483,235,500,735
1000,523,513,516,272,499,771
1000,495,499,507,251,507,758
1000,502,502,492,252,481,733
1000,501,510,492,247,507,754
1000,493,520,502,252,494,746
1000,510,490,478,254,481,735
1000,493,501,484,243,498,741
1000,488,530,463,259,461,720
1000,491,524,515,265,492,757
1000,463,484,509,224,520,744
1000,541,513,510,262,515,777
1000,525,518,488,267,487,754
1000,490,502,495,251,483,734
1000,509,494,521,250,512,762
1000,509,495,490,250,500,750
1000,504,499,494,247,500,747
1000,512,466,481,240,505,745
1000,537,499,488,284,468,752
1000,497,472,497,250,502,752
1000,508,483,501,247,488,735
1000,500,495,515,252,505,757
1000,504,502,506,250,510,760
1000,499,503,507,239,515,754
1000,482,494,500,235,501,736
1000,491,526,522,260,497,757
1000,495,495,496,246,507,753
1000,486,483,513,234,518,752
1000,495,469,495,236,509,745
1000,497,478,495,238,519,757
1000,493,502,507,252,495,747
1000,491,489,497,244,501,745
1000,473,510,485,246,481,727
1000,515,503,460,251,481,732
1000,496,504,503,249,489,738
1000,503,524,503,264,497,761
1000,481,510,514,252,495,747
1000,470,487,490,241,485,726
1000,500,484,508,241,515,756
1000,519,521,505,276,472,748
1000,493,487,477,235,504,739
1000,522,518,497,272,478,750
1000,502,511,489,259,489,748
1000,497,517,495,262,487,749
1000,492,514,489,256,505,761
1000,485,496,526,239,511,750
1000,467,488,515,216,528,744
1000,495,507,513,254,504,758
1000,519,475,489,244,519,763
1000,489,484,508,234,510,744
1000,478,533,488,246,478,724
1000,484,485,502,237,516,753
1000,484,496,503,252,493,745
1000,488,496,483,223,516,739
1000,502,469,529,240,526,766
1000,509,480,511,240,521,761
1000,493,487,483,243,484,727
1000,487,475,532,247,519,766
1000,504,500,522,245,505,750
1000,511,516,476,269,463,732
1000,478,516,503,246,487,733
1000,485,494,506,237,512,749
1000,512,491,510,243,517,760
1000,511,491,471,242,499,741
1000,503,494,475,245,498,743
1000,519,515,535,271,497,768
1000,500,504,502,247,506,753
1000,504,491,506,242,512,754
1000,505,494,487,256,478,734
1000,492,483,507,239,515,754
1000,507,491,519,262,500,762
1000,502,491,487,231,498,729
1000,472,532,516,260,485,745
1000,480,489,470,231,489,720
1000,515,506,493,254,494,748
1000,499,508,495,270,478,748
1000,490,469,528,221,539,760
1000,534,502,469,264,507,771
1000,490,506,516,256,489,745
1000,495,514,485,251,476,727
1000,475,505,522,246,504,750
1000,507,481,494,228,507,735
1000,500,501,516,245,526,771
1000,514,513,481,261,496,757
1000,479,465,483,213,524,737
1000,517,492,486,247,502,749
1000,487,527,511,255,474,729
1000,492,525,495,254,478,732
1000,494,503,484,247,486,733
1000,485,508,468,253,460,713
1000,495,503,488,258,489,747
1000,517,488,479,251,477,728
1000,517,514,520,274,485,759
1000,484,523,509,253,495,748
1000,524,501,500,265,497,762
1000,475,485,509,234,510,744
1000,497,518,485,266,478,744
1000,505,490,517,251,518,769
1000,486,485,514,230,505,735
1000,488,510,494,231,507,738
1000,506,499,501,244,498,742
1000,517,508,500,265,491,756
1000,494,515,491,250,499,749
1000,478,490,492,233,508,741
1000,498,495,504,249,499,748
1000,496,527,505,260,496,756
1000,520,497,530,261,509,770
1000,514,521,505,272,483,755
1000,496,495,502,236,491,727
1000,504,531,477,277,456,733
1000,470,489,491,233,510,743
1000,471,502,526,240,504,744
1000,508,500,529,258,517,775
1000,499,483,488,244,490,734
1000,491,482,502,230,516,746
1000,476,488,530,228,531,759
1000,500,492,488,239,505,744
1000,491,505,505,245,514,759
1000,501,498,508,252,511,763
1000,486,503,510,241,515,756
1000,511,496,504,255,499,754
1000,477,511,475,240,487,727
1000,496,514,500,263,477,740
1000,520,485,519,256,519,775
1000,508,504,475,249,486,735
1000,511,503,500,254,499,753
1000,488,491,547,236,536,772
1000,499,504,513,235,511,746
1000,505,508,505,252,490,742
1000,473,514,488,237,493,730
1000,514,510,509,259,490,749
1000,506,486,509,242,521,763
1000,516,500,488,258,486,744
1000,497,512,496,251,491,742
1000,468,527,523,245,489,734
1000,484,495,507,236,513,749
1000,515,501,485,261,470,731
1000,500,509,491,264,490,754
1000,510,496,504,256,492,748
1000,516,482,517,242,517,759
1000,494,486,498,236,507,743
1000,492,465,514,217,537,754
1000,508,505,527,266,511,777
1000,474,499,521,240,515,755
1000,487,491,524,248,496,744
1000,499,493,462,257,483,740
1000,499,526,499,262,478,740
1000,500,506,486,244,505,749
1000,479,482,502,220,529,749
1000,494,521,460,262,456,718
1000,500,518,497,264,484,748
1000,488,489,483,240,496,736
1000,474,490,494,245,498,743
1000,529,540,508,298,481,779
1000,480,491,487,235,493,728
1000,519,520,481,279,489,768
1000,503,519,492,266,488,754
1000,482,537,490,264,461,725
1000,490,480,492,242,498,740
1000,519,500,526,260,492,752
1000,465,503,491,224,508,732
1000,492,494,515,237,522,759
1000,484,500,525,239,521,760
1000,504,489,523,252,506,758
1000,510,507,512,256,513,769
1000,521,521,489,275,487,762
1000,517,507,497,257,510,767
1000,518,497,513,256,510,766
1000,517,475,528,241,529,770
1000,497,496,497,262,479,741
1000,478,505,464,232,493,725
1000,492,483,485,239,508,747
1000,485,498,519,248,495,743
1000,514,513,473,266,471,737
1000,519,507,511,261,510,771
1000,500,497,479,240,507,747
1000,509,492,509,246,513,759
1000,501,517,498,242,515,757
1000,514,502,502,264,488,752
1000,518,501,505,257,499,756
1000,480,493,517,246,490,736
1000,509,456,504,239,521,760
1000,495,497,500,243,510,753
1000,503,500,475,255,482,737
1000,528,500,490,259,508,767
1000,497,508,495,247,490,737
1000,496,502,474,235,507,742
1000,514,489,491,264,492,756
1000,461,512,497,234,499,733
1000,502,491,508,246,514,760
1000,505,488,507,264,487,751
1000,500,484,519,246,520,766
1000,513,491,523,251,516,767
1000,483,515,526,258,493,751
1000,478,511,515,250,492,742
1000,488,491,502,237,505,742
1000,512,490,507,246,503,749
1000,486,510,525,239,529,768
1000,529,506,479,280,475,755
1000,486,503,486,256,475,731
1000,492,503,514,251,498,749
1000,485,503,502,239,514,753
1000,490,508,504,248,507,755
1000,497,499,505,239,523,762
1000,509,501,520,256,506,762
1000,456,512,511,244,490,734
1000,506,484,495,244,495,739
1000,494,506,519,250,509,759
1000,507,528,495,265,481,746
1000,496,488,473,227,494,721
1000,501,476,491,252,512,764
1000,484,549,490,255,479,734
1000,510,519,501,268,472,740
1000,491,505,519,253,503,756
1000,505,497,512,246,510,756
1000,500,483,510,228,532,760
1000,494,482,520,241,524,765
1000,493,534,497,268,461,729
1000,497,496,489,238,501,739
1000,497,507,513,247,506,753
1000,498,501,497,236,513,749
1000,514,506,505,250,515,765
1000,518,496,495,273,476,749
1000,478,480,495,220,512,732
1000,528,528,515,275,502,777
1000,497,497,495,264,492,756
1000,489,526,474,268,459,727
1000,468,503,503,236,494,730
1000,500,506,502,261,488,749
1000,476,475,506,213,526,739
1000,473,537,503,256,487,743
1000,510,505,501,256,493,749
1000,512,486,493,245,519,764
1000,493,484,511,238,515,753
1000,511,502,527,255,522,777
1000,523,512,489,272,487,759
1000,529,481,496,270,495,765
1000,483,518,497,243,498,741
1000,497,489,505,250,498,748
1000,498,478,488,227,528,755
1000,502,524,496,258,495,753
1000,501,501,488,250,491,741
1000,523,505,497,250,512,762
1000,502,510,526,259,501,760
1000,504,486,486,241,498,739
1000,532,504,522,253,521,774
1000,484,519,511,267,475,742
1000,518,515,495,268,482,750
1000,503,443,497,221,529,750
1000,526,475,501,247,514,761
1000,505,496,491,254,494,748
1000,497,485,503,231,523,754
1000,500,517,491,268,490,758
1000,476,500,486,229,509,738
1000,518,510,477,257,477,734
1000,477,521,483,245,490,735
1000,480,497,491,245,496,741
1000,510,498,506,249,515,764
1000,505,516,519,262,492,754
1000,502,520,518,251,517,768
1000,489,524,502,247,486,733
1000,514,491,518,255,512,767
1000,484,497,483,253,458,711
1000,490,514,516,254,487,741
1000,498,460,529,235,526,761
1000,510,483,499,255,510,765
1000,495,495,481,260,485,745
1000,525,493,500,255,509,764
1000,516,487,510,255,500,755
1000,485,534,484,260,481,741
1000,487,481,478,235,502,737
1000,521,533,503,271,490,761
1000,487,490,499,254,491,745
1000,506,523,479,261,481,742
1000,498,495,515,260,501,761
1000,481,465,491,226,502,728
1000,501,500,513,260,492,752
1000,511,493,480,262,478,740
1000,490,514,491,241,489,730
1000,530,502,506,268,500,768
1000,537,495,503,259,521,780
1000,518,481,520,241,535,776
1000,523,502,508,258,489,747
1000,462,487,517,224,513,737
1000,482,477,505,225,527,752
1000,501,473,475,227,511,738
1000,508,498,482,248,500,748
1000,508,484,487,235,501,736
1000,492,513,476,255,471,726
1000,500,509,489,260,499,759
1000,537,506,485,262,506,768
1000,477,537,481,260,471,731
1000,484,496,470,243,492,735
1000,482,484,514,230,523,753
1000,514,488,519,259,521,780
1000,491,501,489,248,487,735
1000,486,495,526,249,512,761
1000,515,484,516,252,504,756
1000,524,519,484,262,495,757
1000,503,505,520,252,501,753
1000,509,480,499,236,519,755
1000,495,499,521,253,515,768
1000,501,496,522,245,513,758
1000,514,470,505,240,518,758
1000,519,502,489,263,480,743
1000,498,506,498,261,484,745
1000,491,494,511,246,506,752
1000,526,516,509,277,494,771
1000,467,515,503,244,490,734
1000,496,516,500,264,490,754
1000,511,497,495,241,511,752
1000,505,487,505,246,499,745
1000,509,483,508,263,510,773
1000,466,499,488,227,488,715
1000,520,500,479,260,483,743
1000,512,477,498,242,520,762
1000,513,506,491,272,483,755
1000,484,522,498,258,473,731
1000,515,506,508,255,500,755
1000,485,484,480,238,494,732
1000,488,490,497,238,508,746
1000,502,492,485,242,500,742
1000,496,492,487,236,509,745
1000,486,491,516,242,516,758
1000,488,494,520,253,505,758
1000,500,514,495,255,506,761
1000,482,503,500,252,491,743
1000,491,520,480,267,460,727
1000,491,479,475,240,486,726
1000,495,529,489,260,479,739
1000,484,505,475,245,482,727
1000,496,495,495,248,477,725
1000,524,494,522,270,492,762
1000,501,508,484,250,490,740
1000,486,504,490,247,497,744
1000,495,484,481,243,487,730
1000,503,495,517,247,524,771
1000,515,489,512,251,502,753
1000,510,499,472,251,484,735
1000,473,492,489,240,491,731
1000,495,490,530,235,523,758
1000,505,496,500,258,512,770
1000,466,506,516,229,506,735
1000,499,499,497,241,509,750
1000,494,505,506,246,502,748
1000,517,513,494,264,480,744
1000,516,486,486,251,511,762
1000,500,482,490,241,506,747
1000,502,519,493,253,482,735
1000,525,512,473,261,496,757
1000,499,498,507,244,515,759
1000,524,509,506,264,498,762
1000,497,501,479,253,477,730
1000,475,517,519,247,502,749
1000,484,482,501,235,512,747
1000,516,492,490,257,497,754
1000,488,504,500,242,515,757
1000,517,505,493,258,481,739
1000,512,524,502,270,490,760
1000,494,494,482,242,496,738
1000,479,477,518,216,543,759
1000,481,512,518,247,496,743
1000,520,483,504,262,502,764
1000,474,495,492,242,495,737
1000,493,513,475,262,475,737
1000,502,528,514,271,473,744
1000,502,496,471,238,506,744
1000,525,478,522,249,525,774
1000,470,510,504,218,522,740
1000,505,488,491,257,484,741
1000,522,487,477,249,495,744
1000,497,487,514,229,554,783
1000,486,518,467,245,468,713
1000,495,520,508,263,478,741
1000,491,522,515,257,490,747
1000,510,520,482,260,488,748
1000,511,467,493,232,539,771
1000,479,527,493,267,483,750
1000,477,522,483,243,481,724
1000,514,513,478,256,488,744
1000,507,530,501,260,504,764
1000,483,501,519,244,501,745
1000,489,486,515,241,515,756
1000,507,488,504,247,508,755
1000,525,506,515,257,497,754
1000,497,509,499,256,488,744
1000,508,488,506,238,538,776
1000,492,504,539,247,519,766
1000,508,508,508,265,493,758
1000,522,499,534,276,490,766
1000,470,488,479,240,489,729
1000,527,497,492,261,504,765
1000,493,505,525,245,531,776
1000,558,486,505,269,516,785
1000,483,482,509,221,529,750
1000,491,502,499,244,501,745
1000,489,482,486,242,512,754
1000,508,497,516,244,523,767
1000,511,469,473,251,491,742
1000,497,532,494,262,480,742
1000,509,503,520,256,519,775
1000,487,490,500,222,517,739
1000,503,517,466,241,495,736
1000,531,500,478,268,485,753
1000,503,498,499,262,493,755
1000,477,493,510,237,506,743
1000,506,491,503,249,502,751
1000,499,505,473,264,461,725
1000,510,499,503,252,510,762
1000,525,502,491,263,486,749
1000,515,515,464,262,485,747
1000,486,501,495,257,483,740
1000,495,495,508,254,499,753
1000,523,490,498,247,522,769
1000,513,494,499,245,507,752
1000,490,505,504,242,487,729
1000,506,486,502,255,496,751
1000,507,513,496,265,489,754
1000,510,525,533,261,514,775
1000,500,470,500,230,520,750
1000,507,509,492,261,488,749
1000,485,503,482,229,511,740
1000,504,494,496,251,489,740
1000,511,519,489,272,477,749
1000,521,480,486,234,510,744
1000,469,518,516,242,495,737
1000,488,496,488,238,494,732
1000,499,506,513,257,498,755
1000,463,488,498,226,499,725
1000,508,485,478,247,495,742
1000,494,525,509,273,480,753
1000,493,495,509,234,525,759
1000,498,528,500,270,485,755
1000,494,513,468,253,465,718
1000,484,473,513,225,521,746
1000,489,487,521,240,519,759
1000,470,492,526,227,524,751
1000,483,516,526,246,518,764
1000,499,514,478,254,492,746
1000,504,528,521,265,495,760
1000,515,499,496,246,518,764
1000,525,506,493,263,500,763
1000,509,501,483,276,475,751
1000,503,516,505,269,488,757
1000,494,503,495,247,499,746
1000,527,508,509,256,508,764
1000,489,503,486,237,487,724
1000,504,502,524,249,513,762
1000,487,485,521,244,517,761
1000,503,499,502,242,502,744
1000,472,506,489,235,496,731
1000,515,522,476,266,475,741
1000,506,484,493,242,503,745
1000,507,498,501,256,506,762
1000,481,484,487,231,508,739
1000,480,501,500,247,481,728
1000,517,475,479,237,503,740
1000,546,494,480,270,495,765
1000,491,502,510,251,521,772
1000,508,511,510,259,518,777
1000,487,516,517,247,491,738
1000,498,493,521,250,511,761
1000,467,495,504,220,520,740
1000,522,537,513,266,489,755
1000,527,487,475,248,513,761
1000,515,487,491,244,508,752
1000,503,519,507,253,512,765
1000,468,518,502,244,486,730
1000,505,502,483,251,481,732
1000,507,514,519,264,504,768
1000,499,479,470,243,500,743
1000,483,508,518,246,512,758
1000,521,501,500,261,501,762
1000,466,494,515,228,520,748
1000,506,510,500,255,489,744
1000,502,498,524,241,519,760
1000,503,487,464,248,484,732
1000,491,503,518,266,476,742
1000,456,506,519,244,492,736
1000,507,521,502,256,493,749
1000,470,508,501,236,497,733
1000,513,500,483,256,489,745
1000,512,518,525,267,512,779
1000,501,509,507,272,486,758
1000,481,502,480,242,468,710
1000,500,495,506,249,500,749
1000,495,474,500,237,517,754
1000,490,486,524,241,520,761
1000,497,521,502,272,466,738
1000,494,466,488,245,491,736
1000,535,492,512,262,506,768
1000,490,504,513,252,510,762
1000,509,507,479,262,476,738
1000,519,515,504,264,490,754
1000,487,495,490,227,495,722
1000,487,505,486,257,474,731
1000,483,521,480,252,479,731
1000,483,504,494,248,497,745
1000,492,498,530,239,511,750
1000,465,496,528,226,524,750
1000,507,500,508,241,528,769
1000,514,472,537,232,546,778
1000,502,480,527,229,537,766
1000,500,471,500,240,510,750
1000,476,522,476,248,470,718
1000,495,512,486,256,482,738
1000,470,501,465,232,492,724
1000,480,493,478,225,495,720
1000,479,528,509,236,519,755
1000,505,494,515,265,487,752
1000,491,500,504,241,508,749
1000,489,481,508,237,512,749
1000,519,478,511,251,508,759
1000,515,485,491,252,499,751
1000,485,479,493,231,510,741
1000,532,497,499,265,504,769
1000,487,511,497,249,493,742
1000,485,465,497,234,516,750
1000,499,469,507,237,513,750
1000,499,491,515,257,509,766
1000,504,506,502,258,482,740
1000,525,482,489,259,485,744
1000,509,499,519,265,491,756
1000,510,520,492,276,474,750
1000,511,499,496,240,508,748
1000,505,521,500,268,472,740
1000,528,513,519,264,516,780
1000,500,506,506,247,486,733
1000,505,506,509,252,510,762
1000,498,498,497,245,501,746
1000,504,514,515,265,496,761
1000,520,485,516,244,516,760
1000,500,510,504,249,503,752
1000,482,507,526,250,492,742
1000,503,486,494,253,489,742
1000,518,491,503,240,508,748
1000,504,502,491,245,515,760
1000,492,500,495,238,509,747
1000,494,496,520,239,527,766
1000,502,478,512,238,522,760
1000,479,491,505,234,521,755
1000,492,491,496,237,499,736
1000,509,524,504,271,480,751
1000,517,510,466,256,478,734
1000,473,494,483,233,501,734
1000,516,524,493,278,469,747
1000,501,503,484,248,505,753
1000,493,474,503,248,497,745
1000,508,473,489,230,523,753
1000,500,526,535,277,487,764
1000,530,485,508,249,514,763
1000,495,509,471,259,476,735
1000,477,505,520,250,509,759
1000,478,502,506,232,504,736
1000,485,496,513,247,505,752
1000,487,494,504,243,497,740
1000,502,496,489,251,484,735
1000,500,479,494,240,518,758
1000,492,517,526,253,498,751
1000,493,520,501,256,487,743
1000,483,509,516,246,500,746
1000,480,479,490,236,499,735
1000,505,486,489,254,499,753
1000,531,508,533,264,505,769
1000,506,525,507,272,485,757
1000,490,499,480,243,478,721
1000,489,478,495,237,499,736
1000,508,554,483,289,448,737
1000,491,503,497,242,499,741
1000,488,460,487,217,528,745
1000,506,482,501,238,507,745
1000,501,507,502,268,474,742
1000,514,493,509,252,522,774
1000,508,480,498,236,506,742
1000,510,531,511,267,493,760
1000,520,474,482,250,494,744
1000,516,512,539,265,504,769
1000,474,504,490,228,496,724
1000,511,498,496,259,490,749
1000,520,509,506,258,514,772
1000,480,513,511,239,520,759
1000,491,473,506,236,500,736
1000,487,479,509,229,514,743
1000,516,508,481,270,468,738
1000,513,510,477,249,500,749
1000,501,516,499,260,488,748
1000,528,507,492,269,492,761
1000,515,503,469,252,493,745
1000,495,494,491,234,510,744
1000,497,500,530,245,509,754
1000,512,486,518,249,515,764
1000,538,507,477,269,491,760
1000,515,479,525,243,528,771
1000,498,511,516,251,505,756
1000,486,499,506,237,509,746
1000,527,519,511,276,483,759
1000,507,477,521,239,507,746
1000,489,496,499,238,508,746
1000,493,498,500,251,476,727
1000,506,494,530,245,510,755
1000,475,487,496,242,499,741
1000,497,513,501,262,488,750
1000,478,479,523,203,546,749
1000,483,516,517,252,489,741
1000,462,506,530,234,508,742
1000,545,477,520,258,521,779
1000,502,475,509,239,516,755
1000,503,488,507,252,497,749
1000,491,488,504,236,500,736
1000,502,513,473,253,483,736
1000,496,487,501,242,508,750
1000,535,487,489,271,509,780
1000,511,496,511,241,525,766
1000,501,520,511,268,494,762
1000,500,504,517,256,506,762
1000,504,507,498,256,490,746
1000,495,482,515,231,534,765
1000,504,505,483,246,490,736
1000,509,485,507,255,506,761
1000,495,477,486,221,522,743
1000,517,527,507,278,493,771
1000,506,506,523,240,524,764
1000,482,504,499,251,493,744
1000,500,507,515,224,521,745
1000,494,500,511,247,504,751
1000,503,498,496,253,492,745
1000,527,497,522,267,494,761
1000,505,500,507,249,505,754
1000,496,524,499,263,472,735
1000,519,500,492,266,507,773
1000,503,511,498,255,494,749
1000,508,524,476,272,468,740
1000,504,514,501,275,494,769
1000,523,520,468,267,473,740
1000,484,496,521,245,500,745
1000,501,496,476,245,495,740
1000,491,501,504,257,493,750
1000,506,488,493,249,503,752
1000,505,494,485,253,499,752
1000,496,505,532,253,531,784
1000,498,532,483,259,483,742
1000,521,491,507,259,505,764
1000,506,499,501,243,513,756
1000,485,517,509,261,484,745
1000,487,490,504,228,531,759
1000,493,492,494,233,522,755
1000,493,516,494,274,467,741
1000,485,487,492,235,502,737
1000,489,526,491,267,460,727
1000,478,497,477,228,504,732
1000,499,489,493,251,484,735
1000,489,497,504,243,498,741
1000,507,493,538,238,540,778
1000,519,529,488,274,477,751
1000,496,522,484,268,473,741
1000,514,510,508,254,514,768
1000,521,494,472,245,493,738
1000,498,498,487,222,512,734
1000,501,542,500,286,461,747
1000,496,518,518,256,494,750
1000,476,498,480,226,502,728
1000,523,512,480,267,498,765
1000,505,486,486,256,497,753
1000,495,495,476,254,472,726
1000,502,487,497,250,511,761
1000,511,498,501,251,512,763
1000,497,506,531,252,497,749
1000,520,498,497,258,502,760
1000,469,509,517,238,505,743
1000,507,493,508,254,506,760
1000,520,487,497,252,498,750
1000,492,487,483,240,502,742
1000,500,511,517,254,497,751
1000,544,519,503,267,499,766
1000,495,494,536,244,519,763
1000,490,477,501,238,497,735
1000,479,512,501,262,463,725
1000,508,510,503,256,497,753
1000,490,499,487,250,484,734
1000,522,496,537,258,530,788
1000,505,509,474,248,489,737
1000,482,524,491,246,481,727
1000,484,519,487,262,464,726
1000,489,506,490,261,479,740
1000,497,478,512,249,504,753
1000,496,488,524,241,509,750
1000,481,490,497,230,494,724
1000,481,506,498,253,482,735
1000,514,518,467,266,464,730
1000,529,492,502,272,490,762
1000,485,497,500,239,504,743
1000,490,511,508,255,488,743
1000,470,482,468,234,466,700
1000,501,515,505,256,497,753
1000,496,490,489,251,483,734
1000,464,531,494,262,470,732
1000,495,501,484,245,490,735
1000,516,496,503,265,493,758
1000,476,502,513,230,520,750
1000,485,464,484,232,494,726
1000,507,505,517,251,503,754
1000,462,503,501,228,496,724
1000,491,511,502,242,502,744
1000,500,500,477,253,481,734
1000,494,538,488,262,478,740
1000,478,496,515,235,508,743
1000,488,510,503,248,502,750
1000,515,482,508,249,512,761
1000,486,502,477,257,449,706
1000,495,530,474,260,471,731
1000,510,507,500,258,487,745
1000,482,499,499,233,503,736
1000,509,510,483,264,479,743
1000,485,490,510,250,507,757
1000,520,501,489,266,495,761
1000,517,517,500,260,493,753
1000,504,463,502,228,534,762
1000,484,513,487,257,469,726
1000,519,468,490,248,504,752
1000,527,529,518,268,510,778
1000,501,513,482,270,470,740
1000,490,487,496,238,499,737
1000,499,504,525,249,504,753
1000,496,521,509,259,489,748
1000,482,497,491,237,503,740
1000,475,506,517,228,518,746
1000,497,491,504,253,494,747
1000,484,503,509,250,504,754
1000,507,474,501,245,506,751
1000,509,496,485,256,484,740
1000,495,529,512,256,484,740
1000,495,507,514,241,516,757
1000,519,520,514,273,488,761
1000,511,516,502,261,484,745
1000,521,498,511,262,508,770
1000,498,481,536,233,541,774
1000,487,506,509,264,503,767
1000,496,491,475,249,470,719
1000,510,524,507,270,480,750
1000,501,504,489,261,485,746
1000,514,511,492,274,485,759
1000,502,516,484,259,488,747
1000,507,516,523,273,483,756
1000,543,506,490,274,493,767
1000,529,502,497,260,515,775
1000,521,494,490,260,502,762
1000,504,531,480,261,475,736
1000,501,520,491,270,479,749
1000,517,486,498,259,507,766
1000,517,509,473,267,493,760
1000,512,497,523,258,510,768
1000,525,510,498,266,496,762
1000,496,492,498,239,517,756
1000,481,495,498,238,501,739
1000,478,498,496,226,513,739
1000,494,478,511,244,516,760
1000,511,533,494,258,489,747
1000,503,518,502,259,486,745
1000,500,496,512,235,532,767
1000,511,490,483,258,492,750
1000,484,533,488,258,469,727
1000,495,521,465,249,470,719
1000,533,507,493,278,469,747
1000,494,503,515,246,509,755
1000,499,481,499,239,524,763
1000,483,488,484,255,484,739
1000,487,512,501,233,498,731
1000,491,498,505,252,493,745
1000,480,492,534,232,528,760
1000,505,519,498,255,481,736
1000,504,512,500,266,473,739
1000,495,502,490,258,465,723
1000,523,514,491,261,491,752
1000,509,532,506,271,481,752
1000,480,502,515,249,497,746
1000,482,484,496,244,503,747
1000,476,512,496,250,483,733
1000,532,520,502,286,470,756
1000,517,522,511,277,472,749
1000,522,493,488,265,487,752
1000,504,481,517,243,516,759
1000,500,488,509,240,521,761
1000,500,502,520,244,516,760
1000,489,508,500,249,502,751
1000,488,489,527,248,504,752
1000,516,515,479,253,494,747
1000,498,494,489,239,501,740
1000,515,488,498,251,503,754
1000,502,533,477,252,473,725
1000,524,487,502,261,511,772
1000,505,493,492,239,511,750
1000,481,491,484,234,500,734
1000,535,493,485,266,489,755
1000,502,513,496,264,493,757
1000,502,499,495,244,493,737
1000,492,485,486,241,500,741
1000,494,509,513,239,517,756
1000,478,490,479,226,499,725
1000,489,503,502,236,521,757
1000,490,503,481,236,495,731
1000,513,483,497,246,508,754
1000,492,486,512,245,508,753
1000,504,521,488,251,493,744
1000,469,492,512,242,491,733
1000,486,497,523,244,526,770
1000,474,493,485,227,506,733
1000,474,481,516,227,512,739
1000,504,526,509,261,499,760
1000,496,531,493,259,485,744
1000,513,497,490,251,511,762
1000,481,507,512,245,497,742
1000,498,532,513,265,488,753
1000,489,519,493,256,483,739
1000,482,506,473,243,488,731
1000,510,493,490,256,499,755
1000,542,493,510,267,510,777
1000,495,515,508,244,511,755
1000,514,496,528,265,502,767
1000,504,489,481,257,480,737
1000,498,501,506,255,486,741
1000,513,505,501,261,486,747
1000,462,500,508,229,508,737
1000,485,516,511,247,513,760
1000,471,506,498,243,494,737
1000,513,507,482,264,481,745
1000,517,541,523,268,498,766
1000,512,467,521,226,533,759
1000,485,514,469,244,484,728
1000,485,512,500,244,482,726
1000,499,514,520,259,506,765
1000,511,499,540,274,507,781
1000,530,469,476,250,509,759
1000,517,506,514,259,514,773
1000,507,506,495,247,508,755
1000,487,502,512,240,518,758
1000,499,506,487,260,477,737
1000,492,504,465,260,475,735
1000,506,483,502,243,514,757
1000,502,502,492,251,508,759
1000,499,487,504,227,526,753
1000,509,489,523,257,515,772
1000,537,519,506,292,471,763
1000,465,505,496,244,491,735
1000,486,494,538,258,505,763
1000,514,500,492,260,492,752
1000,513,460,491,240,521,761
1000,504,515,479,268,472,740
1000,503,480,518,250,505,755
1000,499,509,519,258,491,749
1000,493,529,502,255,502,757
1000,500,497,513,254,489,743
1000,475,504,513,232,516,748
1000,480,503,507,252,486,738
1000,518,509,476,271,474,745
1000,516,490,483,251,493,744
1000,514,535,481,273,478,751
1000,489,523,506,247,495,742
1000,522,518,481,265,491,756
1000,477,492,499,233,513,746
1000,508,516,499,262,492,754
1000,487,498,503,251,504,755
1000,526,508,497,283,478,761
1000,505,525,488,265,477,742
1000,503,488,491,245,499,744
1000,507,493,503,261,490,751
1000,483,498,503,250,490,740
1000,510,518,500,258,483,741
1000,484,481,519,236,502,738
1000,499,520,511,258,503,761
1000,499,511,505,247,502,749
1000,520,493,545,244,539,783
1000,517,496,518,248,513,761
1000,528,507,527,266,526,792
1000,492,495,496,253,478,731
1000,502,533,488,276,469,745
1000,504,531,490,272,480,752
1000,516,514,526,265,484,749
1000,499,514,491,268,461,729
1000,475,480,504,246,510,756
1000,490,509,501,245,507,752
1000,521,512,492,261,502,763
1000,487,543,499,253,494,747
1000,498,503,502,257,514,771
1000,501,524,504,256,480,736
1000,512,474,460,260,473,733
1000,491,507,488,238,495,733
1000,502,516,496,265,491,756
1000,513,492,494,249,500,749
1000,495,480,503,237,517,754
1000,494,486,512,243,513,756
1000,491,481,464,246,491,737
1000,501,508,490,236,515,751
1000,501,508,499,265,499,764
1000,486,468,505,236,509,745
1000,520,510,482,257,487,744
1000,534,529,503,283,481,764
1000,486,497,492,253,483,736
1000,512,479,509,248,518,766
1000,485,519,514,260,487,747
1000,540,495,490,269,502,771
1000,499,513,494,250,510,760
1000,471,486,472,228,502,730
1000,507,497,500,244,509,753
1000,499,509,510,256,495,751
1000,493,525,497,266,476,742
1000,528,460,489,243,516,759
1000,448,504,495,227,503,730
1000,500,511,499,254,497,751
1000,523,475,517,242,533,775
1000,497,491,495,232,518,750
1000,473,506,504,241,501,742
1000,494,479,472,234,501,735
1000,497,490,487,237,504,741
1000,521,503,508,262,502,764
1000,523,517,491,272,490,762
1000,478,509,498,239,496,735
1000,518,500,504,265,489,754
1000,527,507,521,282,491,773
1000,513,488,510,238,526,764
1000,512,485,490,242,519,761
1000,529,496,525,262,513,775
1000,503,537,476,281,470,751
1000,471,511,499,244,494,738
1000,513,512,510,254,521,775
1000,475,524,472,253,470,723
1000,487,499,484,250,486,736
1000,519,516,495,253,498,751
1000,473,468,495,215,509,724
1000,486,499,483,254,484,738
1000,489,535,499,261,490,751
1000,484,500,492,245,486,731
1000,501,493,515,245,517,762
1000,525,519,502,273,478,751
1000,520,467,487,230,524,754
1000,529,514,502,286,471,757
1000,521,526,496,287,479,766
1000,524,481,491,252,510,762
1000,490,478,509,247,518,765
1000,489,470,504,232,519,751
1000,479,518,503,246,490,736
1000,523,497,504,256,531,787
1000,503,495,501,250,506,756
1000,508,520,503,265,515,780
1000,480,487,480,231,493,724
1000,512,469,496,234,507,741
1000,502,491,504,247,510,757
1000,521,500,489,247,511,758
1000,486,491,516,236,513,749
1000,498,480,484,239,500,739
1000,524,536,475,283,474,757
1000,532,511,497,274,484,758
1000,478,514,487,250,491,741
1000,502,512,487,258,483,741
1000,499,502,534,256,511,767
1000,495,471,465,249,483,732
1000,524,493,485,262,504,766
1000,477,519,487,250,481,731
1000,504,525,487,261,499,760
1000,524,497,514,255,509,764
1000,473,511,531,239,516,755
1000,490,479,507,219,524,743
1000,479,481,505,217,519,736
1000,524,530,509,273,481,754
1000,496,512,515,249,501,750
1000,494,489,500,246,502,748
1000,453,499,538,231,536,767
1000,509,513,509,271,497,768
1000,500,503,467,254,485,739
1000,511,531,494,285,452,737
1000,522,546,485,291,445,736
1000,517,480,499,251,505,756
1000,508,519,493,257,490,747
1000,493,481,497,239,512,751
1000,521,502,518,269,498,767
1000,502,504,464,243,489,732
1000,518,504,483,261,502,763
1000,515,492,511,255,513,768
1000,509,501,503,263,498,761
1000,474,487,471,217,520,737
1000,495,477,503,236,505,741
1000,518,493,503,271,484,755
1000,478,522,500,243,496,739
1000,516,517,476,260,493,753
1000,489,524,506,239,505,744
1000,492,477,544,253,515,768
1000,495,541,487,264,472,736
1000,520,482,481,249,505,754
1000,516,503,483,259,498,757
1000,497,475,501,233,516,749
1000,517,475,494,246,501,747
1000,490,502,472,245,494,739
1000,480,511,467,235,488,723
1000,504,488,489,262,491,753
1000,511,487,525,247,529,776
1000,497,499,501,267,490,757
1000,499,532,475,267,470,737
1000,495,495,516,255,493,748
1000,487,526,521,264,500,764
1000,506,521,502,249,500,749
1000,484,500,489,245,499,744
1000,519,498,514,262,508,770
1000,508,500,496,244,515,759
1000,486,468,505,250,482,732
1000,501,478,515,246,510,756
1000,494,523,501,260,493,753
1000,497,492,509,249,498,747
1000,505,501,509,258,503,761
1000,494,508,506,244,500,744
1000,514,517,506,259,517,776
1000,487,512,516,236,524,760
1000,497,502,495,236,527,763
1000,500,473,509,229,523,752
1000,501,508,488,249,499,748
1000,517,499,474,252,513,765
1000,525,505,502,270,494,764
1000,514,485,483,270,469,739
1000,514,499,520,256,501,757
1000,482,500,481,251,478,729
1000,474,528,497,258,483,741
1000,503,483,506,232,523,755
1000,498,520,496,254,498,752
1000,501,531,507,278,469,747
1000,496,527,498,274,479,753
1000,502,504,517,242,504,746
1000,474,497,508,239,506,745
1000,503,528,503,266,484,750
1000,493,489,509,240,506,746
1000,494,479,507,237,509,746
1000,513,500,490,255,499,754
1000,499,493,519,245,512,757
1000,482,483,483,219,519,738
1000,481,498,497,260,477,737
1000,503,485,512,246,529,775
1000,520,487,502,252,518,770
1000,553,498,527,283,496,779
1000,528,512,501,254,520,774
1000,507,497,529,253,509,762
1000,526,513,505,272,487,759
1000,494,494,474,252,473,725
1000,477,492,503,238,501,739
1000,505,478,507,260,477,737
1000,473,512,498,254,485,739
1000,516,500,487,255,499,754
1000,511,459,518,238,523,761
1000,482,508,514,236,505,741
1000,518,495,526,247,531,778
1000,493,508,479,247,488,735
1000,485,495,489,239,485,724
1000,511,513,503,270,492,762
1000,470,505,483,239,482,721
1000,494,519,500,246,501,747
1000,520,491,514,252,523,775
1000,494,506,527,247,516,763
1000,470,518,488,241,485,726
1000,501,486,464,257,472,729
1000,522,485,501,247,510,757
1000,509,510,482,268,479,747
1000,494,502,489,237,501,738
1000,498,489,520,247,508,755
1000,505,501,479,253,493,746
1000,513,504,518,267,500,767
1000,527,495,504,252,511,763
1000,505,510,481,250,489,739
1000,505,489,522,252,517,769
1000,495,492,503,262,479,741
1000,509,488,481,232,520,752
1000,485,517,470,251,477,728
1000,487,521,485,262,482,744
1000,531,511,484,267,492,759
1000,509,509,482,258,488,746
1000,514,517,490,274,478,752
1000,497,500,474,244,499,743
1000,495,484,499,234,524,758
1000,506,526,489,269,470,739
1000,487,506,509,253,495,748
1000,485,511,495,249,496,745
1000,493,519,487,260,500,760
1000,497,555,481,288,444,732
1000,503,485,490,236,513,749
1000,478,516,500,240,511,751
1000,515,479,530,244,523,767
1000,501,485,483,244,492,736
1000,509,513,468,252,490,742
1000,501,496,508,261,516,777
1000,508,484,509,252,507,759
1000,509,497,504,254,493,747
1000,507,529,507,251,498,749
1000,478,497,504,241,496,737
1000,512,507,481,263,479,742
1000,489,482,462,233,500,733
1000,503,537,478,262,456,718
1000,524,504,492,271,489,760
1000,528,496,512,258,517,775
1000,496,513,508,273,480,753
1000,519,483,497,261,489,750
1000,508,503,502,268,491,759
1000,477,520,530,257,496,753
1000,485,507,500,245,501,746
1000,492,484,498,245,515,760
1000,493,517,504,249,511,760
1000,443,504,494,229,497,726
1000,487,487,474,235,493,728
1000,499,518,494,265,482,747
1000,503,511,488,245,496,741
1000,499,505,488,253,496,749
1000,501,486,496,238,517,755
1000,528,505,499,259,497,756
1000,490,522,496,249,507,756
1000,491,458,520,226,516,742
1000,508,482,501,249,520,769
1000,522,504,552,258,527,785
1000,504,478,497,239,522,761
1000,492,504,506,254,495,749
1000,507,502,502,250,501,751
1000,469,509,500,222,494,716
1000,509,511,492,263,481,744
1000,498,510,496,246,520,766
1000,498,486,499,248,524,772
1000,492,502,490,257,497,754
1000,485,492,516,237,508,745
1000,503,485,492,236,509,745
1000,522,519,489,271,483,754
1000,530,477,489,253,509,762
1000,497,507,495,243,502,745
1000,477,522,479,263,463,726
1000,520,514,491,262,485,747
1000,495,499,500,228,518,746
1000,509,493,484,259,477,736
1000,482,495,513,249,504,753
1000,509,501,503,255,500,755
1000,462,514,501,230,506,736
1000,508,510,494,253,507,760
1000,504,481,506,248,511,759
1000,509,513,483,257,490,747
1000,510,513,501,250,509,759
1000,523,523,494,279,483,762
1000,479,477,495,234,501,735
1000,496,509,507,253,490,743
1000,489,502,503,243,499,742
1000,488,482,490,229,513,742
1000,500,515,510,259,490,749
1000,469,505,490,252,483,735
1000,506,491,522,246,524,770
1000,518,511,524,271,499,770
1000,509,510,509,257,510,767
1000,519,521,481,272,462,734
1000,521,475,472,249,497,746
1000,508,511,500,254,500,754
1000,506,516,523,260,495,755
1000,499,500,486,259,475,734
1000,495,516,477,260,487,747
1000,507,507,486,264,486,750
1000,491,464,504,216,517,733
1000,519,495,509,265,500,765
1000,512,533,492,273,466,739
1000,505,468,514,240,498,738
1000,468,501,504,242,498,740
1000,474,504,518,244,497,741
1000,518,500,504,252,518,770
1000,512,501,507,254,492,746
1000,511,480,512,244,511,755
1000,486,477,487,235,506,741
1000,524,496,505,266,502,768
1000,496,533,489,271,473,744
1000,506,475,497,242,511,753
1000,528,502,511,270,494,764
1000,491,477,495,233,513,746
1000,487,517,513,247,489,736
1000,519,493,492,267,487,754
1000,469,489,499,223,512,735
1000,499,488,495,259,491,750
1000,490,495,514,246,505,751
1000,489,507,519,248,500,748
1000,508,490,505,244,495,739
1000,489,455,514,210,535,745
1000,516,508,509,272,483,755
1000,506,484,535,231,548,779
1000,490,484,489,242,495,737
1000,484,479,509,218,520,738
1000,521,488,503,250,518,768
1000,515,496,501,257,506,763
1000,510,521,500,271,483,754
1000,488,477,521,229,514,743
1000,493,500,502,237,521,758
1000,491,504,513,246,510,756
1000,524,519,493,273,477,750
1000,504,482,481,233,509,742
1000,489,496,488,254,484,738
1000,486,484,499,238,498,736
1000,520,508,503,261,498,759
1000,524,516,508,265,513,778
1000,486,503,501,251,482,733
1000,507,536,494,270,478,748
1000,515,499,485,237,511,748
1000,493,504,495,250,488,738
1000,491,493,502,259,480,739
1000,524,528,522,266,515,781
1000,492,514,496,255,492,747
1000,497,499,518,247,506,753
1000,517,492,500,241,518,759
1000,508,499,501,263,494,757
1000,475,486,482,235,498,733
1000,488,488,497,229,520,749
1000,481,506,487,241,495,736
1000,488,491,497,229,514,743
1000,486,513,497,246,490,736
1000,504,503,511,267,496,763
1000,501,497,531,245,523,768
1000,491,520,524,259,494,753
1000,473,519,509,257,486,743
1000,520,482,489,253,491,744
1000,505,478,505,230,526,756
1000,479,467,490,231,501,732
1000,527,501,504,253,504,757
1000,498,482,519,259,493,752
1000,519,495,497,258,506,764
1000,488,515,494,265,472,737
1000,508,502,490,254,505,759
1000,508,466,475,233,512,745
1000,488,492,511,217,523,740
1000,500,490,509,238,514,752
1000,511,528,499,266,489,755
1000,505,520,484,258,487,745
1000,486,482,516,233,530,763
1000,469,497,489,232,486,718
1000,487,504,482,239,492,731
1000,499,490,509,235,521,756
1000,522,510,473,273,492,765
1000,483,496,494,241,510,751
1000,521,524,498,271,482,753
1000,509,492,503,245,513,758
1000,467,478,494,229,498,727
1000,510,515,496,266,486,752
1000,504,508,494,259,495,754
1000,484,495,515,246,511,757
1000,487,490,468,240,496,736
1000,490,499,494,238,502,740
1000,513,498,512,243,515,758
1000,509,518,526,260,514,774
1000,489,517,505,253,496,749
1000,499,506,517,246,531,777
1000,492,502,496,256,489,745
1000,501,517,486,267,485,752
1000,505,498,492,257,500,757
1000,499,515,499,261,483,744
1000,482,503,507,236,501,737
1000,510,500,488,247,508,755
1000,523,497,511,269,497,766
1000,512,502,467,258,505,763
1000,534,492,518,247,535,782
1000,514,496,498,263,505,768
1000,521,509,521,263,507,770
1000,488,510,500,258,495,753
1000,488,506,485,247,493,740
1000,507,487,505,236,526,762
1000,517,509,515,258,516,774
1000,508,485,488,253,500,753
1000,487,494,497,241,496,737
1000,485,500,516,248,501,749
1000,495,475,502,235,516,751
1000,518,525,480,265,487,752
1000,495,497,518,250,509,759
1000,514,518,502,255,507,762
1000,489,513,541,241,519,760
1000,480,480,481,231,491,722
1000,494,527,484,252,497,749
1000,491,536,520,257,500,757
1000,505,504,488,233,523,756
1000,475,489,503,238,496,734
1000,498,495,464,249,495,744
1000,514,500,511,268,493,761
1000,508,514,484,262,481,743
1000,477,512,529,243,512,755
1000,525,507,483,259,494,753
1000,500,513,484,254,474,728
1000,516,471,502,235,521,756
1000,515,488,501,255,499,754
1000,457,499,515,225,511,736
1000,494,534,516,259,502,761
1000,477,528,513,237,510,747
1000,526,496,510,267,496,763
1000,477,522,525,243,521,764
1000,489,470,525,221,547,768
1000,485,488,517,242,506,748
1000,499,498,507,241,499,740
1000,473,498,503,225,512,737
1000,498,483,520,232,525,757
1000,489,514,510,252,490,742
1000,500,513,497,258,498,756
1000,521,492,491,267,496,763
1000,513,496,488,253,479,732
1000,500,480,505,241,500,741
1000,527,498,481,264,483,747
1000,494,497,520,249,510,759
1000,498,489,510,229,512,741
1000,513,486,510,246,502,748
1000,501,521,470,273,455,728
1000,508,502,500,244,521,765
1000,491,503,500,254,491,745
1000,504,515,507,263,496,759
1000,506,508,479,265,477,742
1000,475,500,511,241,510,751
1000,524,505,480,270,479,749
1000,510,487,478,240,511,751
1000,478,486,530,238,516,754
1000,507,507,501,271,471,742
1000,491,485,498,246,505,751
1000,508,493,499,257,488,745
1000,477,491,507,241,505,746
1000,520,456,493,237,513,750
1000,484,494,481,238,488,726
1000,515,504,503,254,503,757
1000,491,485,490,239,504,743
1000,494,506,504,235,508,743
1000,505,492,469,243,488,731
1000,472,508,509,255,495,750
1000,496,510,473,249,476,725
1000,485,503,501,242,501,743
1000,503,504,481,239,501,740
1000,514,479,493,253,490,743
1000,505,488,506,254,499,753
1000,511,461,481,224,523,747
1000,496,487,496,248,508,756
1000,505,497,524,252,514,766
1000,503,500,512,244,521,765
1000,502,506,479,265,482,747
1000,467,496,493,229,513,742
1000,521,493,509,259,508,767
1000,485,484,501,245,490,735
1000,505,497,504,249,504,753
1000,486,482,478,244,493,737
1000,509,509,473,262,481,743
1000,478,477,543,226,527,753
1000,510,486,494,245,502,747
1000,500,504,494,259,481,740
1000,479,506,514,250,501,751
1000,502,514,503,264,498,762
1000,512,493,536,246,536,782
1000,522,495,507,250,511,761
1000,498,491,520,233,530,763
1000,490,477,520,234,518,752
1000,503,505,472,257,475,732
1000,504,494,476,235,500,735
1000,511,516,499,264,484,748
1000,529,485,508,247,520,767
1000,509,521,494,251,494,745
1000,502,504,519,248,519,767
1000,502,511,502,250,499,749
1000,509,488,510,239,523,762
1000,518,492,512,248,522,770
1000,523,504,483,262,494,756
1000,503,511,462,267,467,734
1000,493,477,506,230,517,747
1000,496,489,502,235,506,741
1000,500,492,530,251,509,760
1000,470,507,489,245,488,733
1000,503,478,491,245,495,740
1000,488,507,522,251,507,758
1000,509,492,488,260,486,746
1000,467,516,494,241,500,741
1000,506,519,517,276,484,760
1000,506,499,515,259,504,763
1000,531,514,484,273,495,768
1000,500,469,507,237,512,749
1000,514,482,492,254,499,753
1000,483,497,498,243,480,723
1000,491,477,512,217,542,759
1000,502,482,505,235,514,749
1000,489,498,487,238,494,732
1000,511,499,512,249,497,746
1000,511,508,498,274,481,755
1000,512,481,511,247,524,771
1000,482,487,508,242,510,752
1000,495,508,496,254,510,764
1000,475,517,526,249,493,742
1000,496,478,477,239,514,753
1000,504,528,505,255,520,775
1000,528,535,525,281,492,773
1000,510,509,520,252,518,770
1000,505,511,516,251,497,748
1000,521,487,482,249,500,749
1000,519,507,520,244,523,767
1000,473,504,476,239,488,727
1000,507,525,493,281,467,748
1000,500,509,465,256,474,730
1000,510,497,491,259,497,756
1000,496,482,521,230,538,768
1000,504,499,507,251,505,756
1000,510,505,494,259,510,769
1000,505,487,493,232,518,750
1000,480,520,514,246,511,757
1000,510,494,489,257,486,743
1000,480,465,532,218,531,749
1000,516,518,505,255,510,765
1000,486,490,493,237,510,747
1000,499,505,508,252,504,756
1000,496,521,497,268,480,748
1000,500,526,514,253,507,760
1000,467,461,504,216,517,733
1000,509,496,513,253,518,771
1000,521,507,489,276,472,748
1000,506,490,488,241,510,751
1000,496,491,500,251,501,752
1000,487,509,477,249,482,731
1000,501,484,499,237,505,742
1000,478,473,529,223,529,752
1000,489,513,487,249,486,735
1000,514,524,506,258,513,771
1000,493,501,481,237,485,722
1000,496,496,550,231,527,758
1000,501,502,479,245,489,734
1000,485,482,516,243,515,758
1000,518,502,480,263,495,758
1000,504,518,495,252,501,753
1000,508,527,516,258,507,765
1000,491,508,497,258,483,741
1000,490,504,517,256,498,754
1000,496,495,508,244,502,746
1000,509,505,496,261,502,763
1000,529,517,503,282,473,755
1000,519,508,512,280,478,758
1000,483,506,485,240,499,739
1000,505,492,493,248,506,754
1000,500,502,471,255,488,743
1000,507,508,494,272,463,735
1000,482,468,513,220,530,750
1000,488,488,487,221,527,748
1000,488,466,486,223,502,725
1000,513,525,505,280,482,762
1000,501,475,519,239,527,766
1000,492,510,506,252,510,762
1000,515,492,507,264,494,758
1000,497,510,501,245,499,744
1000,497,512,486,251,502,753
1000,500,484,526,234,526,760
1000,510,471,515,246,519,765
1000,518,496,523,249,527,776
1000,490,498,531,229,535,764
1000,528,495,499,281,476,757
1000,500,482,497,236,507,743
1000,513,488,489,248,508,756
1000,511,515,496,268,496,764
1000,501,491,500,253,506,759
1000,517,492,470,266,476,742
1000,521,504,483,267,488,755
1000,519,521,490,271,481,752
1000,491,487,505,229,513,742
1000,498,509,490,257,499,756
1000,513,486,515,243,509,752
1000,508,527,494,262,476,738
1000,485,524,489,249,484,733
1000,489,498,509,242,510,752
1000,501,502,488,253,495,748
1000,467,528,486,237,484,721
1000,531,501,460,268,475,743
1000,488,497,472,245,495,740
1000,480,505,502,238,496,734
1000,493,485,499,240,512,752
1000,479,476,502,222,522,744
1000,521,484,505,245,514,759
1000,515,537,475,270,480,750
1000,510,502,502,250,501,751
1000,515,510,486,289,482,771
1000,478,506,487,239,502,741
1000,501,487,491,252,497,749
1000,496,487,504,242,502,744
1000,500,489,500,245,522,767
1000,472,500,492,225,514,739
1000,517,503,511,260,493,753
1000,508,505,499,249,501,750
1000,497,508,503,252,500,752
1000,534,518,511,263,507,770
1000,493,509,479,252,474,726
1000,470,483,510,220,534,754
1000,481,486,514,244,501,745
1000,498,505,522,255,491,746
1000,531,504,524,265,514,779
1000,498,500,469,231,509,740
1000,510,487,485,237,512,749
1000,507,474,513,246,513,759
1000,491,508,500,261,496,757
1000,476,508,487,244,478,722
1000,527,495,500,264,490,754
1000,495,515,487,249,492,741
1000,499,484,502,235,522,757
1000,499,481,474,246,493,739
1000,507,512,517,262,508,770
1000,513,497,478,268,481,749
1000,478,493,521,243,512,755
1000,503,495,486,244,497,741
1000,529,497,515,267,503,770
1000,490,514,481,260,489,749
1000,491,495,486,249,495,744
1000,535,501,511,266,513,779
1000,466,509,488,249,485,734
1000,483,495,495,246,497,743
1000,521,499,478,264,490,754
1000,516,497,504,251,495,746
1000,497,494,490,249,484,733
1000,523,487,494,255,512,767
1000,543,489,491,277,491,768
1000,477,494,482,240,476,716
1000,500,503,499,250,502,752
1000,508,521,506,261,493,754
1000,530,499,525,266,519,785
1000,498,483,474,246,475,721
1000,505,493,496,233,518,751
1000,489,472,521,216,550,766
1000,522,503,515,279,482,761
1000,510,505,510,253,523,776
1000,532,494,486,266,502,768
1000,507,501,491,247,495,742
1000,517,503,505,276,483,759
1000,478,518,499,269,477,746
1000,510,493,492,253,503,756
1000,508,464,519,236,522,758
1000,504,472,494,225,519,744
1000,522,492,525,260,522,782
1000,504,505,497,263,496,759
1000,507,480,468,244,488,732
1000,485,523,524,259,487,746
1000,502,485,497,255,485,740
1000,496,534,527,259,511,770
1000,527,499,490,259,491,750
1000,494,492,508,234,515,749
1000,523,493,501,277,471,748
1000,505,504,516,262,504,766
1000,499,461,481,225,522,747
1000,517,522,473,278,477,755
1000,499,527,493,269,470,739
1000,506,494,522,241,527,768
1000,497,493,491,243,510,753
1000,472,489,484,229,497,726
1000,487,503,517,231,509,740
1000,511,511,524,262,510,772
1000,516,513,499,262,493,755
1000,488,497,503,254,486,740
1000,509,517,510,268,488,756
1000,534,486,474,260,496,756
1000,476,522,513,245,499,744
1000,518,491,478,256,498,754
1000,524,494,489,267,495,762
1000,496,510,514,258,501,759
1000,529,506,488,287,471,758
1000,491,535,504,259,499,758
1000,513,508,500,250,502,752
1000,529,502,474,268,494,762
1000,519,493,537,259,511,770
1000,516,482,494,245,514,759
1000,479,506,541,246,509,755
1000,496,478,492,236,518,754
1000,500,506,499,247,497,744
1000,517,473,506,235,522,757
1000,523,481,507,257,501,758
1000,490,515,517,261,486,747
1000,523,492,518,267,503,770
1000,533,487,491,269,499,768
1000,487,492,491,252,495,747
1000,515,501,526,265,525,790
1000,523,505,481,265,482,747
1000,486,484,492,230,516,746
1000,504,510,499,244,511,755
1000,486,526,512,254,499,753
1000,496,473,506,240,504,744
1000,517,503,474,246,504,750
1000,478,485,495,239,504,743
1000,509,501,498,267,503,770
1000,482,516,512,245,510,755
1000,494,507,516,257,508,765
1000,490,449,518,226,525,751
1000,479,518,498,249,492,741
1000,500,471,502,229,520,749
1000,490,466,486,240,497,737
1000,517,471,516,242,518,760
1000,518,483,517,254,512,766
1000,502,515,524,255,490,745
1000,475,515,499,249,490,739
1000,511,516,522,263,504,767
1000,477,485,512,232,509,741
1000,484,494,502,228,514,742
1000,481,488,496,236,494,730
1000,517,510,483,253,502,755
1000,505,496,468,250,491,741
1000,523,504,507,261,514,775
1000,537,477,490,265,491,756
1000,492,491,499,246,496,742
1000,478,480,505,231,512,743
1000,505,493,494,237,520,757
1000,490,498,470,234,495,729
1000,509,504,520,276,472,748
1000,484,504,487,237,490,727
1000,534,519,513,274,504,778
1000,495,472,489,236,509,745
1000,511,491,459,252,486,738
1000,467,508,501,242,489,731
1000,488,496,507,242,496,738
1000,476,491,475,232,500,732
1000,492,506,481,244,505,749
1000,474,499,496,243,491,734
1000,506,493,478,243,494,737
1000,520,509,484,261,485,746
1000,492,468,490,245,500,745
1000,498,462,513,230,525,755
1000,501,494,508,246,510,756
1000,489,498,512,250,516,766
1000,530,481,454,259,484,743
1000,511,482,491,242,499,741
1000,490,503,492,237,514,751
1000,490,517,490,251,476,727
1000,508,507,525,246,536,782
1000,490,508,484,254,476,730
1000,486,487,503,231,519,750
1000,475,548,512,272,477,749
1000,484,472,465,225,504,729
1000,480,488,485,244,484,728
1000,486,493,502,234,511,745
1000,478,513,507,239,491,730
1000,521,473,472,253,507,760
1000,520,463,487,247,518,765
1000,502,511,483,250,505,755
1000,513,500,499,261,486,747
1000,511,483,496,251,504,755
1000,486,526,496,251,484,735
1000,513,533,491,264,482,746
1000,503,498,479,253,478,731
1000,487,497,513,235,519,754
1000,517,505,494,256,505,761
1000,500,524,476,268,471,739
1000,501,544,498,277,477,754
1000,499,499,516,236,529,765
1000,486,523,517,264,486,750
1000,488,472,530,234,530,764
1000,485,497,465,244,485,729
1000,483,515,520,238,528,766
1000,487,492,514,226,533,759
1000,499,493,509,241,505,746
1000,521,479,521,259,514,773
1000,510,504,493,267,493,760
1000,504,478,512,252,506,758
1000,501,515,496,266,488,754
1000,517,475,506,242,528,770
1000,499,495,530,247,513,760
1000,460,511,508,213,531,744
1000,502,522,512,252,503,755
1000,517,529,490,270,481,751
1000,501,503,520,241,518,759
1000,493,500,504,246,497,743
1000,474,492,505,227,511,738
1000,506,487,498,245,515,760
1000,513,483,485,252,488,740
1000,497,500,509,251,512,763
1000,541,494,502,270,493,763
1000,513,491,490,221,535,756
1000,506,525,480,273,466,739
1000,515,503,486,271,486,757
1000,529,503,469,263,479,742
1000,481,497,478,246,472,718
1000,488,477,525,245,518,763
1000,533,494,507,282,484,766
1000,510,502,487,253,484,737
1000,498,482,496,235,513,748
1000,499,488,503,245,503,748
1000,504,480,524,235,528,763
1000,475,488,508,236,497,733
1000,546,521,505,296,489,785
1000,504,499,557,254,525,779
1000,493,502,513,253,506,759
1000,511,469,492,238,521,759
1000,506,494,505,256,503,759
1000,524,479,501,268,500,768
1000,487,515,503,254,489,743
1000,505,506,448,251,483,734
1000,507,498,501,252,513,765
1000,495,493,491,243,501,744
1000,509,497,515,248,520,768
1000,485,510,495,247,479,726
1000,509,513,508,269,491,760
1000,480,491,490,231,501,732
1000,513,499,497,254,496,750
1000,487,524,489,255,474,729
1000,498,494,511,247,534,781
1000,502,488,502,249,510,759
1000,503,510,501,252,504,756
1000,487,502,490,231,509,740
1000,478,513,490,238,504,742
1000,527,493,472,270,481,751
1000,481,524,515,239,513,752
1000,495,499,482,249,480,729
1000,519,507,480,260,486,746
1000,473,522,498,255,472,727
1000,524,506,504,262,505,767
1000,499,504,529,252,518,770
1000,485,490,508,228,523,751
1000,508,504,512,255,517,772
1000,533,477,517,266,508,774
1000,488,477,500,231,519,750
1000,509,480,494,253,498,751
1000,510,513,498,260,502,762
1000,486,511,502,270,459,729
1000,477,489,518,227,530,757
1000,493,499,511,247,508,755
1000,516,513,500,255,497,752
1000,516,486,507,252,507,759
1000,486,507,504,254,500,754
1000,489,506,514,246,503,749
1000,521,502,499,249,511,760
1000,504,501,499,256,505,761
1000,483,513,491,246,487,733
1000,469,506,528,238,500,738
1000,482,479,521,231,532,763
1000,501,497,523,264,510,774
1000,494,517,491,258,483,741
1000,507,491,509,243,516,759
1000,497,501,542,246,517,763
1000,510,504,526,271,490,761
1000,463,487,483,211,514,725
1000,497,465,509,227,516,743
1000,493,492,502,239,517,756
1000,506,500,509,248,504,752
1000,503,470,492,231,515,746
1000,485,537,540,253,508,761
1000,532,472,508,251,522,773
1000,515,475,488,242,497,739
1000,488,520,485,244,496,740
1000,519,516,492,260,505,765
1000,496,509,507,249,506,755
1000,479,465,505,219,524,743
1000,504,504,491,260,493,753
1000,495,498,494,248,493,741
1000,504,505,494,249,513,762
1000,521,529,511,277,494,771
1000,479,501,533,241,517,758
1000,488,538,506,244,507,751
1000,510,496,508,257,518,775
1000,501,492,518,238,537,775
1000,508,500,501,244,515,759
1000,518,494,482,249,516,765
1000,493,510,522,252,500,752
1000,516,502,507,263,504,767
1000,524,499,499,261,494,755
1000,499,504,530,261,505,766
1000,514,498,488,255,497,752
1000,505,526,495,279,470,749
1000,495,483,483,246,492,738
1000,456,503,482,220,494,714
1000,480,499,494,242,489,731
1000,511,511,478,254,486,740
1000,509,482,467,238,503,741
1000,486,473,469,230,496,726
1000,501,510,527,246,510,756
1000,498,475,505,243,503,746
1000,495,494,503,237,527,764
1000,523,488,496,243,506,749
1000,496,518,510,244,513,757
1000,491,501,474,237,498,735
1000,455,500,493,228,494,722
1000,507,518,544,262,511,773
1000,485,535,513,251,498,749
1000,489,504,491,244,525,769
1000,522,513,517,265,520,785
1000,522,505,498,262,490,752
1000,503,485,521,235,522,757
1000,543,488,501,271,490,761
1000,519,509,478,253,488,741
1000,488,494,497,249,481,730
1000,502,504,478,256,503,759
1000,481,506,495,242,504,746
1000,476,489,488,235,509,744
1000,516,527,489,281,464,745
1000,504,497,486,247,484,731
1000,504,551,490,281,464,745
1000,507,496,510,249,505,754
1000,504,479,499,250,510,760
1000,507,528,488,258,483,741
1000,505,506,491,260,473,733
1000,503,493,501,240,504,744
1000,505,484,493,245,514,759
1000,495,538,508,260,506,766
1000,494,507,499,256,491,747
1000,515,509,514,267,499,766
1000,481,505,505,241,494,735
1000,532,480,523,261,517,778
1000,475,507,492,235,505,740
1000,493,497,493,241,503,744
1000,470,494,509,231,504,735
1000,480,493,479,257,475,732
1000,497,515,476,244,488,732
1000,502,488,531,237,538,775
1000,518,498,526,250,524,774
1000,505,515,497,254,502,756
1000,502,477,521,236,533,769
1000,492,499,516,255,513,768
1000,501,479,463,240,488,728
1000,515,524,474,269,476,745
1000,470,483,493,214,514,728
1000,501,491,506,246,514,760
1000,512,496,512,259,486,745
1000,511,484,518,262,488,750
1000,494,518,484,255,481,736
1000,491,496,492,246,492,738
1000,530,504,507,266,506,772
1000,521,498,482,251,500,751
1000,477,478,495,237,499,736
1000,478,501,497,242,491,733
1000,504,510,482,263,488,751
1000,507,484,502,242,517,759
1000,479,513,514,241,506,747
1000,488,505,490,255,498,753
1000,507,493,495,244,516,760
1000,517,475,495,245,510,755
1000,524,506,483,259,500,759
1000,480,487,518,224,509,733
1000,464,473,513,207,519,726
1000,480,488,512,239,516,755
1000,493,474,494,219,520,739
1000,504,510,504,258,502,760
1000,497,514,504,242,491,733
1000,488,488,492,246,484,730
1000,493,486,510,249,496,745
1000,494,510,507,245,521,766
1000,503,490,513,246,514,760
1000,484,513,500,261,485,746
1000,516,487,499,238,532,770
1000,507,493,480,256,486,742
1000,518,482,518,261,508,769
1000,496,517,486,260,477,737
1000,502,506,486,249,492,741
1000,500,485,495,231,528,759
1000,458,474,500,222,506,728
1000,495,511,514,257,494,751
1000,507,498,485,245,498,743
1000,498,512,492,259,486,745
1000,491,499,495,246,494,740
1000,549,492,495,269,510,779
1000,495,484,522,234,533,767
1000,509,494,475,245,496,741
1000,460,477,487,225,498,723
1000,502,493,503,257,507,764
1000,508,527,512,267,499,766
1000,518,470,499,256,507,763
1000,504,515,472,259,478,737
1000,528,459,514,233,547,780
1000,491,481,458,230,487,717
1000,509,519,489,257,486,743
1000,485,502,490,238,489,727
1000,500,518,492,245,511,756
1000,500,494,480,244,496,740
1000,479,493,498,241,506,747
1000,462,467,468,217,504,721
1000,483,504,483,246,482,728
1000,486,501,488,237,507,744
1000,499,515,497,268,488,756
1000,477,519,518,239,510,749
1000,525,512,489,265,493,758
1000,507,487,507,239,521,760
1000,497,506,485,253,485,738
1000,504,480,487,247,493,740
1000,510,527,519,261,501,762
1000,488,505,494,246,487,733
1000,497,514,480,268,481,749
1000,493,499,529,244,522,766
1000,508,489,465,261,480,741
1000,516,477,517,240,521,761
1000,514,512,511,265,494,759
1000,509,472,512,242,517,759
1000,470,487,501,233,499,732
1000,516,523,512,259,488,747
1000,482,501,493,237,493,730
1000,506,504,500,253,506,759
1000,479,511,542,237,527,764
1000,503,488,491,248,502,750
1000,501,512,493,267,470,737
1000,500,462,503,239,516,755
1000,463,499,487,241,481,722
1000,502,497,492,251,491,742
1000,484,513,471,238,497,735
1000,497,507,483,256,482,738
1000,466,522,494,231,487,718
1000,520,497,524,259,500,759
1000,506,513,487,264,479,743
1000,490,497,492,241,511,752
1000,522,510,493,258,505,763
1000,505,503,509,239,512,751
1000,501,523,515,254,508,762
1000,509,508,504,260,494,754
1000,514,477,493,253,522,775
1000,527,511,501,264,500,764
1000,460,519,509,230,510,740
1000,475,502,487,265,467,732
1000,480,492,482,233,492,725
1000,484,497,498,229,518,747
1000,501,495,509,260,502,762
1000,495,505,531,257,504,761
1000,526,498,515,255,509,764
1000,506,503,486,264,488,752
1000,508,509,514,262,502,764
1000,494,502,505,250,494,744
1000,500,496,494,243,502,745
1000,500,486,527,238,531,769
1000,476,488,511,232,504,736
1000,478,503,489,241,502,743
1000,492,510,528,242,509,751
1000,502,500,507,246,515,761
1000,499,492,509,251,505,756
1000,497,514,501,266,486,752
1000,503,507,513,239,530,769
1000,484,498,495,230,509,739
1000,535,504,487,272,494,766
1000,530,501,504,276,482,758
1000,497,487,484,236,512,748
1000,482,526,505,242,484,726
1000,514,523,491,272,479,751
1000,499,483,519,239,551,790
1000,505,490,507,241,511,752
1000,491,505,501,238,506,744
1000,509,484,508,253,516,769
1000,522,480,504,242,509,751
1000,501,521,499,261,493,754
1000,485,490,522,236,533,769
1000,510,499,483,253,492,745
1000,468,514,474,251,469,720
1000,502,526,514,273,486,759
1000,466,495,509,226,510,736
1000,526,502,503,282,481,763
1000,480,523,497,244,499,743
1000,504,493,493,253,499,752
1000,482,526,489,256,491,747
1000,493,517,528,254,510,764
1000,504,515,504,258,496,754
1000,499,514,492,269,474,743
1000,504,492,514,255,493,748
1000,471,493,492,226,492,718
1000,493,486,489,238,505,743
1000,521,485,509,246,528,774
1000,481,531,487,258,463,721
1000,482,510,534,252,503,755
1000,518,521,512,261,498,759
1000,500,504,512,259,513,772
1000,488,494,489,240,511,751
1000,488,494,498,237,508,745
1000,516,497,497,264,492,756
1000,514,516,514,265,488,753
1000,495,508,486,256,486,742
1000,515,528,526,279,492,771
1000,513,509,490,249,517,766
1000,490,486,510,219,551,770
1000,541,505,497,268,493,761
1000,508,512,502,246,517,763
1000,492,495,488,269,466,735
1000,518,512,472,267,482,749
1000,517,509,508,261,512,773
1000,502,502,501,229,529,758
1000,495,526,509,263,502,765
1000,482,513,475,239,481,720
1000,495,510,501,243,506,749
1000,515,461,453,232,511,743
1000,497,511,494,251,492,743
1000,528,493,501,270,478,748
1000,495,514,488,237,495,732
1000,498,534,518,260,516,776
1000,480,566,516,265,495,760
1000,471,513,493,227,524,751
1000,506,512,500,261,501,762
1000,513,485,504,246,506,752
1000,507,504,518,269,482,751
1000,499,516,527,266,493,759
1000,517,476,496,228,526,754
1000,481,504,511,239,500,739
1000,486,518,512,249,507,756
1000,516,506,487,259,497,756
1000,498,496,510,242,522,764
1000,498,490,496,249,496,745
1000,504,496,496,250,506,756
1000,488,523,470,264,472,736
1000,483,480,515,236,520,756
1000,495,500,508,252,496,748
1000,460,512,461,231,472,703
1000,481,530,477,255,469,724
1000,471,495,502,231,509,740
1000,487,468,480,239,500,739
1000,496,489,507,238,508,746
1000,489,492,503,240,510,750
1000,513,508,500,257,501,758
1000,478,520,489,237,501,738
1000,475,501,479,237,484,721
1000,502,523,507,273,491,764
1000,498,518,508,259,497,756
1000,486,481,494,235,518,753
1000,494,514,498,255,498,753
1000,501,489,481,243,499,742
1000,490,490,504,245,493,738
1000,535,499,510,268,504,772
1000,488,472,491,226,513,739
1000,513,486,472,244,516,760
1000,518,497,490,247,501,748
1000,522,517,484,265,493,758
1000,521,497,494,270,485,755
1000,496,486,489,254,481,735
1000,492,501,470,245,499,744
1000,513,478,489,245,523,768
1000,474,489,489,232,492,724
1000,518,467,501,245,513,758
1000,477,511,461,235,479,714
1000,485,526,495,265,481,746
1000,530,479,506,257,518,775
1000,510,492,489,241,511,752
1000,512,525,469,270,483,753
1000,494,524,447,267,459,726
1000,490,493,460,241,490,731
1000,511,520,495,268,489,757
1000,505,492,502,247,492,739
1000,546,520,512,275,499,774
1000,511,521,501,267,482,749
1000,503,492,482,252,495,747
1000,513,515,507,282,479,761
1000,517,503,481,263,473,736
1000,513,501,500,268,496,764
1000,514,473,519,248,527,775
1000,490,499,501,240,499,739
1000,535,503,476,280,470,750
1000,495,475,487,243,491,734
1000,489,491,454,237,486,723
1000,500,504,511,259,495,754
1000,485,506,533,259,485,744
1000,476,508,479,241,481,722
1000,515,515,503,268,493,761
1000,503,479,487,241,511,752
1000,522,496,494,257,509,766
1000,506,497,514,246,504,750
1000,488,490,482,235,498,733
1000,504,512,502,255,498,753
1000,504,520,507,275,480,755
1000,510,493,489,238,510,748
1000,494,512,513,253,506,759
1000,486,531,489,265,470,735
1000,541,500,498,276,505,781
1000,514,495,483,250,507,757
1000,505,471,480,234,501,735
1000,501,503,506,259,490,749
1000,498,479,503,229,512,741
1000,510,486,466,246,495,741
1000,510,500,494,260,500,760
1000,519,511,508,263,492,755
1000,489,512,501,257,481,738
1000,509,508,522,253,512,765
1000,504,492,505,256,490,746
1000,532,526,527,284,498,782
1000,501,494,500,243,486,729
1000,510,489,484,252,497,749
1000,488,499,515,250,496,746
1000,512,494,509,265,491,756
1000,473,523,511,238,521,759
1000,472,487,481,223,493,716
1000,517,463,506,251,506,757
1000,502,503,474,252,494,746
1000,500,487,500,257,499,756
1000,499,492,510,248,524,772
1000,481,498,492,247,483,730
1000,494,526,486,258,477,735
1000,518,499,507,266,488,754
1000,482,506,498,242,508,750
1000,495,465,518,230,527,757
1000,505,476,488,238,496,734
1000,478,484,502,232,511,743
1000,495,508,469,253,484,737
1000,498,504,487,251,509,760
1000,488,490,488,245,495,740
1000,518,505,469,260,496,756
1000,487,480,514,220,538,758
1000,517,496,465,250,481,731
1000,498,535,506,257,485,742
1000,472,512,484,246,490,736
1000,511,480,509,239,529,768
1000,503,530,494,264,494,758
1000,517,510,519,268,495,763
1000,521,514,501,283,472,755
1000,524,513,494,267,500,767
1000,482,486,534,230,527,757
1000,487,488,494,245,490,735
1000,510,507,525,267,505,772
1000,503,506,523,257,506,763
1000,489,483,502,227,510,737
1000,494,504,537,248,517,765
1000,497,463,473,228,520,748
1000,477,499,490,257,473,730
1000,475,520,502,242,509,751
1000,503,521,474,269,459,728
1000,504,490,502,232,510,742
1000,486,477,508,204,537,741
1000,494,498,506,247,498,745
1000,509,514,493,261,495,756
1000,523,510,479,257,481,738
1000,504,477,505,239,516,755
1000,510,501,504,256,502,758
1000,487,506,490,241,504,745
1000,499,493,477,248,489,737
1000,528,525,521,269,507,776
1000,485,483,516,229,513,742
1000,495,518,548,281,489,770
1000,504,500,479,247,500,747
1000,478,498,522,245,506,751
1000,513,503,520,260,498,758
1000,500,506,487,247,499,746
1000,523,486,470,260,478,738
1000,517,493,489,250,493,743
1000,520,469,461,234,509,743
1000,498,502,479,247,487,734
1000,487,478,497,236,504,740
1000,509,496,486,250,505,755
1000,503,496,480,266,474,740
1000,508,517,474,256,494,750
1000,490,487,473,239,488,727
1000,487,490,496,251,492,743
1000,490,517,466,243,496,739
1000,510,515,485,271,475,746
1000,477,496,523,244,507,751
1000,477,462,487,223,510,733
1000,492,493,512,245,518,763
1000,512,512,492,261,483,744
1000,512,493,494,258,500,758
1000,511,497,498,257,490,747
1000,477,500,505,234,520,754
1000,493,471,521,233,523,756
1000,541,462,490,263,509,772
1000,478,515,510,267,477,744
1000,519,533,466,275,463,738
1000,518,516,488,264,485,749
1000,522,501,468,261,497,758
1000,506,501,499,252,492,744
1000,516,531,491,275,488,763
1000,504,502,488,264,479,743
1000,523,522,485,273,474,747
1000,494,486,512,248,499,747
1000,506,495,488,247,503,750
1000,491,486,483,248,480,728
1000,512,490,521,240,533,773
1000,507,501,523,260,509,769
1000,495,498,497,247,495,742
1000,501,491,490,251,491,742
1000,506,494,499,253,494,747
1000,509,444,516,241,537,778
1000,514,491,510,267,495,762
1000,515,526,482,266,477,743
1000,484,463,498,216,528,744
1000,476,485,516,241,499,740
1000,491,514,524,260,501,761
1000,490,477,496,239,497,736
1000,492,494,490,240,499,739
1000,478,460,491,231,513,744
1000,499,507,530,244,514,758
1000,527,488,517,246,529,775
1000,506,493,507,249,510,759
1000,486,490,489,236,486,722
1000,493,509,498,265,479,744
1000,497,470,493,219,530,749
1000,508,499,488,255,508,763
1000,500,513,504,259,490,749
1000,515,483,506,241,527,768
1000,472,506,490,234,486,720
1000,521,513,485,255,500,755
1000,513,519,497,257,497,754
1000,498,486,495,246,502,748
1000,485,502,491,238,491,729
1000,510,516,486,267,475,742
1000,514,503,507,257,510,767
1000,491,468,492,244,494,738
1000,516,512,513,271,490,761
1000,477,506,532,236,522,758
1000,495,505,522,245,516,761
1000,499,521,502,252,476,728
1000,516,493,482,249,490,739
1000,509,510,480,264,464,728
1000,493,504,502,245,507,752
1000,499,496,497,236,504,740
1000,502,507,516,252,499,751
1000,515,549,510,290,464,754
1000,491,510,492,244,494,738
1000,499,488,500,245,504,749
1000,495,488,493,237,503,740
1000,508,502,496,264,483,747
1000,473,504,493,243,495,738
1000,473,502,490,233,504,737
1000,525,517,502,253,511,764
1000,517,533,486,274,480,754
1000,529,491,512,268,513,781
1000,483,488,498,236,511,747
1000,541,499,503,261,504,765
1000,493,509,494,245,495,740
1000,492,485,520,241,530,771
1000,473,490,500,223,525,748
1000,481,492,498,242,507,749
1000,483,494,501,236,515,751
1000,516,515,500,265,496,761
1000,527,489,500,253,491,744
1000,502,467,529,237,523,760
1000,504,512,505,247,515,762
1000,496,519,487,269,476,745
1000,481,537,484,261,480,741
1000,484,496,508,222,522,744
1000,482,487,513,242,512,754
1000,510,530,507,264,496,760
1000,506,519,511,253,505,758
1000,512,476,524,249,514,763
1000,500,520,542,262,512,774
1000,504,497,481,254,504,758
1000,483,494,536,238,514,752
1000,479,513,514,238,516,754
1000,517,487,507,249,506,755
1000,457,518,475,233,493,726
1000,512,514,492,259,480,739
1000,505,499,498,260,486,746
1000,523,494,494,256,490,746
1000,509,494,516,256,504,760
1000,481,514,508,255,496,751
1000,516,510,498,259,515,774
1000,504,494,500,245,499,744
1000,533,501,499,244,531,775
1000,500,497,486,255,486,741
1000,509,506,514,263,501,764
1000,490,479,489,225,502,727
1000,494,481,517,245,499,744
1000,503,487,537,239,538,777
1000,485,482,480,233,492,725
1000,480,488,505,231,518,749
1000,512,489,495,258,488,746
1000,494,495,508,236,525,761
1000,494,463,484,225,517,742
1000,489,488,501,231,523,754
1000,506,480,489,250,499,749
1000,512,511,519,255,504,759
1000,495,515,556,259,515,774
1000,481,463,490,222,528,750
1000,482,504,489,239,509,748
1000,518,526,502,270,512,782
1000,544,514,504,291,478,769
1000,531,503,484,256,489,745
1000,486,503,477,246,493,739
1000,518,508,513,265,489,754
1000,511,524,509,258,493,751
1000,488,482,473,240,480,720
1000,530,499,494,261,502,763
1000,488,486,497,238,505,743
1000,488,489,505,229,520,749
1000,486,487,501,230,508,738
1000,510,487,485,244,491,735
1000,500,496,489,250,493,743
1000,499,492,476,244,489,733
1000,514,484,526,246,526,772
1000,492,479,500,229,522,751
1000,493,522,505,236,519,755
1000,553,497,497,277,499,776
1000,496,518,522,248,517,765
1000,482,487,474,243,485,728
1000,488,490,505,229,518,747
1000,513,509,500,263,493,756
1000,520,519,501,289,467,756
1000,491,511,491,261,480,741
1000,513,488,509,239,519,758
1000,517,503,474,258,500,758
1000,506,515,483,273,450,723
1000,514,489,498,250,496,746
1000,508,499,521,271,485,756
1000,503,503,520,240,509,749
1000,515,537,499,273,493,766
1000,504,496,482,243,507,750
1000,502,511,508,255,503,758
1000,491,494,510,245,505,750
1000,500,496,473,263,470,733
1000,515,522,514,275,493,768
1000,508,497,509,250,514,764
1000,490,507,503,262,487,749
1000,486,524,522,257,496,753
1000,499,500,500,249,498,747
1000,524,502,513,254,511,765
1000,514,476,476,233,503,736
1000,508,493,511,261,507,768
1000,507,471,503,239,522,761
1000,487,510,482,260,483,743
1000,521,470,498,246,508,754
1000,491,524,494,244,481,725
1000,457,505,504,225,497,722
1000,490,502,505,238,501,739
1000,503,486,521,235,530,765
1000,506,523,506,270,494,764
1000,486,496,499,236,518,754
1000,507,506,488,257,496,753
1000,521,486,484,256,492,748
1000,455,529,508,251,482,733
1000,503,457,524,250,507,757
1000,494,506,511,243,499,742
1000,494,526,502,267,487,754
1000,493,474,471,225,525,750
1000,482,511,476,253,464,717
1000,517,503,513,261,523,784
1000,506,497,526,240,529,769
1000,507,477,524,256,509,765
1000,485,492,515,239,515,754
1000,518,515,484,257,496,753
1000,496,499,514,233,522,755
1000,487,520,490,259,471,730
1000,497,471,499,235,509,744
1000,517,470,509,238,526,764
1000,488,513,483,257,471,728
1000,504,508,471,251,480,731
1000,498,484,490,226,521,747
1000,499,510,496,251,508,759
1000,504,475,481,250,500,750
1000,514,479,491,229,529,758
1000,483,506,477,247,477,724
1000,496,526,494,273,468,741
1000,500,509,476,259,469,728
1000,484,516,510,246,505,751
1000,519,507,485,265,504,769
1000,504,471,510,227,527,754
1000,486,505,508,238,509,747
1000,464,512,491,219,501,720
1000,511,498,522,250,514,764
1000,500,526,467,262,477,739
1000,509,487,514,237,526,763
1000,482,471,466,225,496,721
1000,497,537,504,266,494,760
1000,529,476,525,251,507,758
1000,458,510,487,228,483,711
1000,512,500,482,256,493,749
1000,503,489,515,240,519,759
1000,477,510,470,249,474,723
1000,488,481,506,239,497,736
1000,479,502,482,256,483,739
1000,517,486,494,254,503,757
1000,506,507,512,250,515,765
1000,460,520,491,232,500,732
1000,497,537,494,279,468,747
1000,485,480,511,244,486,730
1000,491,514,507,259,481,740
1000,496,541,505,273,461,734
1000,504,507,484,261,488,749
1000,495,540,490,271,467,738
1000,503,494,503,236,503,739
1000,507,503,484,252,478,730
1000,471,489,499,220,508,728
1000,481,510,527,239,511,750
1000,502,499,486,251,492,743
1000,509,526,479,266,476,742
1000,515,488,504,254,510,764
1000,489,503,496,257,480,737
1000,516,492,540,252,532,784
1000,526,509,490,258,493,751
1000,510,483,506,243,500,743
1000,503,501,544,261,514,775
1000,468,510,517,239,517,756
1000,511,492,513,241,509,750
1000,522,528,466,258,491,749
1000,477,545,506,259,497,756
1000,500,494,497,236,520,756
1000,492,505,502,250,500,750
1000,505,523,484,252,497,749
1000,515,499,513,259,519,778
1000,509,527,503,269,488,757
1000,510,495,497,264,473,737
1000,533,494,475,256,491,747
1000,517,525,490,280,472,752
1000,496,495,512,245,512,757
1000,529,529,496,259,507,766
1000,504,494,486,245,492,737
1000,503,516,496,257,492,749
1000,540,456,518,239,522,761
1000,531,514,501,264,484,748
1000,471,511,508,244,513,757
1000,498,489,549,244,541,785
1000,503,510,512,256,504,760
1000,501,483,491,242,506,748
1000,515,513,485,268,486,754
1000,482,477,509,228,516,744
1000,482,520,508,244,510,754
1000,532,514,495,273,503,776
1000,500,489,494,246,511,757
1000,489,483,520,234,510,744
1000,510,502,518,252,507,759
1000,485,503,470,255,470,725
1000,503,495,515,250,518,768
1000,533,503,524,269,523,792
1000,488,521,497,255,492,747
1000,504,471,480,244,494,738
1000,514,487,511,258,500,758
1000,455,510,507,225,511,736
1000,518,497,527,266,483,749
1000,487,514,518,244,518,762
1000,515,524,498,265,487,752
1000,499,492,513,242,519,761
1000,533,535,472,295,467,762
1000,477,487,483,234,505,739
1000,483,485,504,240,497,737
1000,507,479,487,232,519,751
1000,486,519,505,252,495,747
1000,487,511,508,245,510,755
1000,495,501,500,247,503,750
1000,511,504,503,261,506,767
1000,528,496,524,271,502,773
1000,512,499,495,264,491,755
1000,497,492,500,256,494,750
1000,500,508,533,245,525,770
1000,487,522,481,252,495,747
1000,489,493,490,219,522,741
1000,502,522,494,266,483,749
1000,479,507,476,246,480,726
1000,501,518,518,259,497,756
1000,486,496,530,249,495,744
1000,471,482,511,223,510,733
1000,487,501,483,253,478,731
1000,496,524,477,269,470,739
1000,505,494,497,246,512,758
1000,488,500,508,249,498,747
1000,504,517,547,241,530,771
1000,503,490,483,243,511,754
1000,504,480,513,244,520,764
1000,515,531,497,265,487,752
1000,480,547,480,262,467,729
1000,523,529,491,286,474,760
1000,508,494,512,252,495,747
1000,491,530,512,271,479,750
1000,498,492,503,247,498,745
1000,491,499,496,249,502,751
1000,526,514,480,268,465,733
1000,484,481,508,228,525,753
1000,522,484,518,254,511,765
1000,480,478,509,236,513,749
1000,517,499,499,259,499,758
1000,485,500,527,264,487,751
1000,498,504,508,253,509,762
1000,464,495,492,236,486,722
1000,489,503,475,245,484,729
1000,490,521,484,255,480,735
1000,516,520,488,261,492,753
1000,508,499,503,253,502,755
1000,487,492,497,243,490,733
1000,487,524,492,251,500,751
1000,504,500,477,243,503,746
1000,462,503,463,226,472,698
1000,494,519,496,262,482,744
1000,500,492,484,254,477,731
1000,500,467,497,242,511,753
1000,495,471,484,228,523,751
1000,512,518,527,262,519,781
1000,498,472,462,233,493,726
1000,500,469,497,236,509,745
1000,503,498,489,253,490,743
1000,494,519,489,254,499,753
1000,497,495,511,257,481,738
1000,521,505,524,251,511,762
1000,506,506,480,254,490,744
1000,511,513,494,275,473,748
1000,517,494,498,246,516,762
1000,518,514,508,277,471,748
1000,482,499,476,245,486,731
1000,494,505,476,255,470,725
1000,510,507,478,258,479,737
1000,512,466,512,242,513,755
1000,486,535,503,256,491,747
1000,499,503,510,249,500,749
1000,509,475,499,238,511,749
1000,476,502,476,228,507,735
1000,512,516,490,267,484,751
1000,514,484,518,256,522,778
1000,494,503,480,256,473,729
1000,512,505,498,258,492,750
1000,505,512,510,262,500,762
1000,470,507,498,240,496,736
1000,483,496,496,233,491,724
1000,501,502,500,241,509,750
1000,509,488,494,255,514,769
1000,518,480,467,250,507,757
1000,501,522,501,262,474,736
1000,506,510,494,253,501,754
1000,495,492,511,259,500,759
1000,499,502,515,259,505,764
1000,509,473,498,239,513,752
1000,476,495,527,233,515,748
1000,498,499,506,251,496,747
1000,501,478,502,250,510,760
1000,511,484,509,246,499,745
1000,504,473,506,245,508,753
1000,519,492,500,255,519,774
1000,517,517,476,256,489,745
1000,508,496,481,255,488,743
1000,519,497,480,261,487,748
1000,498,490,519,243,510,753
1000,491,504,511,227,510,737
1000,504,481,503,234,509,743
1000,497,497,506,246,512,758
1000,511,487,513,245,509,754
1000,505,505,497,258,499,757
1000,501,480,499,235,517,752
1000,513,524,525,275,492,767
1000,473,516,497,257,480,737
1000,503,522,492,260,480,740
1000,491,536,469,264,467,731
1000,487,501,520,240,522,762
1000,496,507,509,242,522,764
1000,474,502,499,241,499,740
1000,511,490,498,255,490,745
1000,514,476,499,244,511,755
1000,514,505,514,256,510,766
1000,495,524,497,251,487,738
1000,509,498,493,250,498,748
1000,503,499,494,257,491,748
1000,519,497,493,258,510,768
1000,523,487,506,260,506,766
1000,480,503,503,246,495,741
1000,511,501,497,248,514,762
1000,493,515,503,267,473,740
1000,485,488,497,226,520,746
1000,468,499,507,226,522,748
1000,521,504,478,258,488,746
1000,510,516,477,259,498,757
1000,494,515,492,264,480,744
1000,510,496,510,257,498,755
1000,495,491,493,251,483,734
1000,509,464,492,240,509,749
1000,486,496,473,236,479,715
1000,458,513,515,237,491,728
1000,514,507,509,261,509,770
1000,466,510,457,233,473,706
1000,499,503,493,241,503,744
1000,479,495,501,250,495,745
1000,510,492,475,255,475,730
1000,514,506,511,258,508,766
1000,492,488,489,239,495,734
1000,521,503,529,256,509,765
1000,476,529,519,247,503,750
1000,500,499,492,243,496,739
1000,529,505,497,263,506,769
1000,492,489,469,232,497,729
1000,505,496,511,249,509,758
1000,500,493,500,253,511,764
1000,506,513,473,252,481,733
1000,475,486,488,226,499,725
1000,530,515,465,277,470,747
1000,490,506,491,251,483,734
1000,519,507,519,258,514,772
1000,534,518,495,287,465,752
1000,485,498,508,253,508,761
1000,500,472,478,245,510,755
1000,467,498,538,228,531,759
1000,492,487,523,235,528,763
1000,479,480,488,219,503,722
1000,515,485,513,254,517,771
1000,506,495,493,256,480,736
1000,523,470,513,254,516,770
1000,510,485,504,257,484,741
1000,483,515,481,244,479,723
1000,468,507,520,233,520,753
1000,494,479,496,232,496,728
1000,507,503,468,278,468,746
1000,496,493,507,253,509,762
1000,512,508,493,255,495,750
1000,509,475,503,232,518,750
1000,551,485,487,275,503,778
1000,488,492,486,241,485,726
1000,514,471,527,238,528,766
1000,523,491,511,254,508,762
1000,501,531,480,266,479,745
1000,516,507,510,260,497,757
1000,508,523,511,277,481,758
1000,498,515,503,250,508,758
1000,508,496,500,241,519,760
1000,522,527,495,282,479,761
1000,499,498,510,249,509,758
1000,487,485,480,234,497,731
1000,514,516,513,279,491,770
1000,493,520,500,252,494,746
1000,509,500,475,264,476,740
1000,494,527,487,263,477,740
1000,572,504,513,292,498,790
1000,506,509,503,250,509,759
1000,493,514,510,265,489,754
1000,505,501,494,261,488,749
1000,486,464,492,227,516,743
1000,481,495,495,239,515,754
1000,492,488,496,236,497,733
1000,515,514,503,280,496,776
1000,500,493,541,241,534,775
1000,499,478,484,237,512,749
1000,504,504,519,257,515,772
1000,484,499,493,233,496,729
1000,476,483,521,232,524,756
1000,493,505,489,244,491,735
1000,487,506,499,244,512,756
1000,515,500,480,263,482,745
1000,490,524,510,249,500,749
1000,479,516,481,247,485,732
1000,486,473,508,232,514,746
1000,509,499,506,266,497,763
1000,466,510,501,244,486,730
1000,508,464,493,229,517,746
1000,510,503,482,258,496,754
1000,497,502,488,238,498,736
1000,483,503,502,249,489,738
1000,493,497,507,234,520,754
1000,491,519,466,252,484,736
1000,485,494,483,238,503,741
1000,514,497,514,265,504,769
1000,495,498,477,252,492,744
1000,529,499,493,267,482,749
1000,512,501,491,249,503,752
1000,494,480,535,235,540,775
1000,488,512,497,246,491,737
1000,505,505,506,254,497,751
1000,502,517,475,247,486,733
1000,477,513,530,238,522,760
1000,489,521,498,249,495,744
1000,499,535,505,262,500,762
1000,490,519,510,252,492,744
1000,515,503,463,254,487,741
1000,495,486,497,233,507,740
1000,471,506,499,251,488,739
1000,506,492,523,257,512,769
1000,492,494,478,235,494,729
1000,498,512,503,253,514,767
1000,489,505,513,236,501,737
1000,513,503,522,246,524,770
1000,492,496,486,237,513,750
1000,496,517,501,270,457,727
1000,485,488,544,236,530,766
1000,488,490,499,261,491,752
1000,465,510,487,234,487,721
1000,519,524,462,262,466,728
1000,517,475,522,234,539,773
1000,494,511,483,245,474,719
1000,497,494,507,243,502,745
1000,514,487,489,252,494,746
1000,518,501,497,260,489,749
1000,503,524,471,262,465,727
1000,523,503,507,263,514,777
1000,494,508,483,235,501,736
1000,504,514,510,257,486,743
1000,534,489,507,259,514,773
1000,499,470,475,239,507,746
1000,474,509,516,228,522,750
1000,486,499,507,255,485,740
1000,517,518,513,268,504,772
1000,507,507,526,268,489,757
1000,496,510,507,258,493,751
1000,508,522,489,263,489,752
1000,469,482,513,212,526,738
1000,503,499,493,235,512,747
1000,515,477,514,241,528,769
1000,489,494,492,240,482,722
1000,504,545,502,277,480,757
1000,486,492,515,217,535,752
1000,511,486,485,242,510,752
1000,504,502,500,255,497,752
1000,506,481,487,251,506,757
1000,506,506,487,248,501,749
1000,514,485,484,240,512,752
1000,487,499,515,244,502,746
1000,498,516,523,261,492,753
1000,511,495,485,255,491,746
1000,496,491,512,254,487,741
1000,514,511,500,266,492,758
1000,515,485,501,264,488,752
1000,497,510,484,242,483,725
1000,504,491,504,234,533,767
1000,510,501,488,258,484,742
1000,502,515,508,255,503,758
1000,492,508,498,245,504,749
1000,508,491,528,254,512,766
1000,495,509,501,250,497,747
1000,519,481,496,249,512,761
1000,542,512,516,271,518,789
1000,495,520,514,267,477,744
1000,498,483,489,247,504,751
1000,494,498,503,244,500,744
1000,479,523,513,259,479,738
1000,511,520,484,267,486,753
1000,480,520,522,244,507,751
1000,501,514,508,257,503,760
1000,507,490,516,246,516,762
1000,495,487,513,239,529,768
1000,522,486,497,253,512,765
1000,505,491,489,244,498,742
1000,503,523,495,269,478,747
1000,515,506,482,269,484,753
1000,488,486,520,230,522,752
1000,488,497,492,246,496,742
1000,485,517,482,240,482,722
1000,491,479,493,243,511,754
1000,520,495,483,267,471,738
1000,481,509,505,257,482,739
1000,468,510,476,243,479,722
1000,518,509,486,259,498,757
1000,498,464,504,246,492,738
1000,498,466,513,236,513,749
1000,514,486,535,255,524,779
1000,480,481,501,234,511,745
1000,515,526,519,270,500,770
1000,510,497,513,255,512,767
1000,470,493,513,237,508,745
1000,490,476,495,235,508,743
1000,496,486,509,232,512,744
1000,506,489,486,243,502,745
1000,497,521,489,254,485,739
1000,512,497,507,241,510,751
1000,506,481,513,232,535,767
1000,496,495,502,237,523,760
1000,483,496,490,231,485,716
1000,495,485,502,229,509,738
1000,512,486,522,257,496,753
1000,495,492,510,249,505,754
1000,507,527,504,281,466,747
1000,506,471,499,250,492,742
1000,477,502,526,242,515,757
1000,528,487,508,269,492,761
1000,464,488,501,241,489,730
1000,499,481,483,246,495,741
1000,488,484,522,240,516,756
1000,510,475,514,241,525,766
1000,484,480,501,232,508,740
1000,518,510,508,255,504,759
1000,492,471,495,226,521,747
1000,504,478,496,233,530,763
1000,495,492,504,240,517,757
1000,515,505,481,269,493,762
1000,487,481,522,234,511,745
1000,498,526,477,252,484,736
1000,512,487,475,254,481,735
1000,488,544,476,261,471,732
1000,508,481,494,230,507,737
1000,498,530,495,270,482,752
1000,521,487,505,255,495,750
1000,488,506,491,239,514,753
1000,498,462,483,221,527,748
1000,486,516,474,252,479,731
1000,498,511,487,260,482,742
1000,502,497,510,250,512,762
1000,498,518,499,262,495,757
1000,490,487,493,247,512,759
1000,500,495,494,236,503,739
1000,472,506,484,243,488,731
1000,490,495,494,245,510,755
1000,518,497,515,263,491,754
1000,509,497,494,258,491,749
1000,484,510,507,237,497,734
1000,492,512,522,257,497,754
1000,502,490,512,235,526,761
1000,503,532,501,275,474,749
1000,500,518,493,254,485,739
1000,503,492,497,252,494,746
1000,536,523,517,282,504,786
1000,496,493,525,236,518,754
1000,499,487,506,247,499,746
1000,502,500,524,240,515,755
1000,477,509,518,250,496,746
1000,481,513,503,254,483,737
1000,512,475,474,237,514,751
1000,477,503,481,231,510,741
1000,482,515,502,256,482,738
1000,490,485,480,238,495,733
1000,487,528,517,268,484,752
1000,508,474,484,230,516,746
1000,478,467,518,235,509,744
1000,536,522,502,282,490,772
1000,494,489,495,241,514,755
1000,503,527,492,262,481,743
1000,512,509,531,252,517,769
1000,503,487,509,244,534,778
1000,511,484,497,246,515,761
1000,522,487,498,268,489,757
1000,460,498,514,220,509,729
1000,479,542,472,261,473,734
1000,501,508,527,255,511,766
1000,491,514,508,266,495,761
1000,497,496,519,250,490,740
1000,508,470,485,239,497,736
1000,517,518,507,274,496,770
1000,543,509,503,262,514,776
1000,511,511,488,264,487,751
1000,506,491,512,260,491,751
1000,482,493,493,247,486,733
1000,489,474,508,233,520,753
1000,514,515,497,255,515,770
1000,488,510,490,262,464,726
1000,509,523,516,276,492,768
1000,498,484,491,243,499,742
1000,498,502,469,251,481,732
1000,495,527,509,254,508,762
1000,504,534,496,261,481,742
1000,506,514,496,262,481,743
1000,502,534,491,267,473,740
1000,492,499,508,244,505,749
1000,492,494,506,253,497,750
1000,503,502,519,247,517,764
1000,521,495,501,267,495,762
1000,523,508,489,282,472,754
1000,495,523,489,259,471,730
1000,509,478,502,239,515,754
1000,507,484,475,259,471,730
1000,540,494,511,264,505,769
1000,491,483,522,236,514,750
1000,499,492,498,245,506,751
1000,479,506,485,241,494,735
1000,468,505,521,257,489,746
1000,500,487,492,237,526,763
1000,513,506,513,268,494,762
1000,491,473,496,220,531,751
1000,512,492,482,247,513,760
1000,516,497,494,256,495,751
1000,526,461,489,246,503,749
1000,487,483,542,242,531,773
1000,509,478,476,245,498,743
1000,504,533,492,275,470,745
1000,494,503,477,247,478,725
1000,518,509,500,267,477,744
1000,518,491,491,256,486,742
1000,480,519,504,245,492,737
1000,519,515,479,274,477,751
1000,509,502,511,256,502,758
1000,504,521,523,243,524,767
1000,481,512,508,243,514,757
1000,487,507,507,249,495,744
1000,490,480,510,234,500,734
1000,491,506,505,266,482,748
1000,516,499,502,268,477,745
1000,486,487,508,236,509,745
1000,495,510,502,250,494,744
1000,514,513,484,250,498,748
1000,518,513,501,266,484,750
1000,519,490,486,256,507,763
1000,498,507,525,242,535,777
1000,500,505,524,256,512,768
1000,523,487,507,255,510,765
1000,500,497,506,257,485,742
1000,503,497,499,250,490,740
1000,492,480,503,223,522,745
1000,499,494,510,252,507,759
1000,496,504,464,239,477,716
1000,513,496,510,243,511,754
1000,502,469,498,237,497,734
1000,500,523,522,262,502,764
1000,488,487,528,225,530,755
1000,486,486,482,255,485,740
1000,495,524,512,263,486,749
1000,496,502,488,243,490,733
1000,500,509,494,243,504,747
1000,539,526,498,291,474,765
1000,497,526,506,267,486,753
1000,493,482,503,233,492,725
1000,512,482,500,261,504,765
1000,512,498,487,271,476,747
1000,489,507,512,247,504,751
1000,493,490,479,242,509,751
1000,488,503,467,262,465,727
1000,525,493,504,274,479,753
1000,501,509,496,271,480,751
1000,513,511,492,265,482,747
1000,501,480,505,236,519,755
1000,494,512,466,257,478,735
1000,471,484,512,222,520,742
1000,523,480,503,256,488,744
1000,494,504,535,242,523,765
1000,508,515,478,260,489,749
1000,518,478,492,241,527,768
1000,518,501,519,259,505,764
1000,502,526,476,257,472,729
1000,491,485,502,247,498,745
1000,488,489,517,244,519,763
1000,493,479,494,231,511,742
1000,513,505,516,256,514,770
1000,496,473,538,237,543,780
1000,492,512,507,250,498,748
1000,542,507,497,275,498,773
1000,492,511,499,238,501,739
1000,501,499,487,256,484,740
1000,493,501,518,259,498,757
1000,533,506,498,275,490,765
1000,495,502,498,241,504,745
1000,487,523,487,260,465,725
1000,497,508,491,244,514,758
1000,507,488,497,244,518,762
1000,477,515,510,244,494,738
1000,503,480,489,229,520,749
1000,498,518,495,254,498,752
1000,477,505,499,249,487,736
1000,485,518,490,262,470,732
1000,512,494,474,245,497,742
1000,510,499,488,250,491,741
1000,482,530,498,260,477,737
1000,497,507,520,247,503,750
1000,498,496,500,244,504,748
1000,478,485,476,219,521,740
1000,496,500,496,250,499,749
1000,487,492,498,244,518,762
1000,525,487,496,249,525,774
1000,487,464,495,233,506,739
1000,492,500,488,247,492,739
1000,516,485,494,251,503,754
1000,507,533,488,266,474,740
1000,503,505,536,250,510,760
1000,498,481,480,235,497,732
1000,522,501,487,269,475,744
1000,477,481,496,222,522,744
1000,505,494,475,253,481,734
1000,490,528,492,268,473,741
1000,506,507,508,269,489,758
1000,500,531,493,265,474,739
1000,499,492,487,246,505,751
1000,487,512,490,262,479,741
1000,509,453,527,240,537,777
1000,510,501,506,260,505,765
1000,511,490,497,240,510,750
1000,515,486,510,242,530,772
1000,496,503,520,247,514,761
1000,467,506,504,229,512,741
1000,505,533,492,269,480,749
1000,498,502,503,253,503,756
1000,496,476,493,230,506,736
1000,489,480,482,239,492,731
1000,484,522,506,258,492,750
1000,488,506,507,251,486,737
1000,532,515,488,266,485,751
1000,494,507,516,240,513,753
1000,470,456,508,204,535,739
1000,517,492,503,256,504,760
1000,507,482,502,247,503,750
1000,496,506,483,235,498,733
1000,481,510,520,257,497,754
1000,500,487,501,245,501,746
1000,483,525,519,243,504,747
1000,508,488,505,244,510,754
1000,507,495,489,253,483,736
1000,491,518,506,253,496,749
1000,500,503,510,243,517,760
1000,486,485,551,242,537,779
1000,487,532,485,273,460,733
1000,484,500,513,253,494,747
1000,511,517,486,268,497,765
1000,518,519,497,276,489,765
1000,459,491,481,238,495,733
1000,523,481,516,263,501,764
1000,508,506,517,259,512,771
1000,510,500,527,263,508,771
1000,524,494,475,260,492,752
1000,503,488,495,244,498,742
1000,518,478,515,247,520,767
1000,512,510,477,252,491,743
1000,470,496,480,230,478,708
1000,502,518,501,263,499,762
1000,512,508,505,254,520,774
1000,476,502,519,233,516,749
1000,502,508,458,260,464,724
1000,490,508,492,250,483,733
1000,503,509,503,251,490,741
1000,546,500,488,280,494,774
1000,477,500,527,239,519,758
1000,508,513,499,260,488,748
1000,498,539,501,279,466,745
1000,498,507,512,237,511,748
1000,524,483,498,250,509,759
1000,488,511,485,252,482,734
1000,510,517,510,270,484,754
1000,493,504,531,244,519,763
1000,509,476,489,235,514,749
1000,521,520,485,267,483,750
1000,497,476,485,231,502,733
1000,517,489,497,253,513,766
1000,496,504,507,241,516,757
1000,492,519,507,255,486,741
1000,510,522,463,277,457,734
1000,485,524,497,258,482,740
1000,509,505,499,269,495,764
1000,491,480,491,237,521,758
1000,520,535,513,292,472,764
1000,487,507,507,247,493,740
1000,491,485,496,246,500,746
1000,490,515,500,255,480,735
1000,491,498,509,242,523,765
1000,493,501,475,244,479,723
1000,472,473,513,217,537,754
1000,535,498,496,251,522,773
1000,524,463,499,248,497,745
1000,486,490,510,247,483,730
1000,515,485,497,244,511,755
1000,502,518,489,260,500,760
1000,472,514,467,231,491,722
1000,531,489,499,248,502,750
1000,485,526,505,260,478,738
1000,499,521,468,275,450,725
1000,478,495,504,237,494,731
1000,508,481,488,243,509,752
1000,498,500,491,248,487,735
1000,494,535,496,262,479,741
1000,477,518,527,235,519,754
1000,510,506,505,268,477,745
1000,507,470,486,233,510,743
1000,503,496,475,247,493,740
1000,501,541,520,266,491,757
1000,508,493,507,261,507,768
1000,492,498,486,240,500,740
1000,508,497,517,259,503,762
1000,516,518,527,253,516,769
1000,476,493,499,233,501,734
1000,476,497,476,244,487,731
1000,504,489,523,246,518,764
1000,516,492,489,253,503,756
1000,518,508,511,257,505,762
1000,511,501,487,252,514,766
1000,494,500,507,235,523,758
1000,520,528,491,269,491,760
1000,508,521,495,248,493,741
1000,506,504,512,259,489,748
1000,507,504,449,253,478,731
1000,537,485,467,258,504,762
1000,491,499,472,244,495,739
1000,479,536,508,253,497,750
1000,506,507,502,261,484,745
1000,516,470,504,240,521,761
1000,502,495,492,256,493,749
1000,500,505,510,263,495,758
1000,496,494,519,244,513,757
1000,508,495,503,250,511,761
1000,498,486,464,221,511,732
1000,498,500,510,265,480,745
1000,468,488,471,226,493,719
1000,503,464,472,252,484,736
1000,467,526,494,247,484,731
1000,502,494,498,248,505,753
1000,506,524,484,273,464,737
1000,476,499,515,240,510,750
1000,488,522,490,259,479,738
1000,501,492,492,242,504,746
1000,475,498,525,226,522,748
1000,501,467,486,234,506,740
1000,523,477,499,240,513,753
1000,489,507,488,250,497,747
1000,479,514,491,248,485,733
1000,495,489,516,242,497,739
1000,525,523,520,279,495,774
1000,471,506,498,243,487,730
1000,483,503,526,253,511,764
1000,510,491,483,248,496,744
1000,483,507,524,247,499,746
1000,499,491,518,241,512,753
1000,510,491,520,241,533,774
1000,517,506,501,262,501,763
1000,483,530,490,255,473,728
1000,517,485,511,247,521,768
1000,504,511,470,256,483,739
1000,515,460,486,246,510,756
1000,512,481,500,261,485,746
1000,510,526,485,259,489,748
1000,507,514,446,261,463,724
1000,500,468,520,230,523,753
1000,522,500,484,248,504,752
1000,497,500,501,233,503,736
1000,502,487,508,254,515,769
1000,494,516,511,255,485,740
1000,510,513,485,267,492,759
1000,508,486,514,250,513,763
1000,514,490,466,250,484,734
1000,488,512,528,262,499,761
1000,514,483,524,240,530,770
1000,504,501,512,268,486,754
1000,496,500,481,246,495,741
1000,466,511,488,241,481,722
1000,524,494,484,265,498,763
1000,481,514,520,247,498,745
1000,531,481,522,255,519,774
1000,510,498,507,255,512,767
1000,508,500,504,250,509,759
1000,500,476,490,238,504,742
1000,514,518,479,272,483,755
1000,498,515,487,259,497,756
1000,528,498,502,279,481,760
1000,508,515,480,272,476,748
1000,487,498,489,248,476,724
1000,497,466,511,237,514,751
1000,504,523,492,264,494,758
1000,497,505,487,254,492,746
1000,507,489,493,245,513,758
1000,502,495,500,251,506,757
1000,513,521,502,269,500,769
1000,527,496,515,267,515,782
1000,501,508,523,262,503,765
1000,467,522,511,248,502,750
1000,521,473,498,251,516,767
1000,498,484,480,233,519,752
1000,514,503,486,263,487,750
1000,507,499,483,249,491,740
1000,509,502,483,247,493,740
1000,522,509,494,255,500,755
1000,501,512,483,264,480,744
1000,497,481,533,232,532,764
1000,481,486,486,238,485,723
1000,503,507,491,243,514,757
1000,530,509,472,276,475,751
1000,501,471,505,238,509,747
1000,508,518,503,282,458,740
1000,491,471,498,230,508,738
1000,486,483,501,230,528,758
1000,495,515,500,256,489,745
1000,508,492,485,245,508,753
1000,488,502,512,253,495,748
1000,489,505,539,253,514,767
1000,481,493,497,232,504,736
1000,523,504,487,266,489,755
1000,533,534,464,282,472,754
1000,507,520,508,253,502,755
1000,495,494,504,250,502,752
1000,452,509,481,231,472,703
1000,525,496,497,262,503,765
1000,519,537,474,283,453,736
1000,481,492,497,236,499,735
1000,515,502,501,255,509,764
1000,520,512,547,266,525,791
1000,499,497,507,246,507,753
1000,508,484,502,254,495,749
1000,477,485,495,230,504,734
1000,495,485,531,235,526,761
1000,465,505,527,235,505,740
1000,534,467,515,235,544,779
1000,488,481,515,231,523,754
1000,491,460,500,215,538,753
1000,487,457,498,219,533,752
1000,493,459,490,221,512,733
1000,486,503,515,242,503,745
1000,491,519,488,244,491,735
1000,509,524,493,273,464,737
1000,458,513,521,238,499,737
1000,507,492,468,256,478,734
1000,489,502,475,253,483,736
1000,491,495,510,234,511,745
1000,482,516,525,241,526,767
1000,517,498,492,259,491,750
1000,483,502,521,255,492,747
1000,521,522,532,277,498,775
1000,498,505,509,256,494,750
1000,520,487,513,267,505,772
1000,519,514,507,257,504,761
1000,495,516,496,264,482,746
1000,506,493,502,244,502,746
1000,466,490,477,239,472,711
1000,493,502,485,252,487,739
1000,509,511,486,273,490,763
1000,512,507,493,252,488,740
1000,522,481,526,242,529,771
1000,487,499,494,242,498,740
1000,478,509,516,249,501,750
1000,484,511,513,248,511,759
1000,511,512,495,266,491,757
1000,506,506,505,258,501,759
1000,517,501,501,258,504,762
1000,519,501,475,256,476,732
1000,498,495,508,252,510,762
1000,534,512,504,289,475,764
1000,475,502,469,236,479,715
1000,517,513,491,267,481,748
1000,495,502,493,243,502,745
1000,500,473,482,239,504,743
1000,518,522,514,277,485,762
1000,510,504,501,275,481,756
1000,494,478,480,249,486,735
1000,495,495,489,256,479,735
1000,492,493,509,244,503,747
1000,521,484,505,268,491,759
1000,485,476,486,224,511,735
1000,489,497,487,241,497,738
1000,516,511,535,268,511,779
1000,529,521,507,298,462,760
1000,479,493,477,238,485,723
1000,493,505,501,242,495,737
1000,484,487,503,248,497,745
1000,501,501,530,255,523,778
1000,516,500,538,258,520,778
1000,513,485,493,251,503,754
1000,513,507,508,251,500,751
1000,490,489,483,233,500,733
1000,483,472,534,223,546,769
1000,518,522,510,269,489,758
1000,517,460,499,242,515,757
1000,515,504,517,269,492,761
1000,533,484,500,265,506,771
1000,495,503,504,241,506,747
1000,500,505,493,254,491,745
1000,491,504,493,249,490,739
1000,511,500,490,257,498,755
1000,516,510,494,258,508,766
1000,496,512,479,245,486,731
1000,508,501,489,250,497,747
1000,501,501,503,259,482,741
1000,543,506,492,284,472,756
1000,501,507,507,225,531,756
1000,507,477,524,231,526,757
1000,491,542,475,270,464,734
1000,525,486,509,250,512,762
1000,506,498,498,245,508,753
1000,519,484,495,245,506,751
1000,517,488,510,253,509,762
1000,491,497,490,245,493,738
1000,522,472,499,243,509,752
1000,499,495,475,255,479,734
1000,501,483,490,243,507,750
1000,493,497,522,245,514,759
1000,519,510,512,255,529,784
1000,513,509,516,255,513,768
1000,470,505,499,235,513,748
1000,523,471,489,248,512,760
1000,517,512,485,256,498,754
1000,493,498,488,249,485,734
1000,484,470,473,240,487,727
1000,472,500,524,229,528,757
1000,509,502,470,265,468,733
1000,510,505,508,252,496,748
1000,510,480,480,251,473,724
1000,502,490,485,240,494,734
1000,503,483,504,242,517,759
1000,512,487,500,256,510,766
1000,516,502,498,256,497,753
1000,528,526,511,274,502,776
1000,521,506,481,254,498,752
1000,507,487,496,239,510,749
1000,509,499,507,261,482,743
1000,504,498,508,245,525,770
1000,511,498,490,248,492,740
1000,514,498,521,265,511,776
1000,528,499,502,260,504,764
1000,514,483,509,258,505,763
1000,501,488,514,251,507,758
1000,477,504,499,247,484,731
1000,495,507,504,249,510,759
1000,487,473,517,227,519,746
1000,487,510,498,246,499,745
1000,519,498,465,254,477,731
1000,507,519,514,257,503,760
1000,511,511,506,253,500,753
1000,507,529,522,250,501,751
1000,466,492,496,232,505,737
1000,504,510,521,264,485,749
1000,504,518,495,282,480,762
1000,501,513,495,263,471,734
1000,514,508,502,248,508,756
1000,497,513,486,259,472,731
1000,496,521,496,254,478,732
1000,473,521,517,244,508,752
1000,504,528,491,278,478,756
1000,488,502,514,251,503,754
1000,494,517,511,262,491,753
1000,490,487,479,244,487,731
1000,524,465,490,233,531,764
1000,499,486,499,242,511,753
1000,499,509,491,239,515,754
1000,495,494,527,250,515,765
1000,484,519,494,252,487,739
1000,481,502,494,239,506,745
1000,528,490,515,258,524,782
1000,534,483,511,255,512,767
1000,513,500,502,264,499,763
1000,477,447,488,212,516,728
1000,521,511,493,264,493,757
1000,499,516,513,264,505,769
1000,509,505,502,250,512,762
1000,526,522,472,279,464,743
1000,498,501,519,249,508,757
1000,510,532,502,277,472,749
1000,525,525,483,277,468,745
1000,481,508,491,260,472,732
1000,499,490,519,240,527,767
1000,486,486,501,239,503,742
1000,474,487,512,225,525,750
1000,526,507,482,257,498,755
1000,476,485,480,235,491,726
1000,505,528,518,255,515,770
1000,498,508,495,251,497,748
1000,510,501,502,265,494,759
1000,500,498,531,233,550,783
1000,496,507,520,253,489,742
1000,531,505,500,255,511,766
1000,494,499,495,235,508,743
1000,511,492,501,245,512,757
1000,496,486,486,253,487,740
1000,497,515,521,264,505,769
1000,483,490,496,229,504,733
1000,489,498,503,251,489,740
1000,501,507,515,256,505,761
1000,505,503,505,242,512,754
1000,513,519,503,268,506,774
1000,484,518,481,253,477,730
1000,505,499,488,242,502,744
1000,498,507,495,256,492,748
1000,517,516,496,272,478,750
1000,492,484,513,234,504,738
1000,469,498,504,233,483,716
1000,495,494,485,262,481,743
1000,511,476,498,247,498,745
1000,498,501,505,253,512,765
1000,544,513,512,284,495,779
1000,490,510,495,242,500,742
1000,496,474,495,232,509,741
1000,500,513,506,265,498,763
1000,477,495,492,244,484,728
1000,479,481,510,214,525,739
1000,501,534,481,270,458,728
1000,493,511,505,246,511,757
1000,481,470,498,239,505,744
1000,501,490,472,247,491,738
1000,507,487,488,236,511,747
1000,535,527,498,281,476,757
1000,488,501,530,240,527,767
1000,504,478,520,262,507,769
1000,497,513,477,263,477,740
1000,505,493,490,246,506,752
1000,482,510,525,243,516,759
1000,485,507,487,237,500,737
1000,475,469,523,207,539,746
1000,451,504,510,219,503,722
1000,501,508,501,246,510,756
1000,509,500,510,260,493,753
1000,491,500,494,242,510,752
1000,508,511,520,254,508,762
1000,502,490,504,234,524,758
1000,515,474,514,257,499,756
1000,479,507,505,244,496,740
1000,489,529,489,253,471,724
1000,497,504,516,246,494,740
1000,495,513,506,246,507,753
1000,511,504,506,246,495,741
1000,537,489,490,269,499,768
1000,484,472,497,237,499,736
1000,509,489,514,253,516,769
1000,513,504,501,259,497,756
1000,486,514,487,256,488,744
1000,455,505,505,223,508,731
1000,520,508,520,269,504,773
1000,488,505,509,259,488,747
1000,488,501,494,246,493,739
1000,522,506,509,261,513,774
1000,504,505,504,239,523,762
1000,506,483,547,270,507,777
1000,492,499,507,261,497,758
1000,509,498,507,241,514,755
1000,519,485,532,244,527,771
1000,517,491,473,251,492,743
1000,513,490,502,243,516,759
1000,505,525,506,271,480,751
1000,498,517,506,267,483,750
1000,490,484,491,246,493,739
1000,509,475,520,243,516,759
1000,495,495,467,247,464,711
1000,494,490,479,254,490,744
1000,505,490,510,242,541,783
1000,483,504,510,245,494,739
1000,513,489,494,252,509,761
1000,542,486,492,263,495,758
1000,503,494,497,252,513,765
1000,531,496,476,263,495,758
1000,541,510,521,277,507,784
1000,518,491,492,260,506,766
1000,471,513,473,248,463,711
1000,515,500,493,255,490,745
1000,515,516,504,256,519,775
1000,516,534,492,255,511,766
1000,505,524,495,258,494,752
1000,497,524,508,270,473,743
1000,507,490,492,248,490,738
1000,501,531,491,271,465,736
1000,489,523,499,258,488,746
1000,471,505,511,239,489,728
1000,496,497,501,230,509,739
1000,481,487,492,249,497,746
1000,497,502,492,250,478,728
1000,501,493,524,246,526,772
1000,483,502,512,241,498,739
1000,510,501,490,249,507,756
1000,525,540,515,274,486,760
1000,527,480,486,251,513,764
1000,488,505,521,234,518,752
1000,516,474,515,246,515,761
1000,522,470,518,250,516,766
1000,473,499,499,242,501,743
1000,474,500,499,233,499,732
1000,459,493,503,231,524,755
1000,480,479,513,228,510,738
1000,500,521,510,269,493,762
1000,492,480,500,233,509,742
1000,503,478,528,228,546,774
1000,511,513,519,254,514,768
1000,508,501,524,259,503,762
1000,497,510,494,248,486,734
1000,510,510,522,261,511,772
1000,489,501,523,257,496,753
1000,505,492,508,247,508,755
1000,488,487,504,242,498,740
1000,523,494,510,256,516,772
1000,496,498,488,250,495,745
1000,495,498,489,252,506,758
1000,476,492,497,227,505,732
1000,517,520,491,277,481,758
1000,478,518,493,251,462,713
1000,500,488,494,244,515,759
1000,488,516,514,262,497,759
1000,500,534,515,257,491,748
1000,508,506,507,254,495,749
1000,523,527,512,279,461,740
1000,517,487,500,239,511,750
1000,497,523,500,267,494,761
1000,491,490,500,229,518,747
1000,504,477,504,241,507,748
1000,508,494,478,246,488,734
1000,515,497,503,245,504,749
1000,522,505,521,255,512,767
1000,515,493,481,262,493,755
1000,509,507,483,268,469,737
1000,492,488,507,239,511,750
1000,456,482,526,230,507,737
1000,507,514,492,265,490,755
1000,513,483,494,233,523,756
1000,499,469,484,219,518,737
1000,486,479,478,226,508,734
1000,516,503,525,255,528,783
1000,492,502,538,235,547,782
1000,488,513,513,236,505,741
1000,507,489,514,240,515,755
1000,525,476,475,256,494,750
1000,505,462,494,225,528,753
1000,494,496,488,237,499,736
1000,496,532,512,277,491,768
1000,492,507,505,240,500,740
1000,485,516,504,250,487,737
1000,505,527,501,265,489,754
1000,500,497,478,250,488,738
1000,485,516,493,246,492,738
1000,480,495,499,235,511,746
1000,486,515,503,251,498,749
1000,506,509,516,251,520,771
1000,494,514,517,252,501,753
1000,512,519,508,256,497,753
1000,509,499,510,269,492,761
1000,523,477,514,262,489,751
1000,500,500,528,244,535,779
1000,492,504,497,240,512,752
1000,504,476,497,244,496,740
1000,509,518,506,273,497,770
1000,508,528,491,270,470,740
1000,504,478,491,239,517,756
1000,498,502,490,246,504,750
1000,507,506,510,233,523,756
1000,492,486,519,247,516,763
1000,511,488,529,239,533,772
1000,510,505,488,247,488,735
1000,504,495,513,257,501,758
1000,490,516,506,254,487,741
1000,469,488,510,227,505,732
1000,538,503,479,272,478,750
1000,492,517,476,239,491,730
1000,493,492,524,255,497,752
1000,501,459,499,234,531,765
1000,499,503,509,243,501,744
1000,491,540,519,270,487,757
1000,508,510,514,264,501,765
1000,516,496,486,271,484,755
1000,481,472,497,229,509,738
1000,505,490,499,252,496,748
1000,491,483,520,238,515,753
1000,487,518,513,254,486,740
1000,508,504,486,246,500,746
1000,486,481,501,222,510,732
1000,467,476,513,232,506,738
1000,473,507,497,253,465,718
1000,525,500,491,254,504,758
1000,465,475,480,221,504,725
1000,475,478,487,234,500,734
1000,512,491,488,255,512,767
1000,485,518,491,255,480,735
1000,516,504,520,251,509,760
1000,480,506,534,239,525,764
1000,507,536,508,268,492,760
1000,476,497,501,240,503,743
1000,513,502,480,261,472,733
1000,480,500,514,242,504,746
1000,496,494,498,249,487,736
1000,506,498,504,250,508,758
1000,469,515,498,240,498,738
1000,508,509,497,252,489,741
1000,506,513,501,257,512,769
1000,508,485,506,246,507,753
1000,502,499,514,261,504,765
1000,483,500,510,244,505,749
1000,505,515,501,251,499,750
1000,486,521,509,248,499,747
1000,489,544,492,264,475,739
1000,481,509,524,256,500,756
1000,505,506,496,262,487,749
1000,489,472,500,233,510,743
1000,500,510,495,264,502,766
1000,483,494,498,241,506,747
1000,478,478,505,234,511,745
1000,486,498,505,233,520,753
1000,519,479,478,249,501,750
1000,503,493,535,239,523,762
1000,491,494,476,237,487,724
1000,493,500,491,244,483,727
1000,490,514,495,261,476,737
1000,489,498,540,246,521,767
1000,528,508,478,257,489,746
1000,502,487,470,247,486,733
1000,496,519,522,253,499,752
1000,495,500,504,244,496,740
1000,513,494,478,250,488,738
1000,512,534,486,263,486,749
1000,499,504,504,253,504,757
1000,500,504,515,254,508,762
1000,507,484,505,240,519,759
1000,495,508,482,247,497,744
1000,483,529,470,250,483,733
1000,522,503,491,267,485,752
1000,498,502,500,252,499,751
1000,508,511,496,258,495,753
1000,498,497,503,250,506,756
1000,478,491,487,240,498,738
1000,499,525,490,268,466,734
1000,499,491,470,244,488,732
1000,508,490,493,249,498,747
1000,491,508,533,255,506,761
1000,501,516,489,263,485,748
1000,495,509,480,239,492,731
1000,509,502,524,259,510,769
1000,505,496,489,252,488,740
1000,500,504,527,259,496,755
1000,498,487,510,242,510,752
1000,510,508,483,258,493,751
1000,490,474,477,238,492,730
1000,503,509,517,255,503,758
1000,496,504,494,253,491,744
1000,477,481,485,220,509,729
1000,490,491,459,231,485,716
1000,510,492,507,248,515,763
1000,463,506,506,248,497,745
1000,518,504,516,262,512,774
1000,527,477,495,243,527,770
1000,491,497,503,217,530,747
1000,502,518,504,270,487,757
1000,471,452,489,204,524,728
1000,493,500,505,255,480,735
1000,497,506,517,249,514,763
1000,516,486,501,244,513,757
1000,494,484,496,241,506,747
1000,501,493,508,247,508,755
1000,495,499,499,251,491,742
1000,506,498,501,266,484,750
1000,501,521,510,264,495,759
1000,478,521,487,249,488,737
1000,523,509,506,263,490,753
1000,491,480,515,238,522,760
1000,526,499,500,259,521,780
1000,481,513,506,257,488,745
1000,520,518,505,265,493,758
1000,499,507,512,250,498,748
1000,509,520,485,269,492,761
1000,515,489,497,255,497,752
1000,491,494,509,250,507,757
1000,489,498,516,239,515,754
1000,522,494,516,243,520,763
1000,501,495,472,230,518,748
1000,508,525,501,272,483,755
1000,493,505,492,245,491,736
1000,509,516,494,270,476,746
1000,490,489,535,240,515,755
1000,469,489,494,233,497,730
1000,524,495,481,253,511,764
1000,499,495,511,252,508,760
1000,488,490,516,235,509,744
1000,505,487,496,254,496,750
1000,510,544,525,277,499,776
1000,506,503,491,261,479,740
1000,506,489,512,235,528,763
1000,520,491,502,258,502,760
1000,503,528,500,285,472,757
1000,499,500,466,241,505,746
1000,507,513,496,253,505,758
1000,493,485,494,230,525,755
1000,507,488,519,244,534,778
1000,512,509,518,259,513,772
1000,495,498,487,256,490,746
1000,506,496,514,250,520,770
1000,509,499,505,239,523,762
1000,501,498,494,258,496,754
1000,472,492,474,226,487,713
1000,499,518,483,270,461,731
1000,516,488,507,258,498,756
1000,500,483,483,245,494,739
1000,521,492,461,259,470,729
1000,489,487,481,257,486,743
1000,511,507,500,257,501,758
1000,507,502,468,258,470,728
1000,494,518,508,255,485,740
1000,479,487,501,228,511,739
1000,539,497,503,273,506,779
1000,503,490,473,239,491,730
1000,513,517,470,269,485,754
1000,509,473,526,259,493,752
1000,486,510,475,251,470,721
1000,502,494,527,248,510,758
1000,494,511,498,251,496,747
1000,518,502,494,266,478,744
1000,527,500,492,270,475,745
1000,484,488,495,228,513,741
1000,482,525,521,253,491,744
1000,484,484,498,247,479,726
1000,500,518,527,255,499,754
1000,504,515,510,266,490,756
1000,496,525,500,266,483,749
1000,514,497,485,250,509,759
1000,478,498,529,234,519,753
1000,501,479,524,233,544,777
1000,476,465,486,209,521,730
1000,479,483,497,237,498,735
1000,514,499,467,254,490,744
1000,501,512,496,244,499,743
1000,512,487,517,243,517,760
1000,496,508,518,257,499,756
1000,499,512,479,240,486,726
1000,501,497,468,244,500,744
1000,508,491,517,246,508,754
1000,522,495,520,270,501,771
1000,513,478,518,243,517,760
1000,493,518,490,250,488,738
1000,495,493,513,255,496,751
1000,503,471,504,226,537,763
1000,503,490,509,247,518,765
1000,497,523,496,262,467,729
1000,486,509,510,244,508,752
1000,514,489,511,259,507,766
1000,501,516,495,262,482,744
1000,476,482,509,240,498,738
1000,493,501,513,247,507,754
1000,487,475,479,239,497,736
1000,496,477,496,247,493,740
1000,481,497,523,251,505,756
1000,507,486,530,258,505,763
1000,526,505,490,271,488,759
1000,500,463,531,230,539,769
1000,520,509,515,265,497,762
1000,497,502,487,251,493,744
1000,518,490,512,251,510,761
1000,506,490,498,245,502,747
1000,505,498,485,266,482,748
1000,483,500,480,247,498,745
1000,519,520,519,273,491,764
1000,506,470,511,235,527,762
1000,495,500,487,248,482,730
1000,508,490,503,240,515,755
1000,495,506,501,252,494,746
1000,491,488,479,241,492,733
1000,523,485,494,258,503,761
1000,519,480,512,252,509,761
1000,500,527,498,261,487,748
1000,486,480,496,226,519,745
1000,509,500,478,261,492,753
1000,504,503,466,251,471,722
1000,496,494,520,241,515,756
1000,493,471,497,231,523,754
1000,501,471,500,249,510,759
1000,502,486,528,245,527,772
1000,492,527,480,265,481,746
1000,496,520,503,260,488,748
1000,492,499,481,252,486,738
1000,490,497,510,253,502,755
1000,527,495,524,264,510,774
1000,512,485,485,243,509,752
1000,523,526,475,278,465,743
1000,507,515,517,266,506,772
1000,494,502,493,257,482,739
1000,500,519,485,251,508,759
1000,458,492,492,222,500,722
1000,518,505,495,262,502,764
1000,497,499,524,231,552,783
1000,518,489,521,241,532,773
1000,501,492,501,258,505,763
1000,483,494,508,224,527,751
1000,525,501,460,264,481,745
1000,484,480,489,225,508,733
1000,516,505,518,273,495,768
1000,505,484,478,244,496,740
1000,484,513,509,259,496,755
1000,500,493,529,250,513,763
1000,497,510,476,249,496,745
1000,523,523,508,266,498,764
1000,523,495,477,261,494,755
1000,485,503,523,245,504,749
1000,502,497,478,256,489,745
1000,484,501,490,247,489,736
1000,515,496,510,252,500,752
1000,505,495,534,242,533,775
1000,510,521,496,278,473,751
1000,466,498,494,219,509,728
1000,475,498,485,244,500,744
1000,479,501,499,247,482,729
1000,484,506,501,254,489,743
1000,493,482,520,255,502,757
1000,507,480,502,249,513,762
1000,499,489,507,239,515,754
1000,503,502,517,256,500,756
1000,498,518,510,259,509,768
1000,515,489,487,252,488,740
1000,503,490,510,233,525,758
1000,511,502,518,269,498,767
1000,498,506,495,241,504,745
1000,473,488,494,230,497,727
1000,521,505,493,272,490,762
1000,527,513,518,274,492,766
1000,475,507,500,253,489,742
1000,476,489,498,249,486,735
1000,505,498,495,251,510,761
1000,472,504,477,235,485,720
1000,501,499,483,247,500,747
1000,518,513,508,266,499,765
1000,513,510,514,277,477,754
1000,500,478,503,234,528,762
1000,498,496,525,258,496,754
1000,485,517,514,253,504,757
1000,497,510,501,251,498,749
1000,488,488,481,239,489,728
1000,510,499,481,264,486,750
1000,512,472,474,233,499,732
1000,491,485,506,253,495,748
1000,502,521,520,262,500,762
1000,481,489,514,241,505,746
1000,503,500,512,252,511,763
1000,487,508,496,258,479,737
1000,501,493,505,235,514,749
1000,502,518,491,267,476,743
1000,516,495,534,256,511,767
1000,488,536,494,266,481,747
1000,509,533,456,268,456,724
1000,521,512,533,286,491,777
1000,501,506,466,223,518,741
1000,493,497,514,243,523,766
1000,527,498,477,278,473,751
1000,510,515,509,260,504,764
1000,485,512,510,246,496,742
1000,482,512,518,244,505,749
1000,513,499,481,242,500,742
1000,504,530,480,269,477,746
1000,503,535,512,277,467,744
1000,490,516,498,243,500,743
1000,525,505,522,262,522,784
1000,515,510,498,269,477,746
1000,506,477,486,253,496,749
1000,497,463,484,247,502,749
1000,492,489,508,237,512,749
1000,495,485,495,242,515,757
1000,499,485,515,240,523,763
1000,484,508,516,247,498,745
1000,507,510,515,270,489,759
1000,491,515,509,259,494,753
1000,518,520,505,257,498,755
1000,522,510,471,256,489,745
1000,488,530,478,267,455,722
1000,511,499,520,264,496,760
1000,502,500,504,240,507,747
1000,504,501,487,244,509,753
1000,494,502,499,243,513,756
1000,482,534,500,254,494,748
1000,520,509,485,266,477,743
1000,479,505,494,230,502,732
1000,472,512,491,235,497,732
1000,470,491,498,235,505,740
1000,506,533,514,284,460,744
1000,506,504,526,250,512,762
1000,484,490,480,244,484,728
1000,497,481,506,236,521,757
1000,500,510,520,262,490,752
1000,507,502,485,248,499,747
1000,501,487,504,244,504,748
1000,506,485,514,241,509,750
1000,489,505,472,234,498,732
1000,513,493,494,251,497,748
1000,526,505,492,260,497,757
1000,498,505,469,244,507,751
1000,542,487,498,262,490,752
1000,510,490,494,253,507,760
1000,490,524,501,266,497,763
1000,520,495,511,275,496,771
1000,513,475,512,245,515,760
1000,502,505,511,256,499,755
1000,508,495,501,246,507,753
1000,494,495,504,248,505,753
1000,506,488,487,255,485,740
1000,481,508,494,249,491,740
1000,498,513,501,276,481,757
1000,507,488,508,255,492,747
1000,504,481,503,248,500,748
1000,500,499,496,235,502,737
1000,513,549,502,272,477,749
1000,482,507,504,246,494,740
1000,502,501,495,247,497,744
1000,504,528,491,267,477,744
1000,517,549,506,287,484,771
1000,514,494,505,252,512,764
1000,512,538,462,267,467,734
1000,506,497,498,269,472,741
1000,531,500,510,260,508,768
1000,507,471,506,242,507,749
1000,513,496,478,248,493,741
1000,468,474,484,215,521,736
1000,481,480,507,247,493,740
1000,488,521,502,271,458,729
1000,535,520,506,295,476,771
1000,499,468,516,250,507,757
1000,501,488,501,263,491,754
1000,466,506,509,240,494,734
1000,513,524,484,267,485,752
1000,488,514,518,252,509,761
1000,490,491,486,247,493,740
1000,501,497,507,246,500,746
1000,502,468,481,239,496,735
1000,504,483,483,242,523,765
1000,518,501,479,252,483,735
1000,514,496,519,258,511,769
1000,486,510,500,241,509,750
1000,512,519,526,261,502,763
1000,514,502,478,258,487,745
1000,517,525,493,278,472,750
1000,528,496,522,268,504,772
1000,468,493,488,231,501,732
1000,512,498,502,265,491,756
1000,483,497,511,245,494,739
1000,481,520,496,250,492,742
1000,497,504,507,251,510,761
1000,527,521,522,276,506,782
1000,483,486,519,238,522,760
1000,497,487,524,239,536,775
1000,492,505,521,258,497,755
1000,477,453,500,220,534,754
1000,491,486,495,236,507,743
1000,478,466,494,218,514,732
1000,497,509,463,240,481,721
1000,509,536,498,268,479,747
1000,490,501,504,234,514,748
1000,484,511,467,256,476,732
1000,494,491,482,242,493,735
1000,469,509,487,232,500,732
1000,512,495,513,263,505,768
1000,482,496,506,250,496,746
1000,481,485,500,241,493,734
1000,492,487,508,243,494,737
1000,547,475,492,257,507,764
1000,476,494,495,233,497,730
1000,498,494,510,242,508,750
1000,518,492,529,266,518,784
1000,508,535,468,274,464,738
1000,496,509,474,261,482,743
1000,510,511,508,265,496,761
1000,500,522,503,258,488,746
1000,509,499,487,265,489,754
1000,500,507,512,257,498,755
1000,490,511,509,247,508,755
1000,485,514,507,245,506,751
1000,493,487,486,241,510,751
1000,519,517,517,272,476,748
1000,507,500,495,248,499,747
1000,502,521,507,267,489,756
1000,496,503,502,261,484,745
1000,504,512,511,257,497,754
1000,486,489,469,245,492,737
1000,526,492,523,252,521,773
1000,523,506,498,250,514,764
1000,509,492,493,255,487,742
1000,488,477,512,241,502,743
1000,500,481,507,252,506,758
1000,518,498,500,262,499,761
1000,517,496,484,246,518,764
1000,495,533,513,254,497,751
1000,485,514,480,244,486,730
1000,489,502,518,248,494,742
1000,484,514,503,242,503,745
1000,479,484,514,229,526,755
1000,503,496,513,241,505,746
1000,516,528,513,280,483,763
1000,531,509,511,263,509,772
1000,491,509,530,253,511,764
1000,479,497,505,249,484,733
1000,492,496,509,236,524,760
1000,515,507,490,243,500,743
1000,509,493,511,245,529,774
1000,497,505,499,247,483,730
1000,496,482,493,231,506,737
1000,469,500,475,240,491,731
1000,502,481,532,252,532,784
1000,491,473,509,236,520,756
1000,481,488,473,244,485,729
1000,511,503,537,268,502,770
1000,514,527,520,257,515,772
1000,512,471,497,238,514,752
1000,497,517,523,247,525,772
1000,491,494,482,247,489,736
1000,483,527,501,253,482,735
1000,488,477,489,228,514,742
1000,528,464,497,235,516,751
1000,481,492,536,240,517,757
1000,491,500,514,242,515,757
1000,491,503,489,238,506,744
1000,510,511,496,241,495,736
1000,495,490,489,247,499,746
1000,505,520,502,259,478,737
1000,488,499,498,245,511,756
1000,497,493,508,242,517,759
1000,517,490,527,241,532,773
1000,506,487,502,254,494,748
1000,506,493,510,249,522,771
1000,483,496,497,242,499,741
1000,471,506,517,252,475,727
1000,491,506,498,242,500,742
1000,504,510,524,262,506,768
1000,518,486,516,245,508,753
1000,476,492,483,244,481,725
1000,501,514,489,257,495,752
1000,497,483,482,231,501,732
1000,489,480,483,237,494,731
1000,504,534,499,259,510,769
1000,499,500,490,244,513,757
1000,489,508,492,251,498,749
1000,514,529,506,277,499,776
1000,511,480,508,245,522,767
1000,504,476,512,236,540,776
1000,500,496,502,246,499,745
1000,496,519,506,254,503,757
1000,491,507,504,248,500,748
1000,518,496,502,256,504,760
1000,494,508,492,258,477,735
1000,525,486,520,268,508,776
1000,494,504,488,263,471,734
1000,508,511,507,266,480,746
1000,528,498,474,267,471,738
1000,508,490,518,254,503,757
1000,504,491,504,258,498,756
1000,500,514,499,265,492,757
1000,500,502,479,235,505,740
1000,486,511,497,234,525,759
1000,477,496,523,241,498,739
1000,518,499,503,270,492,762
1000,490,488,474,236,487,723
1000,500,467,496,228,514,742
1000,487,534,498,257,491,748
1000,534,495,480,258,493,751
1000,478,510,484,249,492,741
1000,502,519,530,258,519,777
1000,505,508,484,258,485,743
1000,484,527,487,260,477,737
1000,501,473,498,239,508,747
1000,524,512,491,260,506,766
1000,490,508,492,261,459,720
1000,489,511,470,243,493,736
1000,502,513,495,250,500,750
1000,505,463,528,233,528,761
1000,499,524,515,262,494,756
1000,492,501,531,235,539,774
1000,467,542,493,243,491,734
1000,503,523,484,270,464,734
1000,504,494,490,252,517,769
1000,530,475,508,254,520,774
1000,492,482,497,236,521,757
1000,487,511,498,261,471,732
1000,480,522,493,255,475,730
1000,519,503,490,247,509,756
1000,481,507,492,248,489,737
1000,515,494,508,254,517,771
1000,510,493,475,247,501,748
1000,467,482,511,233,510,743
1000,518,481,508,258,506,764
1000,494,539,497,272,484,756
1000,535,496,510,247,523,770
1000,479,499,486,247,486,733
1000,517,520,505,267,492,759
1000,484,508,507,231,511,742
1000,505,511,472,264,480,744
1000,478,477,503,243,496,739
1000,491,522,499,245,497,742
1000,513,476,498,248,508,756
1000,507,488,496,242,515,757
1000,505,469,483,251,504,755
1000,516,526,501,276,478,754
1000,488,503,505,244,499,743
1000,493,505,508,262,490,752
1000,495,493,519,239,509,748
1000,520,512,508,253,519,772
1000,496,514,521,257,492,749
1000,497,502,504,267,472,739
1000,486,474,485,243,501,744
1000,492,457,511,235,517,752
1000,488,519,499,261,472,733
1000,514,523,498,266,502,768
1000,495,507,502,264,486,750
1000,486,516,545,255,524,779
1000,479,523,490,240,508,748
1000,497,517,507,262,500,762
1000,492,459,490,221,526,747
1000,476,513,497,234,495,729
1000,517,512,487,256,497,753
1000,499,491,498,229,510,739
1000,492,490,495,262,493,755
1000,524,487,498,257,499,756
1000,525,519,485,286,482,768
1000,515,522,522,257,536,793
1000,502,500,480,252,498,750
1000,482,478,475,241,470,711
1000,506,493,499,239,525,764
1000,466,488,474,223,504,727
1000,519,489,473,252,502,754
1000,482,535,519,246,493,739
1000,513,487,504,252,496,748
1000,511,499,513,263,503,766
1000,525,493,512,262,502,764
1000,496,503,515,251,494,745
1000,510,510,494,255,495,750
1000,482,525,527,250,500,750
1000,531,516,530,273,511,784
1000,505,486,524,242,524,766
1000,495,473,493,231,508,739
1000,491,481,491,237,504,741
1000,521,465,528,228,547,775
1000,499,484,521,241,531,772
1000,510,460,518,245,529,774
1000,487,496,512,241,525,766
1000,483,540,536,236,525,761
1000,513,506,478,258,491,749
1000,501,493,504,255,503,758
1000,516,495,501,258,496,754
1000,513,521,491,279,485,764
1000,517,476,488,254,495,749
1000,498,503,480,247,497,744
1000,479,512,484,244,485,729
1000,507,497,486,268,480,748
1000,482,481,500,232,514,746
1000,517,521,500,266,501,767
1000,533,507,498,264,500,764
1000,513,485,514,243,522,765
1000,496,501,510,258,500,758
1000,502,514,488,275,459,734
1000,512,506,493,247,510,757
1000,487,482,451,251,485,736
1000,482,493,513,226,522,748
1000,480,532,526,263,494,757
1000,486,488,485,226,497,723
1000,493,529,537,259,509,768
1000,490,495,521,245,503,748
1000,489,471,488,227,499,726
1000,493,536,481,259,484,743
1000,502,496,473,251,473,724
1000,499,501,514,246,516,762
1000,532,495,513,283,489,772
1000,508,508,504,277,481,758
1000,505,500,509,257,508,765
1000,518,529,509,275,490,765
1000,503,507,488,255,493,748
1000,477,486,504,238,511,749
1000,502,495,486,243,504,747
1000,471,493,507,240,503,743
1000,521,473,478,247,500,747
1000,529,483,492,246,514,760
1000,535,480,524,258,504,762
1000,484,504,500,254,493,747
1000,487,513,520,242,521,763
1000,495,503,501,267,491,758
1000,505,502,502,263,484,747
1000,499,520,503,264,485,749
1000,513,494,503,243,512,755
1000,513,498,521,257,517,774
1000,491,506,520,238,514,752
1000,511,489,487,258,496,754
1000,498,465,498,215,523,738
1000,514,517,534,267,505,772
1000,510,489,478,236,516,752
1000,532,488,502,267,494,761
1000,500,504,481,249,490,739
1000,491,511,502,254,487,741
1000,499,503,502,246,514,760
1000,492,479,500,234,519,753
1000,497,487,493,239,497,736
1000,455,502,513,224,523,747
1000,510,511,512,271,492,763
1000,499,506,471,251,491,742
1000,504,489,487,250,490,740
1000,510,515,495,255,505,760
1000,541,508,502,267,504,771
1000,528,480,495,259,499,758
1000,526,528,475,283,459,742
1000,503,495,532,251,513,764
1000,513,487,503,247,528,775
1000,517,499,522,250,525,775
1000,487,484,497,229,516,745
1000,477,493,492,237,501,738
1000,529,481,510,243,530,773
1000,479,532,485,259,472,731
1000,508,501,502,256,499,755
1000,491,464,488,225,508,733
1000,478,502,524,237,516,753
1000,504,497,499,257,485,742
1000,536,510,514,264,517,781
1000,493,545,520,275,492,767
1000,510,499,488,271,493,764
1000,469,529,489,245,492,737
1000,486,508,481,242,503,745
1000,514,470,503,233,530,763
1000,517,494,516,250,508,758
1000,485,493,508,235,511,746
1000,523,482,514,251,511,762
1000,511,501,487,261,489,750
1000,481,472,497,224,521,745
1000,527,522,492,277,473,750
1000,476,498,492,247,482,729
1000,485,505,501,245,504,749
1000,502,500,521,244,528,772
1000,486,495,536,242,529,771
1000,487,531,498,251,483,734
1000,483,478,521,228,535,763
1000,523,512,498,264,495,759
1000,529,491,492,267,506,773
1000,508,480,527,250,505,755
1000,507,466,496,237,523,760
1000,505,500,480,259,479,738
1000,509,501,488,262,503,765
1000,522,508,511,258,501,759
1000,517,502,493,261,490,751
1000,506,516,496,259,475,734
1000,512,523,508,264,494,758
1000,510,500,497,265,476,741
1000,509,507,495,248,502,750
1000,510,498,505,261,506,767
1000,494,500,493,244,497,741
1000,498,509,488,246,490,736
1000,488,502,492,244,498,742
1000,492,497,489,243,503,746
1000,506,520,522,260,503,763
1000,499,498,518,255,509,764
1000,485,522,500,269,469,738
1000,490,499,488,244,502,746
1000,505,498,511,244,504,748
1000,501,476,495,237,509,746
1000,473,509,491,241,511,752
1000,503,508,490,258,489,747
1000,508,515,486,249,492,741
1000,508,487,500,239,516,755
1000,495,487,499,252,500,752
1000,493,518,519,267,491,758
1000,505,549,502,266,479,745
1000,507,510,527,264,490,754
1000,513,505,536,260,522,782
1000,534,508,517,279,486,765
1000,505,510,512,258,511,769
1000,503,481,503,233,516,749
1000,498,489,517,231,533,764
1000,501,496,524,249,508,757
1000,489,499,485,259,475,734
1000,493,485,485,250,483,733
1000,497,469,507,228,514,742
1000,498,498,499,251,497,748
1000,483,495,512,247,501,748
1000,502,519,477,256,482,738
1000,509,517,514,267,500,767
1000,510,497,490,238,510,748
1000,470,483,502,232,491,723
1000,502,515,472,259,472,731
1000,528,494,473,253,496,749
1000,491,495,493,252,496,748
1000,520,505,513,251,523,774
1000,489,489,526,248,497,745
1000,501,501,509,264,483,747
1000,470,522,484,241,491,732
1000,514,489,509,243,515,758
1000,505,507,524,255,499,754
1000,510,504,506,255,525,780
1000,503,511,485,263,484,747
1000,482,504,491,230,498,728
1000,519,527,517,267,506,773
1000,511,493,484,257,495,752
1000,491,489,500,252,497,749
1000,492,495,518,237,516,753
1000,493,516,478,248,492,740
1000,491,510,516,254,507,761
1000,499,509,493,259,477,736
1000,483,528,482,249,489,738
1000,493,516,512,260,485,745
1000,495,518,493,252,488,740
1000,498,494,524,249,508,757
1000,465,488,474,228,492,720
1000,507,520,463,272,463,735
1000,482,491,496,229,512,741
1000,493,498,511,249,498,747
1000,490,515,510,249,498,747
1000,462,486,488,229,479,708
1000,524,511,495,263,506,769
1000,491,499,519,271,475,746
1000,495,493,493,255,477,732
1000,512,512,514,267,489,756
1000,475,496,514,232,501,733
1000,524,490,520,264,506,770
1000,504,507,529,255,509,764
1000,467,486,495,217,518,735
1000,493,489,515,236,528,764
1000,498,532,488,271,478,749
1000,497,503,524,253,510,763
1000,509,483,501,232,527,759
1000,474,494,535,238,507,745
1000,524,498,496,273,484,757
1000,493,489,524,242,517,759
1000,489,489,490,234,500,734
1000,505,527,501,262,493,755
1000,513,504,508,265,509,774
1000,494,497,478,244,500,744
1000,482,483,490,231,504,735
1000,513,484,511,249,519,768
1000,496,500,510,245,510,755
1000,506,487,513,236,514,750
1000,494,488,498,233,512,745
1000,498,513,472,265,482,747
1000,487,482,523,256,500,756
1000,505,510,486,264,480,744
1000,492,500,468,236,507,743
1000,516,474,491,239,503,742
1000,504,474,499,237,511,748
1000,522,505,489,269,493,762
1000,507,468,485,232,521,753
1000,526,485,497,240,521,761
1000,516,499,489,263,476,739
1000,497,478,498,232,520,752
1000,481,510,484,249,483,732
1000,493,478,495,228,530,758
1000,473,528,497,243,482,725
1000,490,506,481,245,506,751
1000,495,485,527,244,520,764
1000,485,489,509,226,525,751
1000,489,491,507,243,500,743
1000,500,487,507,248,498,746
1000,496,491,519,240,519,759
1000,484,504,520,233,526,759
1000,498,473,507,225,519,744
1000,506,486,517,244,517,761
1000,520,503,504,255,515,770
1000,503,493,486,245,500,745
1000,501,497,491,246,504,750
1000,477,529,511,239,499,738
1000,484,510,525,240,519,759
1000,497,502,474,252,475,727
1000,516,491,523,246,520,766
1000,498,498,490,241,510,751
1000,511,475,464,253,478,731
1000,495,516,499,251,496,747
1000,472,504,448,243,468,711
1000,507,490,471,240,499,739
1000,525,494,515,276,495,771
1000,487,520,501,250,504,754
1000,486,490,497,225,519,744
1000,512,515,513,253,516,769
1000,482,484,502,239,500,739
1000,493,482,479,238,495,733
1000,500,499,520,255,516,771
1000,479,500,492,246,481,727
1000,477,498,535,226,533,759
1000,506,482,490,244,502,746
1000,512,502,529,252,525,777
1000,474,486,483,232,491,723
1000,493,471,487,234,510,744
1000,480,496,465,246,477,723
1000,515,513,513,270,489,759
1000,506,532,478,255,477,732
1000,478,509,490,223,513,736
1000,495,503,471,251,492,743
1000,493,499,539,250,505,755
1000,482,502,498,248,495,743
1000,504,500,487,239,511,750
1000,502,507,485,244,499,743
1000,523,522,504,284,467,751
1000,477,495,480,241,484,725
1000,490,459,481,222,511,733
1000,496,497,495,243,493,736
1000,489,495,495,227,535,762
1000,496,546,528,265,510,775
1000,476,504,514,240,501,741
1000,478,512,508,238,504,742
1000,462,493,518,225,515,740
1000,518,507,535,266,515,781
1000,513,501,511,269,499,768
1000,502,506,490,257,504,761
1000,491,516,487,257,486,743
1000,488,499,518,249,505,754
1000,505,532,487,278,467,745
1000,507,497,508,262,487,749
1000,489,499,509,248,507,755
1000,504,538,481,270,468,738
1000,500,509,525,262,522,784
1000,479,501,488,237,478,715
1000,511,505,488,253,475,728
1000,470,492,512,238,510,748
1000,500,492,505,232,514,746
1000,483,517,524,241,515,756
1000,495,521,476,260,458,718
1000,478,500,535,244,522,766
1000,498,506,522,252,500,752
1000,517,492,488,236,509,745
1000,496,485,477,222,496,718
1000,511,510,497,258,492,750
1000,489,496,506,232,498,730
1000,505,487,495,258,485,743
1000,492,494,497,246,496,742
1000,518,521,487,265,503,768
1000,504,475,460,254,473,727
1000,512,499,525,258,514,772
1000,501,494,499,236,524,760
1000,506,478,519,244,504,748
1000,511,491,474,249,476,725
1000,512,531,495,271,487,758
1000,494,464,507,222,539,761
1000,520,493,508,251,509,760
1000,503,494,506,246,497,743
1000,519,506,523,263,513,776
1000,503,531,512,253,513,766
1000,476,526,503,245,489,734
1000,518,476,493,250,504,754
1000,504,510,467,253,486,739
1000,511,519,486,258,489,747
1000,513,488,512,249,513,762
1000,518,519,506,275,493,768
1000,488,486,471,226,510,736
1000,483,501,493,258,473,731
1000,515,498,533,250,539,789
1000,491,510,496,253,494,747
1000,489,501,512,234,519,753
1000,492,499,506,226,523,749
1000,490,515,518,264,507,771
1000,481,496,490,242,493,735
1000,472,497,521,229,531,760
1000,502,519,467,266,460,726
1000,494,471,485,227,508,735
1000,493,506,503,239,508,747
1000,504,522,530,267,502,769
1000,523,497,511,245,510,755
1000,504,477,487,242,495,737
1000,496,524,508,258,471,729
1000,532,511,503,280,494,774
1000,515,504,487,247,500,747
1000,499,503,489,270,471,741
1000,488,489,510,230,509,739
1000,483,498,531,238,530,768
1000,470,490,496,219,529,748
1000,483,484,472,247,472,719
1000,518,530,502,280,487,767
1000,468,497,508,241,501,742
1000,528,506,505,272,500,772
1000,508,508,522,268,489,757
1000,502,492,502,252,496,748
1000,504,499,508,246,510,756
1000,484,484,458,246,469,715
1000,516,465,514,231,517,748
1000,500,492,511,245,514,759
1000,476,531,498,256,477,733
1000,505,523,489,261,489,750
1000,524,515,502,277,480,757
1000,509,493,506,254,504,758
1000,515,513,512,253,513,766
1000,499,503,524,255,517,772
1000,507,491,510,244,508,752
1000,495,491,492,243,506,749
1000,489,528,504,265,473,738
1000,494,498,494,258,484,742
1000,525,507,507,268,503,771
1000,531,516,501,278,494,772
1000,495,492,522,241,510,751
1000,517,512,478,259,491,750
1000,516,507,527,256,515,771
1000,499,496,505,247,503,750
1000,485,484,477,244,484,728
1000,493,491,502,248,500,748
1000,489,500,525,251,502,753
1000,515,515,506,255,496,751
1000,493,511,499,255,481,736
1000,518,495,484,253,513,766
1000,491,495,497,242,496,738
1000,505,487,516,239,506,745
1000,474,498,495,246,495,741
1000,496,523,507,260,491,751
1000,507,475,505,240,511,751
1000,489,498,512,246,492,738
1000,487,501,516,242,521,763
1000,504,473,502,237,516,753
1000,492,517,488,248,491,739
1000,482,473,503,227,511,738
1000,498,498,478,263,473,736
1000,515,490,480,251,511,762
1000,509,495,447,257,468,725
1000,504,494,491,257,488,745
1000,510,482,497,229,527,756
1000,503,501,499,244,519,763
1000,489,496,492,256,495,751
1000,490,515,493,263,489,752
1000,522,498,490,253,509,762
1000,517,496,480,251,505,756
1000,495,507,474,248,488,736
1000,505,476,501,240,506,746
1000,485,484,508,238,505,743
1000,469,475,522,228,505,733
1000,498,521,493,256,487,743
1000,507,487,516,242,496,738
1000,518,513,492,260,495,755
1000,509,499,492,250,513,763
1000,490,477,469,221,503,724
1000,480,508,516,243,503,746
1000,484,511,499,232,508,740
1000,484,517,484,250,485,735
1000,515,532,500,266,484,750
1000,509,503,491,259,487,746
1000,462,479,493,220,503,723
1000,504,489,511,247,508,755
1000,504,536,492,274,478,752
1000,506,535,504,270,485,755
1000,505,528,478,260,479,739
1000,484,539,516,263,487,750
1000,524,517,497,269,496,765
1000,485,493,526,237,509,746
1000,503,495,527,247,511,758
1000,476,513,512,246,494,740
1000,476,464,495,229,505,734
1000,513,518,501,263,498,761
1000,501,482,469,256,488,744
1000,490,512,504,248,500,748
1000,505,505,486,258,477,735
1000,524,488,509,255,506,761
1000,500,529,499,271,468,739
1000,520,487,501,262,504,766
1000,496,486,504,245,499,744
1000,490,497,525,239,529,768
1000,487,506,512,244,503,747
1000,474,498,503,246,508,754
1000,492,506,515,243,505,748
1000,495,511,509,257,499,756
1000,524,523,476,278,467,745
1000,505,512,521,246,541,787
1000,480,501,494,248,483,731
1000,522,501,522,266,506,772
1000,499,525,522,260,498,758
1000,512,468,504,238,533,771
1000,501,497,463,245,477,722
1000,491,484,495,240,509,749
1000,479,500,508,232,509,741
1000,481,502,468,237,492,729
1000,498,485,502,237,508,745
1000,484,499,515,228,524,752
1000,487,495,491,247,486,733
1000,501,500,489,248,504,752
1000,490,487,467,234,497,731
1000,488,485,470,216,511,727
1000,510,517,517,268,490,758
1000,511,486,510,250,519,769
1000,515,522,493,271,478,749
1000,493,522,489,259,500,759
1000,508,512,488,245,507,752
1000,486,507,511,250,501,751
1000,530,493,527,259,522,781
1000,492,501,509,236,514,750
1000,517,496,510,258,508,766
1000,479,515,516,240,510,750
1000,510,494,491,257,499,756
1000,484,484,489,233,504,737
1000,514,517,512,260,495,755
1000,474,508,510,240,491,731
1000,489,506,508,250,497,747
1000,520,482,520,260,497,757
1000,514,502,511,267,504,771
1000,479,519,493,260,493,753
1000,504,512,507,249,497,746
1000,500,494,492,250,507,757
1000,520,508,516,246,536,782
1000,497,521,498,241,501,742
1000,498,501,505,259,485,744
1000,513,519,504,272,484,756
1000,519,518,519,277,494,771
1000,530,500,493,263,510,773
1000,513,490,487,244,503,747
1000,510,504,518,256,501,757
1000,487,519,491,270,469,739
1000,501,533,515,269,491,760
1000,472,480,500,240,504,744
1000,510,527,516,278,481,759
1000,501,530,492,276,474,750
1000,480,511,544,254,511,765
1000,486,489,501,236,508,744
1000,529,505,501,274,476,750
1000,494,520,461,260,475,735
1000,486,512,477,251,471,722
1000,480,516,495,231,513,744
1000,483,506,479,247,483,730
1000,532,494,508,257,511,768
1000,480,510,520,249,502,751
1000,503,470,490,222,519,741
1000,504,491,489,260,489,749
1000,508,524,487,246,513,759
1000,505,479,503,237,502,739
1000,505,500,530,257,507,764
1000,487,492,527,227,524,751
1000,497,475,496,236,520,756
1000,465,489,514,222,534,756
1000,504,515,515,268,486,754
1000,505,494,494,229,514,743
1000,491,493,510,254,494,748
1000,514,480,516,253,522,775
1000,514,509,536,253,520,773
1000,498,510,486,265,483,748
1000,524,486,501,240,528,768
1000,519,493,491,256,495,751
1000,496,511,487,252,471,723
1000,492,483,492,248,481,729
1000,501,478,502,236,512,748
1000,517,484,489,249,495,744
1000,488,511,494,254,482,736
1000,496,488,512,241,512,753
1000,501,474,487,239,517,756
1000,499,501,485,251,508,759
1000,515,525,519,273,489,762
1000,485,520,489,247,492,739
1000,505,503,495,270,489,759
1000,479,487,519,236,497,733
1000,488,500,520,247,502,749
1000,522,509,502,264,493,757
1000,515,476,484,258,484,742
1000,513,510,492,273,471,744
1000,522,511,496,264,502,766
1000,501,514,508,254,493,747
1000,477,489,516,233,511,744
1000,468,513,510,239,507,746
1000,483,479,481,227,498,725
1000,491,509,482,236,492,728
1000,490,494,505,242,497,739
1000,465,531,498,246,499,745
1000,541,524,484,287,478,765
1000,499,492,506,242,527,769
1000,500,513,500,251,496,747
1000,499,495,519,239,520,759
1000,492,499,507,249,505,754
1000,488,507,486,241,503,744
1000,498,505,482,262,466,728
1000,497,498,502,229,519,748
1000,490,502,490,244,504,748
1000,533,485,489,250,515,765
1000,500,480,502,251,510,761
1000,469,490,510,220,515,735
1000,499,471,528,235,532,767
1000,468,500,511,240,482,722
1000,536,500,505,247,521,768
1000,500,515,490,256,495,751
1000,484,509,489,221,523,744
1000,522,489,491,248,515,763
1000,494,498,516,241,518,759
1000,494,513,514,259,508,767
1000,513,509,502,264,504,768
1000,503,494,520,250,516,766
1000,502,509,489,259,480,739
1000,490,494,495,230,500,730
1000,493,502,544,236,545,781
1000,500,490,480,241,505,746
1000,506,494,471,244,499,743
1000,519,496,509,260,500,760
1000,484,465,510,236,515,751
1000,523,489,495,254,510,764
1000,502,511,520,247,519,766
1000,488,514,484,240,512,752
1000,494,520,491,259,486,745
1000,487,493,487,246,499,745
1000,497,497,470,228,508,736
1000,482,501,483,229,506,735
1000,497,515,499,270,475,745
1000,512,535,531,269,490,759
1000,512,512,502,265,500,765
1000,496,515,475,260,487,747
1000,523,494,473,265,477,742
1000,512,485,485,244,500,744
1000,500,516,476,264,478,742
1000,490,520,529,267,501,768
1000,498,523,504,267,469,736
1000,513,521,503,264,492,756
1000,506,484,513,251,508,759
1000,516,479,482,254,486,740
1000,478,513,500,253,468,721
1000,486,487,510,241,502,743
1000,487,462,483,229,512,741
1000,500,493,507,246,522,768
1000,518,517,525,272,505,777
1000,502,484,504,242,509,751
1000,475,498,519,240,514,754
1000,507,521,518,259,510,769
1000,494,504,490,260,485,745
1000,512,524,493,260,490,750
1000,482,481,478,234,506,740
1000,490,534,523,261,488,749
1000,483,503,495,247,492,739
1000,508,495,488,254,487,741
1000,508,508,510,267,495,762
1000,512,510,507,245,496,741
1000,488,502,477,244,485,729
1000,495,510,522,252,505,757
1000,532,478,478,246,521,767
1000,522,511,500,273,492,765
1000,517,483,498,254,511,765
1000,500,535,500,271,479,750
1000,515,490,488,246,514,760
1000,503,495,504,260,499,759
1000,504,494,492,252,497,749
1000,523,507,498,252,515,767
1000,470,488,506,230,504,734
1000,474,515,487,250,475,725
1000,517,521,484,261,501,762
1000,503,510,493,262,493,755
1000,518,478,503,242,501,743
1000,499,507,504,242,510,752
1000,485,478,500,237,512,749
1000,469,468,498,201,548,749
1000,521,509,520,256,520,776
1000,483,479,505,226,514,740
1000,494,488,491,248,502,750
1000,488,494,480,247,485,732
1000,528,502,500,268,505,773
1000,510,512,498,248,509,757
1000,534,513,530,273,509,782
1000,494,480,503,235,519,754
1000,489,505,481,239,489,728
1000,479,471,507,228,507,735
1000,529,504,490,267,497,764
1000,494,491,484,252,472,724
1000,510,515,493,267,489,756
1000,496,483,504,234,518,752
1000,515,498,489,260,479,739
1000,490,484,530,240,514,754
1000,512,496,501,265,497,762
1000,493,510,498,256,475,731
1000,531,496,493,282,477,759
1000,487,472,466,228,502,730
1000,504,510,493,258,502,760
1000,496,480,510,249,509,758
1000,493,499,481,256,475,731
1000,488,497,522,232,553,785
1000,479,501,502,251,494,745
1000,483,467,506,214,520,734
1000,527,493,488,262,501,763
1000,483,489,490,241,489,730
1000,486,506,500,244,486,730
1000,471,481,491,228,504,732
1000,516,519,509,260,503,763
1000,490,493,498,250,481,731
1000,522,491,498,254,506,760
1000,486,516,508,251,496,747
1000,492,508,497,241,498,739
1000,488,499,476,251,488,739
1000,506,515,516,260,499,759
1000,509,527,509,275,490,765
1000,502,507,515,257,513,770
1000,509,520,499,275,477,752
1000,480,504,488,242,492,734
1000,489,500,515,254,505,759
1000,504,503,494,250,511,761
1000,508,522,504,273,463,736
1000,484,492,514,232,526,758
1000,508,506,479,269,482,751
1000,513,512,498,276,487,763
1000,494,490,501,242,504,746
1000,516,487,482,251,491,742
1000,502,482,480,244,490,734
1000,467,521,500,237,485,722
1000,505,492,508,248,517,765
1000,503,510,507,256,491,747
1000,481,492,483,236,497,733
1000,527,491,504,256,494,750
1000,487,476,509,206,545,751
1000,486,513,508,270,471,741
1000,484,504,515,257,493,750
1000,502,518,513,273,486,759
1000,500,501,539,245,524,769
1000,521,492,489,259,511,770
1000,490,505,479,265,462,727
1000,520,502,507,276,489,765
1000,480,499,465,229,493,722
1000,490,494,509,241,496,737
1000,513,473,508,247,516,763
1000,521,464,470,245,505,750
1000,499,489,527,251,499,750
1000,500,506,513,259,511,770
1000,494,504,504,254,502,756
1000,461,531,534,247,505,752
1000,481,487,532,237,521,758
1000,501,484,496,251,496,747
1000,516,548,497,281,474,755
1000,503,486,517,234,526,760
1000,508,523,496,271,471,742
1000,515,476,502,249,506,755
1000,483,468,509,239,493,732
1000,510,502,505,248,508,756
1000,493,498,500,243,493,736
1000,493,495,529,240,513,753
1000,502,502,531,239,521,760
1000,521,521,503,267,502,769
1000,469,478,500,230,499,729
1000,502,477,488,245,495,740
1000,471,510,487,251,476,727
1000,489,515,481,253,486,739
1000,523,524,509,261,507,768
1000,522,475,506,250,521,771
1000,500,508,485,243,490,733
1000,498,522,522,257,504,761
1000,527,472,523,252,514,766
1000,482,494,516,232,517,749
1000,508,487,494,263,483,746
1000,474,490,501,243,484,727
1000,521,492,517,261,506,767
1000,474,495,518,237,509,746
1000,501,499,481,251,485,736
1000,505,514,487,247,506,753
1000,496,509,514,253,502,755
1000,511,479,486,237,513,750
1000,512,524,491,266,471,737
1000,492,521,484,256,488,744
1000,494,463,527,228,532,760
1000,481,493,496,244,508,752
1000,490,477,488,226,509,735
1000,463,532,504,263,475,738
1000,530,511,501,277,494,771
1000,488,493,526,247,511,758
1000,522,497,493,255,495,750
1000,498,501,498,240,510,750
1000,508,487,489,245,492,737
1000,524,510,462,259,485,744
1000,488,475,518,225,518,743
1000,505,507,500,264,482,746
1000,527,507,509,272,491,763
1000,486,504,480,252,479,731
1000,522,491,514,253,512,765
1000,519,507,514,258,516,774
1000,492,504,498,256,485,741
1000,493,523,519,261,491,752
1000,498,513,520,268,500,768
1000,488,485,495,234,496,730
1000,505,492,531,245,516,761
1000,496,472,501,240,504,744
1000,520,492,488,264,493,757
1000,504,489,508,243,525,768
1000,508,495,510,266,497,763
1000,523,506,492,273,491,764
1000,515,503,498,261,489,750
1000,514,496,491,258,505,763
1000,501,478,503,241,489,730
1000,481,504,499,241,499,740
1000,509,483,490,250,495,745
1000,522,473,475,240,510,750
1000,516,471,506,254,506,760
1000,485,496,513,230,524,754
1000,495,515,508,253,487,740
1000,492,516,501,254,492,746
1000,489,497,522,230,527,757
1000,491,498,493,249,482,731
1000,498,510,508,263,496,759
1000,503,499,504,258,488,746
1000,534,474,503,243,525,768
1000,517,492,496,261,505,766
1000,496,525,496,266,468,734
1000,482,514,505,237,513,750
1000,506,472,462,235,488,723
1000,493,490,508,254,497,751
1000,501,468,469,226,502,728
1000,501,508,467,245,491,736
1000,466,479,481,213,493,706
1000,491,503,504,235,513,748
1000,494,476,503,233,516,749
1000,505,492,485,250,498,748
1000,504,521,486,262,487,749
1000,507,503,500,259,502,761
1000,508,485,495,252,497,749
1000,478,497,479,249,484,733
1000,517,501,522,267,509,776
1000,484,486,515,248,504,752
1000,486,477,486,217,519,736
1000,505,511,495,268,479,747
1000,522,486,513,260,503,763
1000,515,486,533,251,521,772
1000,492,494,488,254,484,738
1000,499,512,478,263,487,750
1000,531,518,495,279,478,757
1000,510,529,495,263,495,758
1000,487,510,518,253,496,749
1000,507,488,504,247,510,757
1000,509,491,500,235,516,751
1000,514,527,486,269,471,740
1000,490,484,517,231,505,736
1000,509,527,514,271,490,761
1000,495,491,496,244,503,747
1000,511,497,529,240,539,779
1000,535,522,506,284,476,760
1000,491,507,508,245,504,749
1000,500,482,495,252,498,750
1000,544,499,471,271,488,759
1000,499,492,509,246,528,774
1000,479,517,485,249,478,727
1000,493,467,502,237,515,752
1000,470,499,507,240,514,754
1000,507,501,488,270,478,748
1000,523,502,501,260,493,753
1000,489,508,489,260,481,741
1000,492,477,470,246,498,744
1000,501,495,493,253,492,745
1000,518,496,492,251,498,749
1000,490,496,494,251,503,754
1000,495,485,477,251,470,721
1000,466,509,530,234,507,741
1000,496,489,511,241,518,759
1000,485,510,521,244,537,781
1000,520,511,521,271,503,774
1000,506,489,497,229,526,755
1000,485,502,498,238,504,742
1000,484,508,500,254,478,732
1000,520,499,495,260,503,763
1000,489,494,522,242,511,753
1000,510,490,510,253,503,756
1000,501,487,516,252,498,750
1000,511,506,500,265,495,760
1000,510,489,507,237,529,766
1000,478,498,519,249,501,750
1000,484,501,500,235,502,737
1000,472,503,495,228,518,746
1000,482,506,511,249,495,744
1000,490,486,491,249,497,746
1000,479,476,507,227,508,735
1000,491,513,506,255,497,752
1000,500,501,505,257,490,747
1000,496,495,476,244,496,740
1000,489,521,496,266,470,736
1000,483,495,488,249,494,743
1000,498,491,482,256,485,741
1000,488,500,493,241,490,731
1000,486,506,493,248,501,749
1000,474,520,493,250,487,737
1000,501,505,519,256,503,759
1000,466,481,499,225,505,730
1000,503,536,525,282,483,765
1000,498,511,529,251,504,755
1000,484,506,502,239,494,733
1000,502,497,515,253,504,757
1000,499,497,505,253,507,760
1000,499,495,503,252,502,754
1000,506,499,484,248,500,748
1000,478,521,540,253,509,762
1000,487,517,497,258,479,737
1000,487,472,507,238,520,758
1000,500,487,506,245,512,757
1000,496,485,524,245,513,758
1000,509,508,518,262,509,771
1000,519,489,515,267,512,779
1000,488,489,517,231,519,750
1000,523,500,492,255,498,753
1000,532,485,530,243,536,779
1000,502,514,491,258,486,744
1000,500,507,463,249,475,724
1000,520,478,529,251,529,780
1000,493,489,519,245,507,752
1000,490,502,474,255,478,733
1000,471,473,533,212,535,747
1000,500,519,473,264,472,736
1000,501,477,519,243,522,765
1000,504,491,511,244,521,765
1000,503,488,493,260,491,751
1000,519,509,512,257,514,771
1000,517,522,492,272,474,746
1000,510,486,501,245,526,771
1000,489,504,511,246,511,757
1000,498,490,481,252,484,736
1000,500,496,524,237,525,762
1000,527,510,514,269,491,760
1000,502,493,477,252,474,726
1000,501,509,495,268,487,755
1000,504,512,491,253,493,746
1000,515,477,455,236,495,731
1000,498,503,493,246,492,738
1000,510,481,481,251,501,752
1000,464,505,486,223,498,721
1000,496,531,507,271,502,773
1000,460,492,527,231,521,752
1000,508,494,516,264,503,767
1000,545,509,492,271,516,787
1000,485,527,497,251,493,744
1000,500,509,508,261,493,754
1000,508,549,516,287,484,771
1000,507,490,515,261,499,760
1000,494,488,517,242,503,745
1000,496,489,490,252,485,737
1000,491,492,493,240,500,740
1000,474,494,499,238,502,740
1000,540,494,497,260,509,769
1000,515,520,508,270,497,767
1000,505,497,478,247,505,752
1000,500,495,542,244,527,771
1000,503,496,508,246,533,779
1000,491,494,533,244,521,765
1000,526,491,491,246,505,751
1000,490,490,475,247,484,731
1000,482,489,502,232,504,736
1000,510,494,503,241,514,755
1000,498,507,482,264,468,732
1000,529,498,490,256,506,762
1000,501,461,487,232,514,746
1000,508,503,488,254,497,751
1000,526,506,489,273,477,750
1000,491,487,514,229,523,752
1000,476,523,526,239,521,760
1000,507,491,489,243,497,740
1000,495,513,481,254,478,732
1000,487,499,492,244,494,738
1000,478,496,493,221,513,734
1000,506,505,520,270,497,767
1000,508,486,509,247,511,758
1000,492,503,520,244,520,764
1000,476,509,496,258,479,737
1000,468,489,511,222,522,744
1000,505,492,486,250,495,745
1000,513,523,496,269,496,765
1000,517,515,488,286,461,747
1000,495,492,492,244,492,736
1000,489,516,499,256,481,737
1000,500,488,519,246,511,757
1000,493,488,520,252,510,762
1000,506,504,519,260,490,750
1000,500,519,492,258,497,755
1000,477,519,534,236,520,756
1000,521,503,492,261,498,759
1000,497,521,490,251,509,760
1000,492,493,525,238,508,746
1000,511,497,498,257,501,758
1000,487,498,498,238,520,758
1000,507,490,481,252,501,753
1000,483,478,497,220,508,728
1000,506,503,491,258,481,739
1000,513,487,490,252,497,749
1000,493,491,518,235,509,744
1000,501,493,490,242,491,733
1000,541,515,479,273,482,755
1000,527,508,494,277,477,754
1000,482,509,503,246,494,740
1000,491,529,468,251,487,738
1000,495,496,487,239,503,742
1000,487,512,505,246,504,750
1000,500,505,509,241,516,757
1000,524,485,494,243,520,763
1000,495,498,494,244,509,753
1000,458,532,502,247,488,735
1000,518,498,512,267,500,767
1000,492,518,522,248,501,749
1000,483,478,517,227,535,762
1000,474,499,499,247,498,745
1000,499,500,492,241,500,741
1000,485,487,503,240,511,751
1000,490,506,467,247,480,727
1000,503,513,535,251,519,770
1000,501,492,503,262,497,759
1000,500,512,494,245,497,742
1000,497,500,520,261,501,762
1000,466,517,516,231,506,737
1000,535,532,499,273,496,769
1000,460,517,493,233,489,722
1000,502,489,503,243,510,753
1000,496,479,497,234,516,750
1000,495,482,495,247,496,743
1000,509,504,497,252,495,747
1000,497,496,488,244,504,748
1000,485,493,508,243,482,725
1000,525,498,509,268,503,771
1000,503,498,493,242,505,747
1000,520,502,477,255,495,750
1000,506,480,503,247,500,747
1000,517,463,508,249,512,761
1000,502,495,487,249,500,749
1000,477,476,509,224,515,739
1000,520,484,519,254,502,756
1000,510,512,498,273,473,746
1000,508,477,480,243,515,758
1000,473,490,476,226,498,724
1000,500,519,493,254,488,742
1000,498,520,487,263,471,734
1000,490,507,515,240,513,753
1000,491,479,506,226,518,744
1000,514,486,494,243,513,756
1000,495,515,514,267,489,756
1000,494,498,488,231,492,723
1000,497,486,486,240,509,749
1000,506,489,514,242,523,765
1000,500,530,495,267,482,749
1000,508,512,518,255,507,762
1000,504,484,531,238,528,766
1000,495,506,503,251,507,758
1000,505,469,502,235,510,745
1000,494,497,515,245,499,744
1000,518,510,477,260,481,741
1000,479,485,519,231,526,757
1000,500,512,494,268,485,753
1000,493,496,498,250,490,740
1000,525,491,488,256,507,763
1000,514,492,462,256,494,750
1000,478,495,500,235,503,738
1000,514,491,511,261,508,769
1000,517,506,507,265,478,743
1000,518,512,515,258,504,762
1000,492,501,501,252,492,744
1000,505,503,501,260,494,754
1000,492,505,498,239,509,748
1000,512,462,519,225,551,776
1000,513,492,497,263,488,751
1000,509,491,494,249,512,761
1000,497,495,512,230,520,750
1000,533,497,497,265,497,762
1000,498,519,489,260,485,745
1000,471,506,511,254,472,726
1000,485,513,481,266,475,741
1000,496,491,536,252,518,770
1000,492,498,493,256,476,732
1000,479,516,509,247,495,742
1000,492,496,489,249,497,746
1000,524,511,485,278,472,750
1000,510,500,506,255,517,772
1000,512,493,473,248,498,746
1000,492,480,502,227,505,732
1000,493,518,505,255,483,738
1000,478,511,461,260,432,692
1000,509,464,487,237,509,746
1000,516,469,478,245,496,741
1000,516,503,486,262,497,759
1000,509,509,493,274,467,741
1000,493,525,507,265,491,756
1000,521,475,500,257,503,760
1000,502,525,515,271,485,756
1000,510,506,503,248,501,749
1000,475,527,475,246,478,724
1000,484,513,498,245,492,737
1000,519,515,499,253,520,773
1000,520,496,525,255,521,776
1000,484,501,473,236,479,715
1000,507,530,493,273,466,739
1000,516,470,462,248,490,738
1000,502,530,501,262,497,759
1000,509,510,511,250,512,762
1000,497,505,512,243,513,756
1000,482,487,530,241,512,753
1000,493,515,509,254,497,751
1000,518,477,488,270,475,745
1000,513,487,514,236,530,766
1000,504,502,490,249,489,738
1000,499,496,491,235,512,747
1000,505,492,507,253,511,764
1000,498,500,515,252,498,750
1000,518,498,473,266,482,748
1000,493,504,490,239,520,759
1000,500,488,521,244,523,767
1000,519,485,509,247,518,765
1000,508,481,496,245,492,737
1000,517,510,496,257,501,758
1000,501,477,488,237,506,743
1000,494,514,493,237,508,745
1000,481,504,477,255,472,727
1000,505,500,517,258,505,763
1000,500,467,490,241,495,736
1000,503,518,482,264,473,737
1000,485,500,506,243,504,747
1000,516,498,505,257,511,768
1000,496,498,470,251,487,738
1000,505,493,522,258,499,757
1000,482,447,485,213,510,723
1000,501,498,477,261,484,745
1000,514,522,500,267,492,759
1000,499,521,517,251,509,760
1000,510,525,503,267,487,754
1000,503,509,483,262,473,735
1000,492,507,495,256,486,742
1000,513,517,475,268,474,742
1000,495,511,524,253,508,761
1000,492,500,533,248,516,764
1000,485,492,496,238,515,753
1000,472,513,514,234,499,733
1000,491,490,500,230,502,732
1000,498,503,523,247,514,761
1000,515,466,491,231,537,768
1000,485,516,534,247,512,759
1000,486,506,499,256,479,735
1000,492,485,524,252,504,756
1000,506,483,484,243,508,751
1000,508,499,518,247,514,761
1000,485,509,500,250,503,753
1000,514,498,500,248,510,758
1000,501,512,491,244,495,739
1000,463,531,496,247,493,740
1000,527,463,486,229,534,763
1000,510,482,497,243,517,760
1000,492,464,497,208,556,764
1000,505,493,505,251,514,765
1000,522,501,500,259,496,755
1000,520,516,531,263,503,766
1000,516,487,514,268,497,765
1000,485,533,500,265,459,724
1000,493,511,493,248,494,742
1000,489,496,494,239,499,738
1000,469,485,495,229,493,722
1000,521,518,511,249,510,759
1000,487,486,497,235,511,746
1000,487,505,509,235,505,740
1000,483,494,489,233,501,734
1000,496,509,508,251,504,755
1000,479,519,480,259,474,733
1000,498,498,480,244,488,732
1000,520,497,537,253,525,778
1000,480,509,498,230,508,738
1000,500,508,498,250,505,755
1000,509,505,518,241,535,776
1000,505,503,509,253,497,750
1000,514,511,494,264,486,750
1000,496,504,488,252,482,734
1000,475,495,475,245,479,724
1000,470,477,497,236,473,709
1000,502,497,499,244,518,762
1000,510,506,511,258,489,747
1000,478,509,495,241,490,731
1000,515,512,510,266,495,761
1000,469,520,481,243,471,714
1000,483,518,500,252,495,747
1000,498,530,494,257,492,749
1000,482,509,526,260,489,749
1000,497,490,513,235,524,759
1000,483,489,506,231,527,758
1000,507,467,490,245,498,743
1000,476,493,473,238,488,726
1000,513,486,485,261,497,758
1000,514,512,516,263,505,768
1000,506,485,504,243,503,746
1000,512,467,481,243,502,745
1000,506,491,484,237,515,752
1000,489,500,513,245,508,753
1000,515,495,478,249,472,721
1000,508,516,498,267,491,758
1000,517,519,506,261,513,774
1000,511,509,494,269,487,756
1000,503,493,518,232,514,746
1000,491,464,500,223,531,754
1000,509,523,511,267,490,757
1000,517,495,487,245,480,725
1000,519,507,499,264,505,769
1000,499,519,499,262,481,743
1000,502,494,477,247,487,734
1000,504,494,485,258,470,728
1000,507,493,496,265,492,757
1000,496,459,512,221,536,757
1000,487,477,494,236,511,747
1000,493,506,495,243,496,739
1000,500,503,502,265,497,762
1000,491,478,482,247,485,732
1000,520,493,497,252,516,768
1000,479,513,508,245,498,743
1000,499,501,491,249,490,739
1000,495,505,519,249,491,740
1000,477,496,532,237,516,753
1000,529,491,475,270,475,745
1000,525,509,509,263,497,760
1000,497,471,482,239,511,750
1000,481,481,523,221,532,753
1000,477,511,503,247,495,742
1000,504,511,481,252,490,742
1000,492,495,537,242,538,780
1000,473,496,494,233,501,734
1000,517,479,492,260,498,758
1000,474,535,484,250,474,724
1000,484,492,475,240,494,734
1000,492,507,504,241,512,753
1000,502,485,506,232,510,742
1000,540,484,496,253,522,775
1000,498,504,502,253,476,729
1000,511,466,468,251,500,751
1000,509,527,495,265,481,746
1000,498,488,507,247,504,751
1000,470,495,512,237,509,746
1000,506,501,530,246,513,759
1000,511,466,506,245,521,766
1000,517,509,494,268,489,757
1000,485,532,500,254,490,744
1000,512,492,528,243,520,763
1000,479,528,527,251,505,756
1000,512,511,500,259,508,767
1000,474,490,493,217,509,726
1000,469,485,509,221,509,730
1000,512,497,481,257,485,742
1000,507,510,514,244,523,767
1000,509,493,530,249,514,763
1000,495,515,487,260,474,734
1000,493,518,519,260,486,746
1000,483,488,519,228,527,755
1000,483,477,496,224,522,746
1000,491,502,481,240,506,746
1000,499,505,541,248,520,768
1000,515,507,506,240,520,760
1000,501,487,531,252,525,777
1000,472,502,509,246,506,752
1000,499,513,479,267,466,733
1000,496,493,512,249,501,750
1000,483,512,507,244,501,745
1000,495,494,510,247,489,736
1000,481,497,487,243,487,730
1000,498,499,513,253,499,752
1000,513,489,473,236,506,742
1000,487,472,530,228,546,774
1000,501,488,518,251,516,767
1000,515,482,497,237,513,750
1000,474,523,497,252,487,739
1000,504,478,511,236,526,762
1000,515,473,494,251,496,747
1000,484,479,519,243,500,743
1000,485,501,474,237,489,726
1000,498,503,514,257,500,757
1000,512,492,510,250,512,762
1000,481,487,486,235,498,733
1000,508,502,504,266,497,763
1000,501,494,516,240,517,757
1000,512,509,497,256,507,763
1000,539,510,491,272,499,771
1000,472,505,492,231,491,722
1000,493,529,503,273,471,744
1000,489,500,498,254,491,745
1000,516,506,493,248,510,758
1000,491,494,504,223,518,741
1000,496,497,487,241,512,753
1000,498,508,478,268,466,734
1000,492,486,507,229,537,766
1000,501,525,505,262,491,753
1000,529,521,512,274,491,765
1000,491,527,490,273,455,728
1000,491,482,455,235,487,722
1000,493,490,478,240,501,741
1000,485,497,481,239,497,736
1000,523,518,494,277,475,752
1000,485,472,491,220,511,731
1000,499,494,488,238,511,749
1000,490,483,480,236,495,731
1000,470,505,518,226,514,740
1000,505,510,506,262,489,751
1000,479,492,476,236,480,716
1000,497,481,513,233,520,753
1000,530,515,472,287,478,765
1000,512,511,466,252,493,745
1000,499,493,504,256,496,752
1000,507,517,488,258,474,732
1000,495,524,477,263,483,746
1000,493,519,516,248,489,737
1000,506,493,512,242,520,762
1000,495,512,502,266,479,745
1000,488,497,514,243,522,765
1000,522,537,488,285,475,760
1000,509,479,493,260,491,751
1000,497,489,497,251,493,744
1000,507,490,490,235,503,738
1000,490,489,497,230,515,745
1000,466,508,514,236,512,748
1000,500,503,505,242,500,742
1000,507,498,519,259,494,753
1000,521,513,477,271,477,748
1000,527,520,513,276,490,766
1000,496,495,518,243,510,753
1000,513,521,502,272,473,745
1000,484,498,510,231,509,740
1000,494,490,503,230,503,733
1000,477,520,523,257,472,729
1000,497,494,501,242,526,768
1000,484,484,502,231,517,748
1000,504,499,510,249,514,763
1000,485,480,511,241,499,740
1000,499,537,488,275,478,753
1000,506,503,497,251,505,756
1000,511,491,529,240,535,775
1000,520,495,505,255,507,762
1000,506,510,487,257,478,735
1000,532,479,524,276,490,766
1000,509,521,509,255,495,750
1000,487,500,493,231,499,730
1000,508,504,518,255,496,751
1000,495,494,522,248,518,766
1000,502,537,492,270,477,747
1000,504,471,511,229,533,762
1000,512,504,514,264,474,738
1000,512,501,496,248,498,746
1000,502,507,493,256,505,761
1000,497,500,485,249,484,733
1000,492,505,507,248,490,738
1000,496,506,511,252,492,744
1000,491,493,473,231,496,727
1000,488,491,507,250,507,757
1000,505,491,489,260,495,755
1000,496,493,526,245,513,758
1000,479,511,491,228,514,742
1000,514,517,503,261,501,762
1000,499,507,508,259,485,744
1000,494,509,488,254,490,744
1000,507,496,477,260,488,748
1000,547,502,475,279,490,769
1000,534,505,495,272,490,762
1000,499,511,504,264,479,743
1000,508,496,500,248,498,746
1000,527,526,528,274,509,783
1000,484,494,500,244,489,733
1000,493,508,507,240,518,758
1000,479,498,482,228,499,727
1000,522,497,469,252,483,735
1000,480,503,529,233,524,757
1000,500,500,492,250,491,741
1000,485,509,513,242,508,750
1000,523,484,483,246,510,756
1000,486,486,502,217,528,745
1000,502,491,491,254,507,761
1000,528,493,509,259,526,785
1000,491,497,499,243,508,751
1000,516,520,480,275,482,757
1000,509,507,518,253,526,779
1000,497,511,507,249,498,747
1000,502,506,494,259,483,742
1000,506,520,503,272,477,749
1000,512,510,485,264,489,753
1000,501,493,494,249,510,759
1000,491,502,520,237,531,768
1000,501,524,501,256,486,742
1000,498,490,522,261,494,755
1000,517,512,500,257,500,757
1000,515,469,514,232,530,762
1000,519,500,487,253,499,752
1000,494,480,480,233,504,737
1000,498,476,480,239,488,727
1000,494,484,498,245,508,753
1000,530,504,511,259,526,785
1000,498,504,495,257,495,752
1000,511,491,512,258,503,761
1000,490,510,517,246,505,751
1000,484,501,502,246,492,738
1000,489,503,499,234,504,738
1000,518,521,497,265,502,767
1000,522,457,528,237,543,780
1000,509,520,513,265,503,768
1000,488,502,480,241,484,725
1000,514,523,482,263,484,747
1000,488,485,494,242,505,747
1000,490,468,489,223,505,728
1000,510,488,495,248,516,764
1000,500,505,490,256,497,753
1000,506,486,482,240,506,746
1000,518,490,470,256,481,737
1000,512,478,499,240,522,762
1000,523,469,486,246,496,742
1000,481,463,508,226,511,737
1000,525,507,518,264,500,764
1000,484,481,476,238,494,732
1000,511,482,520,241,525,766
1000,491,495,489,251,486,737
1000,461,508,506,240,493,733
1000,528,484,491,261,491,752
1000,493,503,543,263,485,748
1000,503,521,501,265,501,766
1000,511,474,508,247,511,758
1000,471,503,517,243,502,745
1000,507,495,499,252,491,743
1000,530,481,489,258,509,767
1000,490,494,493,239,503,742
1000,484,497,516,238,515,753
1000,514,496,502,262,493,755
1000,503,504,508,250,512,762
1000,501,509,514,247,521,768
1000,499,493,491,254,489,743
1000,497,480,501,243,498,741
1000,501,500,512,252,509,761
1000,516,508,518,249,508,757
1000,502,514,490,271,471,742
1000,494,479,527,232,528,760
1000,500,499,514,248,501,749
1000,505,487,519,250,508,758
1000,523,486,502,245,511,756
1000,498,506,498,235,503,738
1000,505,500,504,252,498,750
1000,508,516,489,262,487,749
1000,503,499,512,264,482,746
1000,497,517,512,261,490,751
1000,499,520,505,269,486,755
1000,504,498,505,254,488,742
1000,497,501,507,246,507,753
1000,491,521,493,258,482,740
1000,495,488,518,243,515,758
1000,505,498,513,249,502,751
1000,493,475,491,239,506,745
1000,528,482,465,265,492,757
1000,483,504,516,253,500,753
1000,502,487,526,251,520,771
1000,490,493,514,251,504,755
1000,498,509,470,262,465,727
1000,500,499,543,253,518,771
1000,524,480,495,253,518,771
1000,489,529,495,258,490,748
1000,517,502,483,255,489,744
1000,493,472,522,224,529,753
1000,510,493,490,236,515,751
1000,480,489,528,226,514,740
1000,486,509,472,254,473,727
1000,513,521,500,263,495,758
1000,505,488,491,255,503,758
1000,525,498,503,265,483,748
1000,523,508,495,266,488,754
1000,525,520,492,277,479,756
1000,510,487,504,249,496,745
1000,505,500,499,234,512,746
1000,500,506,513,263,494,757
1000,512,484,499,261,484,745
1000,504,493,494,252,488,740
1000,500,511,489,249,495,744
1000,513,479,499,252,500,752
1000,520,510,508,256,519,775
1000,482,485,510,243,509,752
1000,491,472,505,242,499,741
1000,496,497,503,233,513,746
1000,486,517,512,253,486,739
1000,494,489,522,239,518,757
1000,484,505,473,241,486,727
1000,492,521,488,245,499,744
1000,494,517,484,254,482,736
1000,503,509,523,258,516,774
1000,509,511,492,267,467,734
1000,514,493,491,245,527,772
1000,487,490,512,238,507,745
1000,508,494,479,246,496,742
1000,476,483,497,224,519,743
1000,511,505,504,265,488,753
1000,492,495,501,258,493,751
1000,507,488,483,241,492,733
1000,515,508,500,255,491,746
1000,462,528,518,244,494,738
1000,514,496,501,265,502,767
1000,517,491,520,260,504,764
1000,489,488,499,242,505,747
1000,494,495,507,258,483,741
1000,524,479,493,247,516,763
1000,505,490,524,243,534,777
1000,513,507,518,248,517,765
1000,540,511,496,281,479,760
1000,522,474,521,260,508,768
1000,509,516,531,261,521,782
1000,487,501,501,228,509,737
1000,537,458,497,235,540,775
1000,519,489,524,258,519,777
1000,498,487,502,239,510,749
1000,518,483,493,251,507,758
1000,515,525,492,264,483,747
1000,493,523,494,267,468,735
1000,481,513,503,245,493,738
1000,508,501,477,269,454,723
1000,481,485,513,226,516,742
1000,507,491,510,250,513,763
1000,543,509,487,270,485,755
1000,510,501,502,263,485,748
1000,503,494,516,266,502,768
1000,534,493,516,257,529,786
1000,483,503,494,244,495,739
1000,492,481,497,239,505,744
1000,504,505,491,270,476,746
1000,505,505,477,263,464,727
1000,522,503,491,252,522,774
1000,512,508,501,266,493,759
1000,509,499,486,259,492,751
1000,496,521,471,259,477,736
1000,525,489,516,252,519,771
1000,505,496,516,260,495,755
1000,502,502,486,235,519,754
1000,497,516,500,263,487,750
1000,530,502,510,245,540,785
1000,509,479,525,256,500,756
1000,485,497,471,229,489,718
1000,491,503,463,239,493,732
1000,504,493,486,245,498,743
1000,500,511,501,252,486,738
1000,509,505,511,256,504,760
1000,519,534,496,283,464,747
1000,487,493,480,250,486,736
1000,492,488,494,236,503,739
1000,510,508,507,267,484,751
1000,507,502,501,253,497,750
1000,523,477,484,258,500,758
1000,507,513,522,265,485,750
1000,523,508,506,271,500,771
1000,480,489,527,237,526,763
1000,501,523,493,259,486,745
1000,499,500,518,255,500,755
1000,500,509,487,243,504,747
1000,516,526,487,270,476,746
1000,512,522,508,273,497,770
1000,525,497,493,259,499,758
1000,489,515,523,261,477,738
1000,490,501,509,257,502,759
1000,509,485,482,252,485,737
1000,495,474,491,233,502,735
1000,514,495,493,245,509,754
1000,528,514,507,272,509,781
1000,493,500,527,259,502,761
1000,515,522,497,258,510,768
1000,491,503,497,240,504,744
1000,473,497,507,251,477,728
1000,470,504,530,237,504,741
1000,483,505,505,236,512,748
1000,472,501,496,224,512,736
1000,505,515,495,257,501,758
1000,491,509,513,250,506,756
1000,502,479,504,246,499,745
1000,482,506,487,248,492,740
1000,513,507,474,255,488,743
1000,514,495,485,250,499,749
1000,492,508,509,255,506,761
1000,512,496,497,268,482,750
1000,526,494,520,261,515,776
1000,496,501,504,253,491,744
1000,500,486,479,239,503,742
1000,486,495,497,252,479,731
1000,462,489,490,226,486,712
1000,491,507,531,251,510,761
1000,497,508,498,248,502,750
1000,484,502,482,232,499,731
1000,483,485,505,239,511,750
1000,508,473,497,240,516,756
1000,515,499,481,260,492,752
1000,510,506,488,254,490,744
1000,492,507,475,249,477,726
1000,480,485,493,239,476,715
1000,514,509,498,241,501,742
1000,502,521,502,268,495,763
1000,529,501,496,269,489,758
1000,512,499,500,253,510,763
1000,487,485,511,244,498,742
1000,506,493,496,249,500,749
1000,498,499,468,239,484,723
1000,468,496,514,247,500,747
1000,524,501,507,266,504,770
1000,492,498,485,241,500,741
1000,455,474,503,223,496,719
1000,508,494,493,253,494,747
1000,507,491,486,249,489,738
1000,478,479,504,219,523,742
1000,525,526,495,279,489,768
1000,488,492,523,236,517,753
1000,473,477,514,222,518,740
1000,519,486,510,244,523,767
1000,511,491,506,256,517,773
1000,500,506,504,249,512,761
1000,492,496,490,241,499,740
1000,496,507,509,244,497,741
1000,520,498,471,261,483,744
1000,487,479,521,234,512,746
1000,500,515,528,275,481,756
1000,481,504,494,236,497,733
1000,483,488,488,239,490,729
1000,499,498,499,262,475,737
1000,500,507,479,261,474,735
1000,489,503,494,242,502,744
1000,493,503,481,233,509,742
1000,494,504,525,240,508,748
1000,499,520,471,267,470,737
1000,478,485,486,228,492,720
1000,494,518,494,259,484,743
1000,473,482,509,241,501,742
1000,500,482,500,232,523,755
1000,500,495,470,253,493,746
1000,501,504,505,255,511,766
1000,511,495,483,253,491,744
1000,511,494,480,259,492,751
1000,472,492,491,242,492,734
1000,491,518,480,257,478,735
1000,483,508,514,231,516,747
1000,494,479,526,238,522,760
1000,512,486,510,232,533,765
1000,505,485,485,234,508,742
1000,499,497,501,246,491,737
1000,513,502,493,248,504,752
1000,479,521,504,248,495,743
1000,508,511,491,253,499,752
1000,461,508,503,228,498,726
1000,499,510,506,268,481,749
1000,504,501,532,259,504,763
1000,494,494,489,259,479,738
1000,482,479,500,239,510,749
1000,533,512,507,268,503,771
1000,485,508,467,237,500,737
1000,505,497,517,260,498,758
1000,515,525,510,275,493,768
1000,517,508,519,263,517,780
1000,515,519,514,269,485,754
1000,484,508,496,246,491,737
1000,505,490,504,244,497,741
1000,473,467,495,218,519,737
1000,510,492,484,259,490,749
1000,496,503,514,243,518,761
1000,485,515,503,244,503,747
1000,500,471,505,240,507,747
1000,508,499,505,253,490,743
1000,503,505,479,258,477,735
1000,513,509,496,267,484,751
1000,496,489,476,239,508,747
1000,482,493,495,239,497,736
1000,504,505,495,257,503,760
1000,520,493,464,258,501,759
1000,503,480,499,237,508,745
1000,515,526,485,274,474,748
1000,506,487,499,259,493,752
1000,502,482,510,243,518,761
1000,507,494,502,249,507,756
1000,489,509,508,236,503,739
1000,504,522,519,256,506,762
1000,505,499,478,255,490,745
1000,479,483,490,227,492,719
1000,507,496,480,249,484,733
1000,499,522,495,259,490,749
1000,494,498,500,258,476,734
1000,488,495,524,257,504,761
1000,509,509,493,247,501,748
1000,484,470,490,228,506,734
1000,489,493,494,245,497,742
1000,526,472,499,249,522,771
1000,495,468,501,230,512,742
1000,505,509,502,249,508,757
1000,464,533,490,261,458,719
1000,511,477,528,245,535,780
1000,520,531,471,271,471,742
1000,483,519,503,261,476,737
1000,496,503,502,243,496,739
1000,511,486,488,258,503,761
1000,498,499,515,249,508,757
1000,521,500,499,258,493,751
1000,508,508,513,252,521,773
1000,500,534,495,262,488,750
1000,510,498,505,248,513,761
1000,495,484,505,243,499,742
1000,498,501,513,249,507,756
1000,494,484,490,234,519,753
1000,504,481,512,244,503,747
1000,497,477,488,234,519,753
1000,498,503,503,253,495,748
1000,518,513,513,265,494,759
1000,502,526,506,257,497,754
1000,495,487,500,234,509,743
1000,515,514,484,257,481,738
1000,491,480,522,234,517,751
1000,520,513,481,265,480,745
1000,513,484,484,246,498,744
1000,533,491,519,260,522,782
1000,488,493,485,250,482,732
1000,479,494,505,232,504,736
1000,491,476,529,229,536,765
1000,477,501,520,231,516,747
1000,473,513,517,224,531,755
1000,510,483,485,250,491,741
1000,488,499,498,253,485,738
1000,479,489,501,235,503,738
1000,504,503,528,256,506,762
1000,506,496,494,235,513,748
1000,525,483,495,263,507,770
1000,513,509,498,269,483,752
1000,481,491,533,240,533,773
1000,490,487,458,230,498,728
1000,501,518,480,243,505,748
1000,488,508,501,250,483,733
1000,522,514,508,276,507,783
1000,482,478,495,227,519,746
1000,520,498,521,250,532,782
1000,493,499,510,252,505,757
1000,527,490,510,265,501,766
1000,503,486,501,245,504,749
1000,494,474,483,231,499,730
1000,496,489,490,245,501,746
1000,489,515,522,259,500,759
1000,521,506,520,258,496,754
1000,496,488,488,244,483,727
1000,498,502,497,246,513,759
1000,507,486,491,243,493,736
1000,491,485,503,248,497,745
1000,489,505,486,258,475,733
1000,517,484,528,254,514,768
1000,490,511,495,245,491,736
1000,495,501,493,245,489,734
1000,475,537,491,258,483,741
1000,472,483,478,227,485,712
1000,491,490,493,246,493,739
1000,494,480,504,234,521,755
1000,490,496,487,251,489,740
1000,503,490,474,243,492,735
1000,523,499,479,262,489,751
1000,481,493,517,239,509,748
1000,495,523,487,266,481,747
1000,485,499,476,228,505,733
1000,496,498,518,250,500,750
1000,517,512,501,260,488,748
1000,496,517,504,256,505,761
1000,502,480,493,249,497,746
1000,512,474,503,254,509,763
1000,506,476,502,250,508,758
1000,502,501,529,259,532,791
1000,503,505,490,248,496,744
1000,491,494,491,225,511,736
1000,497,489,484,254,488,742
1000,499,503,491,244,504,748
1000,484,520,483,242,488,730
1000,503,534,505,266,500,766
1000,507,498,472,244,495,739
1000,484,523,502,252,489,741
1000,499,491,508,236,500,736
1000,483,492,522,231,534,765
1000,490,492,489,235,495,730
1000,483,500,509,237,493,730
1000,518,501,507,265,503,768
1000,488,491,503,227,515,742
1000,511,515,470,270,475,745
1000,504,480,477,247,488,735
1000,481,506,494,234,493,727
1000,515,519,513,256,496,752
1000,521,485,492,244,514,758
1000,523,505,495,252,515,767
1000,486,497,481,238,488,726
1000,495,482,498,241,502,743
1000,504,516,496,260,480,740
1000,493,501,509,242,493,735
1000,484,484,480,244,480,724
1000,480,512,488,253,486,739
1000,496,512,492,239,516,755
1000,495,468,501,220,525,745
1000,501,502,518,261,504,765
1000,485,508,480,236,490,726
1000,504,532,515,261,512,773
1000,491,493,501,235,520,755
1000,474,494,500,239,502,741
1000,481,476,513,232,508,740
1000,513,500,497,246,520,766
1000,489,499,451,245,473,718
1000,517,516,493,266,493,759
1000,472,451,481,215,511,726
1000,480,487,526,234,536,770
1000,494,503,509,264,489,753
1000,507,514,494,272,469,741
1000,489,506,497,244,503,747
1000,471,494,479,234,490,724
1000,518,515,497,252,489,741
1000,485,513,491,252,479,731
1000,496,482,495,233,525,758
1000,483,468,492,231,515,746
1000,500,478,492,242,501,743
1000,493,503,514,251,498,749
1000,543,489,496,268,498,766
1000,501,497,498,262,480,742
1000,516,494,498,262,487,749
1000,481,499,505,246,503,749
1000,535,504,485,280,488,768
1000,484,499,502,248,494,742
1000,525,483,506,250,503,753
1000,534,491,490,254,505,759
1000,507,506,511,239,523,762
1000,485,494,504,250,503,753
1000,504,486,509,259,497,756
1000,512,483,521,250,506,756
1000,495,478,510,241,515,756
1000,514,513,492,271,491,762
1000,511,513,494,275,476,751
1000,498,506,500,235,504,739
1000,475,465,512,221,522,743
1000,478,482,510,225,520,745
1000,513,521,518,276,484,760
1000,495,492,512,239,523,762
1000,513,498,492,262,493,755
1000,478,514,510,254,490,744
1000,493,498,485,247,500,747
1000,516,510,504,257,497,754
1000,492,502,483,246,480,726
1000,494,495,506,246,490,736
1000,527,506,546,266,524,790
1000,472,510,499,241,488,729
1000,488,515,492,256,494,750
1000,517,477,529,251,532,783
1000,520,500,506,256,500,756
1000,481,486,486,234,515,749
1000,504,529,459,257,481,738
1000,510,499,518,271,498,769
1000,512,512,495,274,481,755
1000,499,478,512,264,489,753
1000,487,502,505,255,489,744
1000,498,508,497,255,489,744
1000,494,480,499,244,490,734
1000,523,502,498,273,487,760
1000,512,489,491,234,511,745
1000,495,513,486,259,485,744
1000,513,505,464,250,492,742
1000,501,496,497,244,498,742
1000,497,529,523,254,517,771
1000,503,499,516,252,497,749
1000,513,470,514,251,520,771
1000,497,485,521,249,503,752
1000,519,475,508,252,497,749
1000,516,491,503,270,508,778
1000,515,536,531,265,495,760
1000,490,497,494,249,490,739
1000,499,471,491,245,496,741
1000,504,494,487,240,507,747
1000,475,522,501,248,489,737
1000,496,491,483,245,480,725
1000,504,492,520,254,511,765
1000,499,507,492,253,473,726
1000,472,485,481,215,525,740
1000,503,461,502,236,506,742
1000,488,509,536,245,508,753
1000,520,488,506,243,527,770
1000,491,518,498,258,478,736
1000,526,505,489,265,503,768
1000,497,498,502,247,501,748
1000,537,501,492,287,467,754
1000,479,490,520,250,488,738
1000,498,493,522,252,508,760
1000,530,506,516,261,523,784
1000,504,471,499,239,515,754
1000,477,502,531,241,518,759
1000,493,474,522,246,514,760
1000,506,490,509,265,488,753
1000,510,521,508,252,499,751
1000,490,487,492,242,506,748
1000,516,491,461,240,506,746
1000,471,481,526,230,525,755
1000,496,509,522,253,503,756
1000,493,492,526,235,517,752
1000,493,508,501,248,498,746
1000,492,495,525,252,518,770
1000,486,477,478,246,495,741
1000,498,493,493,243,507,750
1000,504,509,513,257,500,757
1000,481,507,503,230,501,731
1000,504,482,508,231,521,752
1000,504,489,497,259,481,740
1000,487,497,501,240,530,770
1000,487,508,526,246,505,751
1000,514,501,510,245,501,746
1000,525,523,481,266,492,758
1000,522,516,514,265,502,767
1000,490,482,489,244,503,747
1000,478,488,473,242,495,737
1000,534,508,495,262,507,769
1000,507,507,495,264,488,752
1000,489,499,478,229,511,740
1000,488,506,490,247,494,741
1000,488,486,517,228,520,748
1000,512,499,529,256,506,762
1000,513,460,495,225,537,762
1000,499,511,504,249,492,741
1000,509,511,489,262,500,762
1000,510,505,488,248,498,746
1000,483,517,497,254,480,734
1000,498,508,519,254,502,756
1000,488,509,490,263,484,747
1000,497,529,485,260,483,743
1000,507,502,504,245,515,760
1000,504,501,486,257,489,746
1000,508,511,491,267,488,755
1000,488,493,490,241,487,728
1000,512,499,520,240,529,769
1000,487,512,527,248,499,747
1000,507,483,493,239,508,747
1000,507,513,513,250,507,757
1000,521,495,515,253,512,765
1000,506,496,506,246,506,752
1000,512,515,484,267,490,757
1000,521,480,513,252,515,767
1000,507,483,505,234,529,763
1000,493,494,511,237,506,743
1000,504,498,506,254,509,763
1000,489,528,504,263,488,751
1000,506,524,510,270,494,764
1000,465,480,509,227,517,744
1000,523,479,491,258,502,760
1000,523,518,505,270,513,783
1000,495,538,517,261,486,747
1000,510,474,497,231,527,758
1000,525,520,494,277,486,763
1000,495,513,512,252,519,771
1000,499,490,483,243,498,741
1000,490,478,503,226,512,738
1000,516,494,496,257,505,762
1000,513,541,490,282,460,742
1000,505,495,499,257,494,751
1000,483,509,528,236,522,758
1000,524,528,520,273,494,767
1000,507,515,502,260,506,766
1000,506,498,515,249,519,768
1000,500,522,532,271,514,785
1000,471,496,519,232,522,754
1000,506,525,514,258,496,754
1000,487,518,489,251,481,732
1000,495,519,504,265,476,741
1000,510,465,478,242,479,721
1000,490,526,494,269,475,744
1000,493,480,497,234,517,751
1000,517,539,488,275,483,758
1000,493,500,502,247,492,739
1000,498,514,500,246,490,736
1000,524,511,481,272,477,749
1000,474,479,515,228,513,741
1000,490,510,496,248,514,762
1000,492,508,476,269,463,732
1000,493,481,526,244,512,756
1000,482,493,498,254,490,744
1000,512,521,498,264,483,747
1000,491,482,500,241,497,738
1000,489,511,480,256,482,738
1000,528,518,522,267,521,788
1000,485,473,498,212,520,732
1000,504,446,468,217,525,742
1000,489,502,522,239,524,763
1000,460,510,498,244,482,726
1000,490,489,486,240,485,725
1000,491,492,494,225,525,750
1000,506,485,511,242,501,743
1000,517,478,477,256,489,745
1000,481,496,520,231,522,753
1000,487,523,493,255,498,753
1000,509,510,517,260,504,764
1000,507,476,505,249,498,747
1000,527,505,527,268,505,773
1000,496,504,495,260,479,739
1000,486,479,491,229,520,749
1000,487,477,504,227,514,741
1000,481,482,470,226,497,723
1000,511,518,492,255,494,749
1000,493,486,486,237,496,733
1000,484,492,529,237,524,761
1000,489,495,490,245,485,730
1000,502,492,514,247,506,753
1000,513,471,522,253,510,763
1000,485,511,529,253,518,771
1000,495,502,473,257,463,720
1000,491,481,510,237,516,753
1000,515,498,511,259,502,761
1000,508,480,524,247,509,756
1000,495,496,498,248,503,751
1000,495,479,514,253,508,761
1000,484,533,508,273,477,750
1000,503,501,467,254,485,739
1000,496,491,498,228,530,758
1000,496,490,528,245,518,763
1000,520,503,504,267,496,763
1000,506,479,496,247,498,745
1000,498,494,494,242,502,744
1000,515,517,487,275,465,740
1000,495,506,499,254,482,736
1000,509,499,490,257,495,752
1000,485,505,497,233,513,746
1000,466,493,492,225,503,728
1000,470,514,491,225,505,730
1000,518,515,505,260,512,772
1000,482,488,496,241,491,732
1000,483,484,519,228,515,743
1000,508,500,521,257,520,777
1000,505,475,489,237,508,745
1000,490,496,514,231,512,743
1000,497,497,497,250,489,739
1000,491,505,512,241,503,744
1000,559,513,498,296,493,789
1000,495,509,489,240,498,738
1000,484,472,512,235,506,741
1000,502,455,485,223,522,745
1000,503,530,465,268,475,743
1000,502,444,500,230,515,745
1000,479,506,491,246,474,720
1000,492,498,471,254,481,735
1000,482,484,490,233,503,736
1000,460,503,485,233,488,721
1000,489,523,488,265,470,735
1000,518,489,493,246,490,736
1000,517,486,495,257,509,766
1000,512,514,481,264,483,747
1000,489,489,488,252,478,730
1000,482,483,525,230,524,754
1000,487,517,499,255,478,733
1000,485,504,490,247,492,739
1000,512,506,487,259,486,745
1000,496,532,505,262,496,758
1000,475,503,524,238,507,745
1000,520,518,495,290,476,766
1000,518,496,519,255,513,768
1000,476,492,530,248,507,755
1000,477,485,501,231,504,735
1000,520,493,514,256,508,764
1000,491,517,493,253,481,734
1000,489,486,510,233,518,751
1000,502,499,516,242,502,744
1000,512,516,504,278,477,755
1000,534,496,497,259,505,764
1000,513,522,483,259,491,750
1000,513,505,502,253,502,755
1000,475,509,522,240,520,760
1000,510,525,489,264,478,742
1000,490,498,483,261,472,733
1000,502,478,514,236,518,754
1000,466,535,515,246,499,745
1000,502,492,496,236,519,755
1000,499,495,510,242,518,760
1000,503,505,508,249,518,767
1000,490,502,510,251,501,752
1000,489,477,505,232,520,752
1000,459,484,498,227,510,737
1000,524,497,493,268,488,756
1000,523,493,510,269,505,774
1000,521,492,475,264,495,759
1000,477,502,502,236,501,737
1000,497,516,511,252,497,749
1000,484,521,465,257,462,719
1000,509,497,496,243,515,758
1000,518,483,501,250,522,772
1000,494,487,492,230,500,730
1000,481,486,514,249,500,749
1000,487,509,497,242,496,738
1000,488,496,515,231,516,747
1000,508,498,508,252,506,758
1000,527,501,518,272,489,761
1000,490,467,520,241,511,752
1000,490,505,499,248,487,735
1000,492,496,517,230,526,756
1000,499,500,510,243,517,760
1000,473,494,509,234,507,741
1000,505,508,510,249,493,742
1000,479,520,485,247,473,720
1000,501,497,526,241,531,772
1000,539,515,485,279,484,763
1000,493,494,517,243,507,750
1000,504,492,502,252,508,760
1000,505,513,465,269,455,724
1000,502,497,522,264,495,759
1000,482,514,489,252,477,729
1000,495,501,516,253,506,759
1000,505,517,497,287,474,761
1000,498,529,497,250,500,750
1000,496,515,518,245,528,773
1000,495,485,515,233,517,750
1000,504,502,493,267,489,756
1000,494,504,508,253,491,744
1000,501,506,485,258,483,741
1000,512,503,513,254,509,763
1000,528,489,513,257,511,768
1000,508,488,510,246,519,765
1000,488,517,529,252,500,752
1000,516,527,488,263,480,743
1000,492,470,499,239,505,744
1000,518,491,489,252,506,758
1000,501,501,492,250,480,730
1000,498,498,481,241,505,746
1000,458,497,487,225,487,712
1000,498,514,509,249,501,750
1000,485,476,521,224,531,755
1000,497,507,514,249,511,760
1000,504,513,505,254,499,753
1000,514,516,483,274,473,747
1000,520,500,491,262,492,754
1000,519,524,524,270,512,782
1000,503,492,506,241,513,754
1000,505,516,497,251,497,748
1000,492,498,497,239,507,746
1000,519,502,529,256,527,783
1000,474,526,502,246,491,737
1000,500,493,486,244,495,739
1000,496,505,507,263,480,743
1000,516,492,534,255,519,774
1000,488,514,491,264,465,729
1000,470,501,506,229,512,741
1000,506,499,540,248,533,781
1000,512,515,502,266,492,758
1000,499,512,493,258,498,756
1000,518,477,499,241,513,754
1000,489,510,518,241,510,751
1000,503,501,495,254,499,753
1000,507,502,498,255,512,767
1000,517,481,524,242,527,769
1000,472,516,489,257,470,727
1000,518,482,512,248,527,775
1000,487,477,507,228,514,742
1000,509,497,476,255,491,746
1000,489,505,501,247,508,755
1000,500,527,487,264,477,741
1000,483,496,522,246,512,758
1000,515,534,515,282,480,762
1000,526,490,503,254,504,758
1000,533,482,509,260,490,750
1000,488,507,498,249,504,753
1000,511,484,496,246,507,753
1000,483,485,470,231,495,726
1000,515,476,488,246,514,760
1000,481,503,482,241,496,737
1000,486,477,501,244,496,740
1000,498,501,498,261,482,743
1000,485,518,520,249,504,753
1000,500,488,508,249,501,750
1000,486,513,512,243,513,756
1000,492,504,492,255,479,734
1000,494,507,496,242,487,729
1000,489,489,509,223,522,745
1000,490,519,506,262,491,753
1000,513,512,512,260,492,752
1000,502,494,522,244,512,756
1000,503,492,487,241,507,748
1000,506,504,492,264,479,743
1000,499,500,515,263,494,757
1000,491,536,491,255,486,741
1000,489,484,482,236,494,730
1000,450,495,485,221,484,705
1000,487,509,491,257,487,744
1000,493,505,497,266,475,741
1000,500,458,523,226,523,749
1000,544,495,500,258,511,769
1000,521,508,520,269,503,772
1000,517,507,518,260,506,766
1000,500,498,478,240,504,744
1000,491,508,506,250,503,753
1000,512,515,496,266,491,757
1000,490,504,485,248,488,736
1000,495,493,502,248,502,750
1000,489,517,484,252,476,728
1000,495,469,500,234,520,754
1000,509,505,512,248,516,764
1000,489,473,480,223,523,746
1000,489,492,509,240,505,745
1000,467,489,496,226,502,728
1000,515,501,513,252,517,769
1000,511,499,491,256,482,738
1000,520,504,501,267,498,765
1000,480,479,512,220,524,744
1000,493,505,515,254,509,763
1000,501,495,479,241,504,745
1000,495,492,515,251,491,742
1000,489,517,486,250,491,741
1000,484,496,504,245,486,731
1000,506,493,484,256,491,747
1000,512,490,497,245,503,748
1000,494,512,506,258,486,744
1000,483,497,546,242,528,770
1000,495,485,481,253,487,740
1000,529,473,460,247,509,756
1000,487,510,492,258,470,728
1000,491,491,501,231,510,741
1000,509,514,505,265,493,758
1000,517,499,478,258,491,749
1000,500,489,513,233,527,760
1000,533,490,504,269,487,756
1000,490,524,494,266,475,741
1000,489,501,502,236,512,748
1000,517,499,503,242,520,762
1000,503,497,507,241,509,750
1000,491,497,491,234,510,744
1000,494,494,509,254,500,754
1000,491,512,500,256,505,761
1000,486,524,488,255,480,735
1000,492,456,465,229,485,714
1000,522,468,505,247,529,776
1000,500,509,499,245,521,766
1000,494,522,506,252,502,754
1000,512,487,522,233,533,766
1000,508,491,489,252,497,749
1000,485,498,461,244,485,729
1000,510,500,482,261,490,751
1000,479,522,468,258,461,719
1000,489,467,513,219,531,750
1000,476,523,493,252,500,752
1000,493,478,488,221,520,741
1000,502,508,512,242,511,753
1000,498,484,516,235,529,764
1000,498,481,500,245,503,748
1000,524,500,502,256,504,760
1000,516,486,504,255,512,767
1000,504,496,508,249,499,748
1000,487,501,512,244,502,746
1000,499,505,488,249,512,761
1000,507,516,502,267,493,760
1000,476,501,496,242,497,739
1000,492,463,479,220,510,730
1000,481,510,459,237,475,712
1000,509,496,501,253,500,753
1000,508,499,494,259,496,755
1000,501,529,501,275,481,756
1000,499,499,540,242,525,767
1000,505,526,493,272,483,755
1000,513,519,491,270,481,751
1000,510,492,509,243,520,763
1000,452,507,517,243,495,738
1000,492,541,526,272,500,772
1000,484,507,492,248,496,744
1000,492,495,485,256,478,734
1000,501,498,503,249,507,756
1000,506,517,509,251,495,746
1000,513,520,483,249,501,750
1000,520,491,512,256,508,764
1000,464,464,484,201,524,725
1000,502,490,485,241,503,744
1000,528,521,486,290,474,764
1000,510,501,500,247,518,765
1000,496,521,494,243,491,734
1000,510,496,511,261,511,772
1000,508,504,543,262,515,777
1000,517,479,492,235,523,758
1000,507,526,477,268,470,738
1000,496,512,495,245,510,755
1000,522,528,491,273,479,752
1000,503,499,517,250,522,772
1000,477,494,506,241,498,739
1000,499,473,508,228,522,750
1000,490,488,499,241,499,740
1000,487,491,495,238,499,737
1000,495,484,486,244,498,742
1000,478,494,503,235,508,743
1000,494,517,496,255,480,735
1000,506,515,508,255,492,747
1000,496,462,496,226,527,753
1000,504,522,518,271,493,764
1000,498,493,484,240,502,742
1000,493,515,494,254,498,752
1000,517,516,498,268,487,755
1000,512,502,513,271,501,772
1000,483,488,516,230,512,742
1000,491,504,496,247,504,751
1000,510,473,498,257,516,773
1000,489,483,466,237,497,734
1000,508,513,495,254,512,766
1000,483,508,505,244,483,727
1000,496,504,540,252,505,757
1000,493,484,503,240,523,763
1000,501,506,498,261,487,748
1000,515,505,512,258,505,763
1000,544,488,501,274,521,795
1000,480,500,518,240,506,746
1000,523,482,517,268,492,760
1000,514,484,508,243,513,756
1000,493,529,494,269,478,747
1000,496,521,509,254,493,747
1000,541,477,520,243,550,793
1000,491,505,516,250,501,751
1000,478,523,492,259,479,738
1000,500,502,472,258,486,744
1000,484,492,513,243,503,746
1000,504,494,502,253,497,750
1000,511,527,489,270,476,746
1000,485,469,505,232,517,749
1000,484,474,495,236,512,748
1000,488,483,501,232,515,747
1000,515,475,518,251,509,760
1000,471,495,487,230,502,732
1000,485,478,496,240,493,733
1000,512,487,506,237,514,751
1000,513,505,504,271,481,752
1000,499,494,487,248,493,741
1000,507,507,531,265,490,755
1000,522,469,499,253,503,756
1000,510,526,503,273,483,756
1000,517,510,485,272,475,747
1000,496,524,495,246,495,741
1000,530,502,492,264,507,771
1000,491,496,533,230,527,757
1000,487,501,511,246,498,744
1000,508,494,496,238,516,754
1000,496,498,537,246,524,770
1000,477,514,523,238,512,750
1000,503,487,488,241,497,738
1000,512,506,517,260,500,760
1000,494,519,483,268,461,729
1000,515,490,500,253,504,757
1000,477,511,502,243,492,735
1000,464,486,476,227,500,727
1000,478,506,522,244,511,755
1000,485,483,504,230,518,748
1000,500,514,478,243,493,736
1000,469,492,532,240,498,738
1000,518,503,506,250,510,760
1000,469,509,506,246,492,738
1000,528,498,488,268,494,762
1000,473,488,458,253,451,704
1000,518,492,494,254,501,755
1000,489,495,480,257,475,732
1000,481,484,547,227,544,771
1000,503,496,498,250,501,751
1000,505,521,474,260,481,741
1000,510,475,479,250,495,745
1000,484,526,491,250,496,746
1000,497,492,487,241,505,746
1000,478,504,503,242,500,742
1000,507,503,496,256,494,750
1000,498,486,485,243,500,743
1000,507,498,478,246,506,752
1000,473,484,500,219,524,743
1000,503,496,504,248,506,754
1000,501,479,510,234,521,755
1000,520,478,513,249,506,755
1000,501,521,494,263,485,748
1000,499,525,467,252,484,736
1000,507,486,484,263,472,735
1000,469,480,500,233,507,740
1000,493,502,494,249,504,753
1000,510,501,481,255,491,746
1000,495,493,498,236,514,750
1000,459,481,474,220,494,714
1000,518,512,498,268,476,744
1000,493,481,494,238,506,744
1000,503,498,487,256,493,749
1000,497,473,505,241,509,750
1000,511,484,507,248,517,765
1000,469,504,456,243,470,713
1000,486,506,509,235,516,751
1000,522,510,510,261,495,756
1000,502,544,500,265,495,760
1000,493,470,495,228,506,734
1000,471,505,521,242,504,746
1000,535,501,506,270,510,780
1000,479,492,488,245,475,720
1000,521,533,497,273,488,761
1000,484,518,491,255,486,741
1000,492,526,459,267,468,735
1000,486,512,485,265,470,735
1000,512,461,476,243,497,740
1000,504,506,483,253,490,743
1000,487,501,470,244,478,722
1000,514,492,477,249,494,743
1000,525,499,498,260,512,772
1000,523,495,506,265,513,778
1000,506,519,471,259,493,752
1000,515,512,496,259,496,755
1000,516,494,520,264,512,776
1000,512,493,517,248,509,757
1000,491,522,479,258,475,733
1000,489,492,512,243,508,751
1000,502,496,504,243,498,741
1000,486,496,506,247,502,749
1000,498,492,480,242,478,720
1000,530,534,511,268,508,776
1000,502,509,483,243,497,740
1000,485,486,461,241,477,718
1000,525,488,496,256,506,762
1000,508,486,507,247,535,782
1000,496,483,501,238,520,758
1000,515,507,496,268,487,755
1000,488,475,519,239,516,755
1000,508,500,495,264,475,739
1000,479,488,496,230,509,739
1000,501,511,491,260,494,754
1000,481,478,511,233,514,747
1000,529,505,511,265,494,759
1000,526,502,486,256,509,765
1000,509,514,489,262,494,756
1000,503,494,516,235,527,762
1000,521,503,471,252,502,754
1000,515,501,526,250,529,779
1000,481,499,516,244,501,745
1000,522,502,514,268,485,753
1000,536,510,471,266,486,752
1000,490,515,516,250,499,749
1000,498,532,499,250,495,745
1000,510,490,511,249,502,751
1000,456,490,505,212,526,738
1000,527,516,485,285,478,763
1000,485,503,488,250,496,746
1000,499,508,499,261,493,754
1000,509,518,505,270,492,762
1000,485,483,494,240,487,727
1000,493,507,501,246,500,746
1000,520,485,511,258,510,768
1000,509,518,482,260,486,746
1000,494,520,510,262,482,744
1000,494,471,517,234,530,764
1000,502,505,524,247,528,775
1000,481,506,517,246,499,745
1000,497,495,494,248,484,732
1000,502,515,505,264,483,747
1000,500,485,496,247,495,742
1000,515,513,503,262,499,761
1000,476,512,516,243,496,739
1000,446,502,511,222,511,733
1000,517,509,498,264,483,747
1000,496,502,490,239,507,746
1000,505,505,535,246,527,773
1000,499,519,502,272,471,743
1000,509,492,474,263,460,723
1000,494,502,510,252,509,761
1000,518,503,531,272,509,781
1000,502,508,508,256,501,757
1000,470,496,508,231,511,742
1000,500,511,484,254,489,743
1000,494,505,495,248,508,756
1000,484,514,495,238,498,736
1000,499,531,513,272,478,750
1000,479,503,521,228,534,762
1000,481,492,501,244,483,727
1000,492,494,485,246,486,732
1000,519,494,495,271,490,761
1000,481,505,507,242,500,742
1000,482,486,482,217,523,740
1000,490,507,475,251,469,720
1000,492,487,494,227,511,738
1000,500,500,495,258,483,741
1000,503,503,498,250,484,734
1000,505,509,478,250,500,750
1000,504,463,496,247,505,752
1000,516,491,514,254,509,763
1000,494,512,498,253,484,737
1000,490,507,503,257,488,745
1000,513,484,503,244,514,758
1000,503,518,478,258,496,754
1000,500,517,505,259,498,757
1000,485,499,505,248,496,744
1000,514,500,511,263,501,764
1000,515,516,488,264,472,736
1000,505,491,497,247,513,760
1000,511,511,489,257,483,740
1000,505,484,482,237,495,732
1000,502,486,525,243,518,761
1000,512,493,511,256,516,772
1000,508,494,496,242,511,753
1000,503,504,504,238,515,753
1000,517,486,492,248,515,763
1000,513,491,489,263,494,757
1000,523,506,498,269,486,755
1000,495,469,505,226,520,746
1000,484,478,497,228,504,732
1000,488,502,491,255,486,741
1000,502,503,499,240,507,747
1000,484,503,478,238,502,740
1000,510,504,508,257,506,763
1000,482,493,486,235,494,729
1000,533,479,510,260,515,775
1000,500,495,476,253,487,740
1000,493,479,511,233,531,764
1000,507,503,519,251,503,754
1000,499,479,515,238,531,769
1000,503,481,499,245,520,765
1000,525,506,520,265,509,774
1000,489,478,514,233,513,746
1000,504,488,504,245,503,748
1000,512,506,515,245,510,755
1000,478,468,507,223,519,742
1000,481,513,530,256,483,739
1000,479,491,496,233,508,741
1000,500,490,502,235,529,764
1000,527,482,513,255,524,779
1000,485,510,520,259,499,758
1000,481,490,484,240,499,739
1000,498,514,505,258,500,758
1000,511,489,486,261,496,757
1000,471,485,505,231,510,741
1000,507,505,505,245,521,766
1000,503,485,466,246,491,737
1000,495,483,505,246,506,752
1000,489,516,487,249,495,744
1000,495,522,502,256,505,761
1000,501,531,533,273,498,771
1000,498,506,511,244,518,762
1000,486,507,524,247,487,734
1000,487,487,484,242,501,743
1000,500,508,489,261,477,738
1000,473,524,483,244,490,734
1000,482,502,506,233,512,745
1000,505,491,499,257,492,749
1000,484,490,498,226,527,753
1000,496,489,519,239,517,756
1000,475,482,508,226,509,735
1000,501,488,484,233,524,757
1000,509,490,481,248,505,753
1000,509,506,485,258,496,754
1000,477,517,506,242,499,741
1000,489,488,483,245,474,719
1000,507,507,484,256,495,751
1000,475,508,527,250,503,753
1000,487,504,448,235,493,728
1000,500,505,477,239,496,735
1000,490,516,525,255,482,737
1000,476,514,492,243,480,723
1000,496,511,528,240,512,752
1000,512,501,502,260,495,755
1000,519,505,509,263,498,761
1000,495,508,504,238,504,742
1000,491,470,514,229,525,754
1000,484,517,505,245,514,759
1000,503,502,502,253,508,761
1000,503,488,490,242,505,747
1000,498,495,513,257,512,769
1000,491,508,477,240,493,733
1000,522,506,504,271,495,766
1000,532,512,501,298,474,772
1000,511,502,492,262,490,752
1000,514,502,490,256,508,764
1000,511,502,496,274,470,744
1000,467,495,486,232,504,736
1000,495,498,500,249,483,732
1000,508,504,502,245,514,759
1000,500,521,489,264,488,752
1000,478,498,490,236,505,741
1000,501,502,498,257,496,753
1000,485,501,508,241,507,748
1000,513,474,476,246,495,741
1000,510,493,496,256,490,746
1000,482,492,498,239,502,741
1000,501,485,512,244,511,755
1000,490,521,502,265,492,757
1000,522,497,495,254,496,750
1000,495,501,502,268,488,756
1000,503,505,500,250,509,759
1000,485,504,500,228,511,739
1000,497,478,487,238,502,740
1000,505,516,463,244,488,732
1000,497,498,500,245,498,743
1000,513,498,503,248,503,751
1000,495,487,488,244,495,739
1000,503,472,487,241,520,761
1000,485,480,473,233,482,715
1000,511,508,517,259,508,767
1000,500,495,518,240,516,756
1000,500,509,531,254,510,764
1000,524,501,497,253,521,774
1000,495,520,521,251,525,776
1000,507,491,522,268,488,756
1000,485,516,490,259,474,733
1000,488,509,526,259,509,768
1000,513,483,507,252,504,756
1000,486,503,453,244,468,712
1000,491,485,497,233,523,756
1000,495,507,490,247,492,739
1000,514,491,500,244,523,767
1000,526,497,511,247,526,773
1000,508,515,499,270,475,745
1000,529,466,461,239,503,742
1000,510,503,501,264,483,747
1000,499,487,522,228,530,758
1000,471,508,461,232,476,708
1000,483,515,484,252,473,725
1000,490,504,493,230,512,742
1000,524,488,508,255,517,772
1000,502,505,506,253,498,751
1000,520,514,525,257,522,779
1000,491,504,500,236,504,740
1000,512,498,512,258,504,762
1000,512,505,487,259,493,752
1000,496,517,515,255,498,753
1000,528,502,508,271,479,750
1000,491,493,478,248,496,744
1000,517,512,491,276,490,766
1000,502,494,508,247,502,749
1000,509,523,474,274,473,747
1000,522,501,485,273,484,757
1000,494,510,498,243,502,745
1000,480,499,484,239,503,742
1000,500,494,479,241,497,738
1000,509,516,509,265,498,763
1000,482,518,502,249,494,743
1000,521,510,500,270,488,758
1000,495,493,497,241,508,749
1000,517,491,516,250,520,770
1000,519,478,489,243,507,750
1000,519,508,476,261,495,756
1000,516,506,491,253,501,754
1000,489,514,507,253,496,749
1000,498,500,504,241,502,743
1000,482,510,475,256,461,717
1000,468,508,503,244,481,725
1000,486,491,492,254,497,751
1000,527,521,484,272,487,759
1000,521,492,515,245,527,772
1000,489,517,501,254,496,750
1000,492,473,515,241,507,748
1000,483,503,496,248,480,728
1000,477,499,487,237,502,739
1000,490,486,487,225,499,724
1000,496,527,491,242,511,753
1000,523,484,491,241,506,747
1000,498,507,513,258,487,745
1000,493,484,501,239,504,743
1000,503,474,495,233,506,739
1000,452,489,488,223,504,727
1000,496,491,517,234,529,763
1000,493,500,492,255,500,755
1000,501,513,508,262,496,758
1000,480,497,483,232,495,727
1000,510,517,549,255,517,772
1000,470,497,497,231,501,732
1000,508,500,504,256,498,754
1000,516,475,492,247,509,756
1000,491,512,513,248,510,758
1000,515,490,497,258,494,752
1000,475,502,489,226,503,729
1000,474,474,527,220,545,765
1000,497,493,475,256,473,729
1000,488,476,509,220,531,751
1000,521,510,498,273,483,756
1000,488,490,503,243,502,745
1000,492,474,523,221,545,766
1000,532,492,482,267,469,736
1000,487,466,517,231,512,743
1000,494,515,486,262,465,727
1000,480,500,488,242,493,735
1000,514,515,514,266,502,768
1000,495,502,502,240,508,748
1000,505,512,471,262,496,758
1000,501,510,472,252,487,739
1000,509,530,505,265,488,753
1000,502,484,516,235,506,741
1000,506,474,481,235,500,735
1000,484,509,518,253,503,756
1000,483,495,492,226,509,735
1000,517,495,488,258,501,759
1000,496,493,482,250,484,734
1000,504,496,519,244,514,758
1000,518,506,495,271,483,754
1000,467,499,507,232,511,743
1000,505,504,491,258,489,747
1000,517,466,467,240,508,748
1000,507,509,502,256,510,766
1000,493,510,512,247,502,749
1000,528,474,505,240,530,770
1000,531,491,492,260,498,758
1000,480,495,512,240,505,745
1000,544,477,489,273,487,760
1000,499,484,493,239,503,742
1000,487,504,499,244,507,751
1000,513,500,522,262,495,757
1000,514,465,484,239,499,738
1000,493,492,509,231,518,749
1000,497,515,475,262,474,736
1000,494,502,501,234,507,741
1000,471,496,501,221,519,740
1000,504,498,507,249,507,756
1000,518,514,501,261,503,764
1000,507,485,460,257,483,740
1000,501,497,492,251,510,761
1000,459,501,487,233,497,730
1000,491,519,497,259,485,744
1000,514,504,492,256,473,729
1000,508,508,483,267,486,753
1000,479,489,496,228,499,727
1000,493,499,487,240,499,739
1000,495,507,492,250,485,735
1000,477,463,495,233,488,721
1000,501,479,489,226,511,737
1000,486,504,489,245,488,733
1000,498,502,493,267,478,745
1000,528,472,504,237,522,759
1000,499,497,508,234,516,750
1000,526,471,462,234,490,724
1000,506,488,507,240,516,756
1000,514,513,491,265,498,763
1000,479,512,514,246,511,757
1000,523,492,480,259,499,758
1000,510,504,512,249,505,754
1000,487,475,511,232,528,760
1000,477,508,477,227,506,733
1000,520,515,506,281,484,765
1000,500,495,496,255,492,747
1000,521,528,534,262,509,771
1000,509,513,496,253,497,750
1000,503,491,488,246,508,754
1000,492,519,487,255,486,741
1000,522,514,501,274,483,757
1000,478,479,484,245,476,721
1000,493,495,503,243,495,738
1000,512,537,492,264,486,750
1000,503,513,489,261,496,757
1000,488,509,509,244,508,752
1000,505,469,506,233,500,733
1000,485,468,495,230,516,746
1000,488,509,506,231,531,762
1000,511,515,493,249,504,753
1000,477,490,494,228,495,723
1000,499,473,500,228,535,763
1000,485,502,489,243,486,729
1000,532,509,505,270,500,770
1000,529,498,495,249,504,753
1000,508,494,479,255,491,746
1000,522,485,521,245,520,765
1000,504,495,482,244,511,755
1000,507,493,488,251,502,753
1000,500,468,519,236,524,760
1000,480,512,497,257,485,742
1000,482,512,500,254,487,741
1000,504,486,476,257,482,739
1000,530,533,477,282,460,742
1000,512,490,509,237,529,766
1000,525,489,487,249,510,759
1000,485,497,503,233,491,724
1000,497,521,514,265,486,751
1000,507,505,488,254,485,739
1000,494,507,498,254,485,739
1000,492,509,510,251,509,760
1000,505,489,500,264,491,755
1000,518,489,509,235,544,779
1000,536,503,519,257,526,783
1000,488,516,531,244,519,763
1000,495,496,489,252,501,753
1000,493,484,483,239,496,735
1000,500,490,506,239,519,758
1000,514,490,479,260,476,736
1000,495,500,510,254,495,749
1000,511,476,518,236,538,774
1000,505,521,484,260,478,738
1000,495,497,536,251,498,749
1000,498,507,495,259,491,750
1000,496,494,475,249,482,731
1000,491,489,501,231,528,759
1000,502,487,495,247,502,749
1000,461,511,487,238,498,736
1000,512,501,486,251,498,749
1000,497,507,499,248,509,757
1000,475,494,496,228,507,735
1000,498,487,494,238,521,759
1000,481,492,474,229,516,745
1000,500,499,504,249,493,742
1000,505,492,496,230,530,760
1000,512,463,494,231,524,755
1000,517,498,500,250,498,748
1000,510,476,478,234,507,741
1000,488,494,497,249,490,739
1000,498,493,499,242,503,745
1000,498,493,503,238,509,747
1000,521,482,469,261,483,744
1000,481,524,492,262,480,742
1000,508,509,489,264,487,751
1000,496,513,498,255,484,739
1000,512,475,514,250,512,762
1000,495,513,474,250,474,724
1000,513,503,490,257,497,754
1000,502,490,485,241,503,744
1000,504,494,485,244,501,745
1000,499,512,488,256,498,754
1000,506,502,494,242,499,741
1000,519,493,494,245,527,772
1000,499,466,515,237,520,757
1000,513,470,497,245,510,755
1000,493,512,489,256,483,739
1000,500,478,501,237,507,744
1000,480,514,517,268,492,760
1000,503,502,528,254,516,770
1000,511,523,502,251,508,759
1000,515,485,484,259,495,754
1000,506,486,500,252,495,747
1000,506,504,509,248,516,764
1000,510,488,491,237,506,743
1000,487,475,458,230,499,729
1000,488,524,507,254,487,741
1000,509,470,512,240,524,764
1000,506,495,510,249,512,761
1000,491,496,455,231,498,729
1000,522,495,513,260,505,765
1000,503,548,458,289,439,728
1000,478,503,524,237,517,754
1000,525,481,512,245,535,780
1000,476,513,498,235,509,744
1000,514,479,482,243,499,742
1000,508,485,498,250,503,753
1000,498,494,496,238,510,748
1000,505,490,490,237,501,738
1000,503,530,494,266,488,754
1000,514,499,506,248,514,762
1000,503,466,511,243,504,747
1000,511,501,518,247,521,768
1000,507,496,482,252,496,748
1000,517,497,487,253,492,745
1000,480,491,533,241,532,773
1000,505,520,527,250,510,760
1000,515,512,480,276,468,744
1000,467,523,502,250,479,729
1000,490,474,523,244,514,758
1000,490,503,489,246,495,741
1000,502,469,490,239,520,759
1000,515,536,497,276,474,750
1000,481,512,497,238,502,740
1000,508,493,509,251,509,760
1000,530,504,514,280,489,769
1000,503,530,505,265,500,765
1000,497,517,485,264,486,750
1000,500,507,478,273,464,737
1000,515,493,535,245,525,770
1000,493,499,487,242,484,726
1000,485,499,520,233,521,754
1000,512,532,513,275,483,758
1000,498,519,515,263,491,754
1000,497,482,484,230,500,730
1000,479,507,486,259,474,733
1000,513,509,500,266,493,759
1000,486,522,507,265,471,736
1000,482,509,493,257,470,727
1000,483,506,472,253,474,727
1000,503,490,485,253,489,742
1000,500,483,506,243,500,743
1000,490,500,487,251,484,735
1000,495,501,532,234,513,747
1000,519,504,484,268,500,768
1000,486,491,479,232,508,740
1000,494,504,469,242,497,739
1000,509,512,460,259,489,748
1000,503,505,495,245,499,744
1000,499,493,538,250,533,783
1000,482,485,491,237,502,739
1000,502,500,512,264,483,747
1000,515,488,500,257,488,745
1000,483,484,497,248,494,742
1000,494,486,482,254,493,747
1000,484,485,471,235,493,728
1000,508,528,495,271,500,771
1000,487,484,506,238,511,749
1000,486,492,505,241,510,751
1000,519,507,510,261,500,761
1000,487,521,517,255,504,759
1000,477,493,496,234,503,737
1000,488,492,500,230,511,741
1000,541,484,524,265,517,782
1000,536,506,499,259,510,769
1000,498,501,512,250,503,753
1000,509,506,499,272,492,764
1000,497,486,512,242,509,751
1000,490,519,497,248,495,743
1000,505,488,481,248,496,744
1000,483,499,520,236,515,751
1000,489,527,520,240,512,752
1000,501,499,501,242,519,761
1000,481,507,502,248,491,739
1000,481,511,495,248,492,740
1000,503,480,487,256,489,745
1000,536,497,501,252,518,770
1000,483,512,491,251,487,738
1000,497,497,512,241,514,755
1000,510,519,516,266,500,766
1000,517,498,496,263,494,757
1000,480,491,499,229,502,731
1000,481,520,503,256,483,739
1000,504,496,499,265,480,745
1000,490,477,510,233,506,739
1000,518,506,521,262,500,762
1000,494,488,492,232,522,754
1000,512,481,491,265,497,762
1000,514,482,479,244,514,758
1000,504,539,497,278,484,762
1000,487,506,498,262,482,744
1000,526,500,522,253,534,787
1000,502,526,505,281,475,756
1000,507,505,489,254,504,758
1000,507,489,492,251,487,738
1000,516,511,511,266,496,762
1000,504,519,506,261,486,747
1000,483,510,514,236,514,750
1000,502,543,469,298,435,733
1000,518,513,498,270,488,758
1000,517,530,520,264,501,765
1000,481,499,513,247,485,732
1000,465,464,493,214,508,722
1000,494,509,527,244,503,747
1000,517,509,518,259,521,780
1000,487,514,488,251,483,734
1000,478,504,501,241,496,737
1000,490,474,479,229,520,749
1000,516,522,541,285,514,799
1000,482,500,500,234,493,727
1000,489,514,494,248,489,737
1000,486,480,489,233,505,738
1000,498,514,503,236,533,769
1000,523,499,493,252,513,765
1000,505,497,525,256,510,766
1000,481,527,497,257,494,751
1000,492,477,516,235,528,763
1000,505,490,497,234,518,752
1000,506,480,478,251,491,742
1000,494,521,478,246,483,729
1000,473,509,511,260,464,724
1000,497,505,502,257,504,761
1000,492,500,503,238,506,744
1000,499,507,508,256,509,765
1000,503,519,514,259,512,771
1000,500,507,525,261,491,752
1000,508,502,490,260,500,760
1000,507,501,522,259,494,753
1000,492,490,511,232,518,750
1000,499,521,481,273,462,735
1000,503,470,493,245,500,745
1000,501,488,496,241,494,735
1000,481,494,499,241,508,749
1000,487,490,483,231,504,735
1000,506,495,511,258,500,758
1000,503,500,517,250,515,765
1000,493,509,485,244,497,741
1000,497,518,483,261,489,750
1000,481,508,501,253,490,743
1000,503,498,512,252,504,756
1000,531,495,523,272,504,776
1000,496,499,530,244,518,762
1000,495,480,488,242,504,746
1000,501,520,502,255,496,751
1000,516,513,478,261,488,749
1000,512,509,503,266,498,764
1000,477,484,516,222,532,754
1000,504,488,487,249,504,753
1000,503,481,516,261,499,760
1000,491,495,483,240,489,729
1000,505,509,498,256,486,742
1000,501,505,531,259,503,762
1000,484,502,503,249,491,740
1000,497,489,471,254,482,736
1000,476,501,518,235,511,746
1000,472,480,484,247,487,734
1000,488,507,485,252,473,725
1000,511,495,492,262,480,742
1000,509,482,481,251,500,751
1000,489,477,510,228,524,752
1000,497,500,490,245,494,739
1000,497,509,487,257,496,753
1000,495,488,522,247,509,756
1000,522,513,496,260,491,751
1000,508,496,464,243,502,745
1000,490,496,510,253,506,759
1000,510,492,503,239,515,754
1000,494,496,518,253,494,747
1000,503,488,485,242,506,748
1000,478,498,497,233,502,735
1000,490,526,493,263,467,730
1000,468,495,515,242,504,746
1000,525,509,487,285,477,762
1000,496,497,495,248,493,741
1000,499,492,475,234,493,727
1000,522,491,479,248,499,747
1000,505,520,527,260,505,765
1000,524,491,509,267,507,774
1000,521,495,521,252,537,789
1000,510,498,480,256,487,743
1000,487,500,481,244,489,733
1000,494,505,500,261,484,745
1000,527,518,494,263,490,753
1000,478,504,505,250,503,753
1000,493,535,503,266,462,728
1000,503,492,520,245,523,768
1000,502,526,492,261,474,735
1000,507,479,503,236,501,737
1000,498,503,510,248,520,768
1000,498,514,494,247,497,744
1000,474,483,472,234,492,726
1000,479,478,486,235,510,745
1000,504,490,481,243,482,725
1000,481,473,473,228,497,725
1000,506,487,486,259,493,752
1000,480,530,494,249,488,737
1000,471,483,512,223,516,739
1000,492,534,481,264,486,750
1000,520,524,475,280,462,742
1000,482,499,495,240,502,742
1000,506,496,510,256,503,759
1000,495,483,473,238,482,720
1000,489,499,502,260,489,749
1000,476,511,518,242,504,746
1000,520,500,481,268,486,754
1000,490,507,498,246,507,753
1000,544,505,488,272,497,769
1000,511,497,497,258,495,753
1000,511,517,516,261,490,751
1000,496,489,503,234,505,739
1000,498,490,520,233,517,750
1000,488,517,462,252,468,720
1000,497,494,520,246,504,750
1000,475,513,493,242,498,740
1000,503,546,504,283,469,752
1000,492,490,514,241,514,755
1000,505,515,520,267,496,763
1000,492,481,471,238,496,734
1000,499,504,509,252,511,763
1000,493,505,510,258,484,742
1000,510,482,517,254,506,760
1000,484,462,501,244,492,736
1000,477,500,507,237,507,744
1000,479,471,493,211,519,730
1000,467,510,479,232,501,733
1000,502,484,504,243,508,751
1000,507,512,512,251,519,770
1000,504,494,494,234,495,729
1000,501,507,506,255,507,762
1000,458,509,487,241,478,719
1000,490,516,492,260,474,734
1000,485,515,536,262,515,777
1000,483,485,517,219,544,763
1000,498,490,513,240,515,755
1000,498,517,505,265,498,763
1000,492,514,527,271,496,767
1000,489,501,475,241,492,733
1000,510,476,473,234,512,746
1000,443,500,500,219,498,717
1000,502,515,501,265,486,751
1000,496,487,510,230,546,776
1000,516,508,502,257,508,765
1000,520,506,492,284,469,753
1000,523,500,490,263,484,747
1000,496,501,515,243,507,750
1000,516,489,526,252,524,776
1000,495,528,511,268,482,750
1000,471,512,468,232,499,731
1000,530,518,506,267,505,772
1000,466,507,497,236,495,731
1000,502,474,468,243,477,720
1000,495,497,478,259,491,750
1000,497,506,513,261,502,763
1000,511,507,520,254,527,781
1000,473,499,508,227,511,738
1000,488,528,501,261,479,740
1000,486,496,539,245,528,773
1000,495,470,507,229,525,754
1000,500,502,511,243,518,761
1000,497,519,473,251,483,734
1000,473,486,507,236,509,745
1000,493,448,513,216,535,751
1000,508,483,481,238,514,752
1000,489,531,483,266,460,726
1000,515,486,514,254,510,764
1000,500,509,504,255,485,740
1000,532,522,479,266,478,744
1000,508,483,489,246,492,738
1000,527,485,470,255,495,750
1000,508,512,477,260,491,751
1000,487,487,531,229,530,759
1000,504,485,488,240,509,749
1000,486,508,493,254,472,726
1000,507,504,483,261,467,728
1000,487,506,510,252,491,743
1000,499,497,500,230,522,752
1000,477,481,494,231,507,738
1000,493,506,514,247,504,751
1000,504,502,502,247,503,750
1000,515,500,491,247,513,760
1000,507,483,513,260,505,765
1000,500,478,505,236,512,748
1000,488,495,493,240,498,738
1000,486,491,499,238,497,735
1000,469,504,513,243,487,730
1000,454,526,494,243,476,719
1000,504,480,499,236,519,755
1000,498,467,513,234,531,765
1000,476,487,485,232,494,726
1000,500,508,492,242,498,740
1000,497,514,488,252,477,729
1000,517,493,504,233,544,777
1000,513,530,510,274,485,759
1000,468,480,504,221,518,739
1000,481,496,493,225,508,733
1000,504,493,500,239,509,748
1000,502,509,485,257,480,737
1000,476,540,502,272,476,748
1000,525,483,499,255,503,758
1000,510,511,473,269,469,738
1000,490,493,489,230,513,743
1000,493,511,474,252,477,729
1000,507,490,487,247,498,745
1000,514,517,515,258,508,766
1000,506,482,515,240,520,760
1000,493,491,500,239,523,762
1000,496,477,503,238,523,761
1000,490,485,479,235,518,753
1000,523,497,494,252,495,747
1000,500,479,501,231,534,765
1000,498,527,513,274,479,753
1000,505,530,508,261,498,759
1000,494,505,497,229,513,742
1000,491,486,520,235,517,752
1000,489,501,481,236,502,738
1000,493,502,510,240,523,763
1000,502,477,506,226,538,764
1000,489,506,490,248,494,742
1000,496,523,494,253,486,739
1000,509,503,464,259,482,741
1000,487,503,508,242,511,753
1000,507,508,507,255,503,758
1000,489,517,484,258,479,737
1000,488,499,467,239,499,738
1000,487,498,493,243,498,741
1000,500,515,506,261,488,749
1000,494,517,494,257,486,743
1000,480,465,510,230,510,740
1000,511,470,493,230,529,759
1000,489,497,493,242,497,739
1000,504,478,487,242,511,753
1000,500,492,513,237,524,761
1000,498,501,521,235,533,768
1000,495,509,475,250,474,724
1000,507,509,477,260,469,729
1000,511,481,494,238,518,756
1000,495,495,528,250,511,761
1000,479,497,510,239,504,743
1000,515,508,504,258,507,765
1000,490,501,491,250,489,739
1000,498,503,487,239,486,725
1000,489,467,522,238,521,759
1000,517,482,517,270,504,774
1000,494,478,481,229,513,742
1000,487,507,504,247,501,748
1000,504,485,493,235,525,760
1000,495,507,510,258,485,743
1000,491,502,483,230,501,731
1000,497,513,503,257,481,738
1000,514,463,517,250,525,775
1000,514,487,500,258,501,759
1000,474,484,515,224,535,759
1000,505,498,523,241,507,748
1000,485,496,478,254,483,737
1000,492,494,478,239,499,738
1000,505,515,496,271,479,750
1000,506,536,497,270,475,745
1000,491,481,498,244,497,741
1000,501,488,494,245,519,764
1000,470,500,517,231,499,730
1000,500,507,536,260,490,750
1000,497,521,537,259,518,777
1000,514,515,509,254,495,749
1000,509,491,492,241,508,749
1000,508,512,498,268,507,775
1000,519,482,523,262,522,784
1000,520,492,493,251,514,765
1000,486,499,483,237,492,729
1000,482,497,481,245,491,736
1000,500,480,518,251,501,752
1000,488,492,515,239,520,759
1000,512,493,511,253,509,762
1000,495,482,524,238,507,745
1000,508,505,502,262,490,752
1000,520,494,534,261,507,768
1000,491,508,497,253,501,754
1000,506,504,463,247,486,733
1000,536,508,498,277,487,764
1000,491,529,506,245,493,738
1000,513,508,485,265,482,747
1000,504,493,497,260,483,743
1000,509,499,508,242,505,747
1000,485,501,497,245,508,753
1000,499,515,491,278,451,729
1000,503,512,499,253,504,757
1000,500,506,522,243,512,755
1000,521,514,508,265,492,757
1000,497,502,508,247,498,745
1000,481,533,512,265,491,756
1000,485,504,490,251,475,726
1000,522,487,484,255,503,758
1000,496,488,487,225,511,736
1000,508,467,523,235,535,770
1000,481,498,479,236,493,729
1000,514,496,508,248,522,770
1000,496,519,509,254,504,758
1000,512,495,487,254,509,763
1000,494,492,503,239,517,756
1000,501,530,500,269,476,745
1000,505,479,531,246,527,773
1000,463,502,485,224,492,716
1000,485,495,475,243,505,748
1000,496,501,469,243,496,739
1000,501,485,495,236,504,740
1000,499,486,506,227,518,745
1000,521,505,525,259,525,784
1000,488,522,522,250,499,749
1000,501,495,502,249,497,746
1000,494,493,497,251,499,750
1000,515,523,493,273,486,759
1000,487,495,496,233,506,739
1000,491,514,476,253,490,743
1000,492,509,519,239,523,762
1000,496,490,525,251,511,762
1000,515,507,502,259,505,764
1000,489,482,507,230,516,746
1000,510,482,471,250,480,730
1000,485,508,514,239,528,767
1000,473,490,482,227,495,722
1000,513,481,482,234,511,745
1000,536,477,512,259,517,776
1000,510,503,508,255,505,760
1000,501,498,507,246,511,757
1000,487,480,528,228,528,756
1000,504,493,524,244,530,774
1000,473,515,534,242,498,740
1000,498,503,482,253,483,736
1000,482,495,497,244,504,748
1000,517,521,541,264,513,777
1000,496,499,511,263,493,756
1000,491,519,507,248,508,756
1000,499,512,511,265,479,744
1000,511,488,508,241,520,761
1000,494,505,510,257,492,749
1000,516,474,495,238,519,757
1000,519,487,508,266,489,755
1000,512,474,506,242,523,765
1000,492,497,516,238,512,750
1000,469,497,495,225,499,724
1000,485,551,506,263,481,744
1000,505,524,510,272,480,752
1000,522,477,511,252,533,785
1000,526,480,508,254,520,774
1000,504,482,505,242,531,773
1000,481,502,527,244,507,751
1000,481,492,473,249,469,718
1000,510,476,482,245,497,742
1000,480,492,504,232,520,752
1000,509,503,481,256,485,741
1000,485,509,501,245,476,721
1000,487,479,484,223,513,736
1000,488,490,506,251,497,748
1000,490,513,498,248,509,757
1000,515,493,486,254,485,739
1000,506,507,490,250,517,767
1000,527,488,471,261,490,751
1000,501,499,503,234,531,765
1000,501,503,526,238,527,765
1000,502,507,480,256,485,741
1000,482,514,524,261,495,756
1000,501,504,505,243,503,746
1000,515,497,501,267,494,761
1000,485,504,520,249,501,750
1000,494,467,512,221,538,759
1000,522,522,515,269,493,762
1000,516,481,490,241,502,743
1000,482,503,475,243,483,726
1000,500,484,467,248,502,750
1000,514,481,500,263,497,760
1000,491,506,474,246,482,728
1000,527,486,517,258,520,778
1000,487,508,518,260,508,768
1000,488,508,478,256,463,719
1000,487,483,481,233,505,738
1000,519,461,491,248,505,753
1000,501,491,513,240,512,752
1000,489,509,499,240,507,747
1000,496,501,508,248,481,729
1000,502,519,510,271,496,767
1000,492,493,478,244,473,717
1000,481,505,510,234,497,731
1000,473,514,504,245,496,741
1000,476,488,492,241,498,739
1000,497,503,498,251,488,739
1000,502,478,481,249,489,738
1000,523,511,511,277,496,773
1000,524,516,521,286,485,771
1000,511,508,500,264,501,765
1000,527,472,494,234,526,760
1000,509,492,484,249,500,749
1000,464,512,514,245,488,733
1000,517,509,480,251,500,751
1000,496,512,490,264,474,738
1000,524,482,477,251,489,740
1000,508,478,499,244,500,744
1000,498,486,491,237,514,751
1000,497,510,516,261,496,757
1000,535,507,518,275,511,786
1000,523,481,518,259,503,762
1000,500,511,502,268,468,736
1000,507,485,469,234,496,730
1000,464,494,502,235,497,732
1000,521,513,519,269,498,767
1000,496,492,482,235,504,739
1000,514,479,502,251,493,744
1000,511,523,512,264,512,776
1000,519,494,471,259,491,750
1000,486,490,480,234,516,750
1000,483,466,502,245,496,741
1000,485,492,477,243,481,724
1000,518,495,495,256,501,757
1000,517,515,509,259,498,757
1000,488,490,505,234,517,751
1000,488,493,505,244,506,750
1000,509,490,536,256,519,775
1000,513,493,474,262,483,745
1000,467,483,512,211,526,737
1000,502,464,483,239,502,741
1000,503,512,506,261,494,755
1000,502,504,487,245,501,746
1000,491,510,483,265,463,728
1000,517,484,482,239,501,740
1000,499,492,507,229,517,746
1000,493,492,519,233,526,759
1000,510,504,506,260,504,764
1000,506,521,487,273,460,733
1000,512,487,496,253,498,751
1000,521,521,485,267,478,745
1000,494,485,514,244,515,759
1000,490,497,489,239,501,740
1000,480,502,498,250,485,735
1000,512,485,501,260,480,740
1000,471,502,506,245,497,742
1000,513,494,482,253,503,756
1000,490,504,500,243,501,744
1000,493,486,527,244,509,753
1000,473,473,497,211,538,749
1000,503,489,518,247,508,755
1000,490,497,494,246,506,752
1000,491,526,493,259,495,754
1000,504,486,505,246,504,750
1000,491,491,529,243,523,766
1000,472,505,468,217,511,728
1000,502,495,516,245,510,755
1000,492,489,514,243,508,751
1000,502,494,510,248,505,753
1000,515,495,489,258,483,741
1000,504,494,480,263,496,759
1000,482,514,515,251,497,748
1000,499,520,491,256,483,739
1000,489,521,479,268,469,737
1000,505,478,526,250,507,757
1000,492,493,503,239,499,738
1000,509,482,513,246,513,759
1000,520,483,496,245,511,756
1000,502,526,503,258,496,754
1000,503,514,502,269,476,745
1000,508,482,501,243,506,749
1000,485,516,537,250,515,765
1000,468,498,485,239,480,719
1000,530,531,492,276,475,751
1000,526,501,517,274,494,768
1000,504,471,499,228,515,743
1000,510,473,475,238,499,737
1000,509,503,496,256,505,761
1000,481,483,470,241,479,720
1000,490,479,513,232,513,745
1000,477,494,513,246,493,739
1000,508,510,492,284,469,753
1000,505,483,501,245,513,758
1000,502,486,500,243,520,763
1000,501,486,536,249,526,775
1000,500,482,517,235,514,749
1000,481,499,505,250,512,762
1000,505,481,495,232,531,763
1000,460,484,489,224,505,729
1000,473,502,507,245,514,759
1000,481,501,483,239,498,737
1000,524,496,454,271,463,734
1000,523,491,500,263,499,762
1000,462,520,513,243,510,753
1000,491,520,519,263,513,776
1000,513,513,502,257,506,763
1000,511,492,506,246,511,757
1000,502,499,495,250,507,757
1000,489,532,527,262,487,749
1000,515,503,506,268,491,759
1000,505,485,483,242,499,741
1000,505,522,489,270,466,736
1000,512,511,520,252,503,755
1000,493,524,487,245,489,734
1000,501,458,504,221,532,753
1000,484,519,510,252,493,745
1000,482,519,520,252,505,757
1000,493,513,496,249,493,742
1000,469,512,504,234,485,719
1000,502,502,511,239,523,762
1000,509,507,497,249,498,747
1000,498,494,492,264,477,741
1000,522,525,498,279,471,750
1000,484,472,500,219,531,750
1000,488,497,497,238,496,734
1000,474,514,495,231,499,730
1000,506,494,512,258,496,754
1000,542,480,482,259,519,778
1000,510,492,499,250,509,759
1000,518,507,483,262,495,757
1000,486,494,502,246,505,751
1000,518,504,503,279,491,770
1000,525,491,522,268,500,768
1000,527,497,498,267,480,747
1000,508,499,500,262,494,756
1000,476,521,507,228,528,756
1000,453,513,478,238,465,703
1000,511,508,504,262,486,748
1000,506,491,524,251,508,759
1000,482,498,486,243,479,722
1000,498,494,497,241,515,756
1000,490,501,487,235,506,741
1000,509,485,518,243,528,771
1000,519,493,485,261,496,757
1000,501,489,511,239,525,764
1000,518,481,535,259,524,783
1000,485,538,474,266,472,738
1000,512,521,537,270,502,772
1000,507,516,509,250,506,756
1000,498,492,496,246,496,742
1000,486,510,525,235,516,751
1000,494,509,506,243,503,746
1000,505,525,491,257,486,743
1000,482,501,498,242,490,732
1000,492,500,503,233,520,753
1000,513,503,498,262,498,760
1000,485,486,543,226,542,768
1000,527,496,506,257,498,755
1000,506,512,511,280,489,769
1000,502,518,505,267,483,750
1000,504,509,474,276,465,741
1000,498,512,531,261,523,784
1000,495,487,494,242,518,760
1000,498,497,506,254,509,763
1000,494,498,505,236,509,745
1000,498,486,503,245,494,739
1000,475,486,484,230,496,726
1000,501,508,502,255,505,760
1000,483,480,487,221,521,742
1000,485,541,516,252,501,753
1000,479,480,487,229,492,721
1000,512,507,525,270,498,768
1000,464,469,475,222,503,725
1000,520,467,504,236,524,760
1000,498,508,517,248,519,767
1000,490,522,491,246,489,735
1000,509,497,493,263,476,739
1000,502,516,504,257,499,756
1000,524,492,512,254,510,764
1000,491,500,501,240,500,740
1000,492,499,486,240,508,748
1000,444,517,501,239,477,716
1000,488,494,511,236,509,745
1000,508,500,511,257,490,747
1000,507,476,504,240,511,751
1000,492,503,493,247,496,743
1000,477,495,503,224,514,738
1000,500,514,480,253,492,745
1000,521,507,482,258,491,749
1000,508,498,518,248,509,757
1000,485,507,476,264,478,742
1000,528,488,505,244,537,781
1000,515,521,529,265,504,769
1000,511,512,483,259,490,749
1000,485,496,480,255,476,731
1000,496,500,472,236,494,730
1000,453,509,496,234,500,734
1000,494,525,498,253,480,733
1000,473,489,508,227,508,735
1000,472,519,519,245,514,759
1000,509,486,492,249,511,760
1000,488,519,497,255,488,743
1000,480,470,494,230,518,748
1000,477,514,500,254,476,730
1000,490,524,513,256,485,741
1000,486,515,494,264,489,753
1000,482,519,526,253,518,771
1000,518,515,497,264,497,761
1000,515,494,479,263,481,744
1000,492,528,491,256,502,758
1000,520,483,494,257,506,763
1000,500,489,504,239,511,750
1000,489,487,466,235,496,731
1000,481,506,492,243,493,736
1000,499,483,500,247,499,746
1000,501,492,486,242,502,744
1000,489,511,519,251,502,753
1000,476,484,508,235,496,731
1000,500,521,515,267,499,766
1000,505,502,478,267,475,742
1000,485,499,507,246,505,751
1000,469,515,526,249,498,747
1000,520,515,483,257,490,747
1000,507,495,484,266,476,742
1000,500,502,499,248,480,728
1000,510,499,475,256,495,751
1000,515,499,507,263,498,761
1000,505,492,474,231,520,751
1000,478,506,520,247,502,749
1000,503,495,487,243,505,748
1000,482,506,490,249,493,742
1000,496,498,479,248,490,738
1000,507,506,523,252,511,763
1000,495,512,512,265,486,751
1000,501,484,462,230,492,722
1000,495,479,503,237,509,746
1000,492,496,492,238,502,740
1000,494,496,488,245,504,749
1000,523,508,453,276,466,742
1000,512,490,513,244,506,750
1000,514,487,508,240,501,741
1000,464,502,508,224,518,742
1000,510,500,526,249,523,772
1000,501,488,508,250,501,751
1000,488,494,490,240,506,746
1000,500,492,504,250,499,749
1000,535,525,501,283,493,776
1000,475,483,502,224,510,734
1000,509,498,511,245,501,746
1000,521,513,487,271,474,745
1000,481,488,500,226,513,739
1000,476,502,497,227,511,738
1000,492,491,491,226,511,737
1000,506,509,506,256,497,753
1000,507,491,510,248,522,770
1000,527,502,495,258,517,775
1000,491,489,481,244,489,733
1000,497,499,499,246,515,761
1000,492,517,511,261,501,762
1000,469,509,485,234,483,717
1000,506,517,489,263,471,734
1000,493,523,502,250,505,755
1000,518,493,512,256,501,757
1000,506,474,505,233,526,759
1000,489,506,498,246,499,745
1000,483,507,518,257,500,757
1000,506,512,506,256,495,751
1000,513,515,552,267,525,792
1000,502,490,493,255,503,758
1000,500,488,499,231,512,743
1000,490,506,507,249,500,749
1000,514,510,489,267,468,735
1000,489,492,503,240,507,747
1000,494,517,493,266,487,753
1000,488,507,494,251,493,744
1000,502,496,492,256,502,758
1000,524,493,483,232,515,747
1000,475,512,494,244,476,720
1000,498,526,489,265,468,733
1000,518,503,470,263,497,760
1000,495,495,516,240,513,753
1000,473,516,493,239,496,735
1000,534,466,488,238,527,765
1000,505,498,483,239,489,728
1000,507,490,500,250,501,751
1000,500,492,514,249,512,761
1000,511,503,469,256,489,745
1000,496,514,490,248,501,749
1000,473,482,531,227,515,742
1000,511,489,484,256,489,745
1000,522,528,517,279,488,767
1000,509,491,502,230,522,752
1000,476,516,528,254,492,746
1000,526,489,476,255,500,755
1000,510,496,536,253,516,769
1000,486,504,518,258,488,746
1000,527,492,494,268,498,766
1000,495,486,475,229,501,730
1000,472,519,483,255,461,716
1000,499,500,523,259,502,761
1000,519,486,484,250,502,752
1000,529,492,495,260,502,762
1000,524,517,507,268,505,773
1000,497,508,477,250,488,738
1000,520,486,499,261,500,761
1000,507,527,491,256,487,743
1000,493,505,491,251,506,757
1000,518,502,486,265,488,753
1000,500,536,504,272,477,749
1000,481,470,531,221,552,773
1000,527,515,492,258,499,757
1000,488,476,528,237,517,754
1000,497,510,480,244,490,734
1000,491,507,489,256,474,730
1000,490,509,527,246,517,763
1000,475,505,533,246,516,762
1000,504,519,482,263,475,738
1000,468,497,476,232,488,720
1000,473,504,519,243,495,738
1000,505,513,526,260,504,764
1000,521,500,516,262,504,766
1000,515,479,492,242,525,767
1000,495,493,525,251,512,763
1000,476,500,503,246,487,733
1000,483,492,492,236,497,733
1000,496,528,526,256,488,744
1000,470,515,488,240,494,734
1000,506,529,523,269,506,775
1000,499,526,499,255,480,735
1000,511,488,507,242,515,757
1000,505,499,507,245,497,742
1000,480,508,471,238,491,729
1000,478,510,495,241,484,725
1000,487,502,506,239,509,748
1000,519,496,504,255,521,776
1000,529,489,500,263,509,772
1000,485,487,506,248,509,757
1000,493,521,526,260,502,762
1000,484,512,511,259,494,753
1000,475,506,511,241,501,742
1000,494,500,498,243,517,760
1000,533,509,488,277,501,778
1000,486,495,509,236,508,744
1000,497,488,482,241,496,737
1000,473,499,495,251,476,727
1000,487,513,479,263,472,735
1000,491,524,489,242,502,744
1000,501,500,492,254,486,740
1000,515,495,488,259,488,747
1000,497,504,488,236,512,748
1000,494,478,495,244,500,744
1000,492,487,524,241,514,755
1000,504,494,493,255,500,755
1000,496,502,474,258,471,729
1000,503,505,477,257,481,738
1000,486,487,502,248,512,760
1000,490,467,489,222,524,746
1000,525,529,497,282,477,759
1000,496,506,487,249,495,744
1000,495,499,521,251,525,776
1000,502,507,495,249,503,752
1000,503,507,501,258,484,742
1000,502,509,492,257,495,752
1000,501,505,526,271,490,761
1000,499,468,494,228,513,741
1000,537,525,506,288,471,759
1000,485,494,474,247,477,724
1000,490,488,519,239,500,739
1000,514,514,493,265,498,763
1000,525,524,500,273,496,769
1000,496,490,499,236,507,743
1000,503,478,491,231,519,750
1000,493,523,502,251,505,756
1000,493,505,478,235,481,716
1000,496,509,506,259,496,755
1000,481,501,524,240,516,756
1000,483,499,501,230,508,738
1000,467,486,510,237,496,733
1000,492,475,484,212,530,742
1000,492,503,521,246,508,754
1000,491,499,510,232,509,741
1000,501,498,524,263,504,767
1000,470,483,485,240,496,736
1000,473,510,499,241,513,754
1000,516,543,525,283,479,762
1000,490,505,521,241,517,758
1000,490,501,509,251,500,751
1000,503,500,493,252,493,745
1000,490,494,500,238,505,743
1000,501,493,510,246,488,734
1000,509,513,502,249,512,761
1000,487,500,487,229,511,740
1000,514,516,482,263,485,748
1000,488,518,480,267,461,728
1000,471,497,493,235,483,718
1000,487,531,525,263,511,774
1000,492,498,483,244,506,750
1000,504,502,491,255,477,732
1000,501,493,489,234,505,739
1000,480,498,497,230,509,739
1000,494,513,522,252,504,756
1000,489,514,525,263,500,763
1000,527,511,483,274,489,763
1000,510,532,494,263,492,755
1000,502,518,517,261,503,764
1000,520,482,508,257,505,762
1000,505,525,503,273,483,756
1000,502,487,496,241,506,747
1000,497,503,513,247,515,762
1000,512,487,495,235,528,763
1000,526,525,517,281,488,769
1000,502,495,508,258,501,759
1000,504,506,509,257,504,761
1000,488,507,510,247,486,733
1000,493,506,503,252,496,748
1000,490,493,493,241,506,747
1000,508,489,514,254,500,754
1000,527,533,536,264,507,771
1000,522,493,512,247,519,766
1000,504,504,483,261,474,735
1000,485,509,488,238,491,729
1000,531,476,528,243,531,774
1000,508,527,500,262,499,761
1000,531,511,464,261,475,736
1000,482,503,482,242,496,738
1000,515,525,473,266,485,751
1000,507,508,494,251,511,762
1000,470,489,503,235,515,750
1000,498,527,508,259,500,759
1000,531,513,490,271,490,761
1000,503,516,547,266,509,775
1000,516,478,500,252,505,757
1000,492,496,509,247,508,755
1000,495,512,503,257,480,737
1000,495,516,528,240,516,756
1000,474,492,506,235,509,744
1000,496,507,488,258,489,747
1000,505,467,501,240,513,753
1000,508,509,477,254,499,753
1000,505,509,526,259,484,743
1000,479,479,503,237,498,735
1000,480,490,505,227,517,744
1000,518,490,498,245,508,753
1000,482,514,483,239,489,728
1000,499,506,531,259,508,767
1000,510,488,490,238,504,742
1000,499,473,496,237,497,734
1000,521,490,506,255,517,772
1000,476,506,501,248,489,737
1000,510,508,510,267,499,766
1000,502,533,505,268,477,745
1000,492,492,533,234,537,771
1000,488,516,529,256,512,768
1000,501,516,495,265,475,740
1000,506,520,514,268,487,755
1000,505,491,513,260,503,763
1000,507,514,491,258,497,755
1000,499,534,506,261,498,759
1000,492,522,517,246,503,749
1000,488,491,527,240,515,755
1000,476,507,519,232,505,737
1000,521,466,508,240,537,777
1000,484,511,516,238,510,748
1000,483,505,491,231,499,730
1000,520,510,505,271,478,749
1000,495,521,489,238,504,742
1000,481,499,483,234,501,735
1000,491,499,490,248,493,741
1000,476,476,483,235,478,713
1000,532,526,528,288,478,766
1000,515,520,513,254,503,757
1000,511,496,497,241,505,746
1000,495,498,469,241,482,723
1000,507,489,491,242,510,752
1000,495,519,532,251,523,774
1000,497,504,492,231,505,736
1000,488,505,479,251,491,742
1000,532,499,522,263,526,789
1000,505,477,520,240,522,762
1000,487,475,515,232,534,766
1000,494,454,491,226,522,748
1000,486,495,520,236,513,749
1000,512,498,515,248,521,769
1000,512,514,514,267,493,760
1000,517,514,495,258,506,764
1000,537,510,473,288,466,754
1000,492,521,530,240,536,776
1000,495,500,485,245,488,733
1000,466,494,498,227,513,740
1000,501,493,522,232,529,761
1000,495,503,515,246,526,772
1000,495,511,500,232,527,759
1000,519,476,473,251,482,733
1000,510,495,480,247,497,744
1000,498,508,514,261,499,760
1000,529,513,461,275,469,744
1000,516,517,504,268,503,771
1000,503,475,496,235,520,755
1000,509,519,504,265,492,757
1000,521,507,506,258,517,775
1000,476,479,487,223,517,740
1000,522,512,506,267,495,762
1000,510,499,486,256,484,740
1000,476,501,506,232,516,748
1000,485,480,518,235,505,740
1000,502,494,503,247,496,743
1000,496,518,485,254,497,751
1000,500,510,511,257,492,749
1000,526,517,516,280,493,773
1000,490,487,479,225,506,731
1000,507,496,516,268,496,764
1000,526,481,501,249,501,750
1000,493,513,523,254,513,767
1000,478,479,488,237,480,717
1000,520,497,523,261,511,772
1000,509,510,500,266,496,762
1000,499,517,512,246,505,751
1000,488,485,479,233,493,726
1000,460,495,496,229,496,725
1000,515,516,476,261,489,750
1000,510,480,502,238,530,768
1000,502,506,501,250,516,766
1000,495,526,489,274,473,747
1000,487,510,536,249,521,770
1000,529,521,503,284,466,750
1000,481,507,476,241,487,728
1000,494,468,507,232,516,748
1000,481,500,498,241,496,737
1000,505,487,511,247,506,753
1000,500,477,526,242,524,766
1000,502,506,479,252,492,744
1000,493,510,494,238,510,748
1000,484,513,488,248,472,720
1000,491,525,509,245,490,735
1000,486,493,483,245,492,737
1000,530,491,485,261,504,765
1000,517,517,497,280,468,748
1000,501,475,507,227,529,756
1000,498,500,529,247,516,763
1000,505,517,485,252,483,735
1000,513,519,526,280,493,773
1000,489,493,526,235,522,757
1000,510,497,519,255,511,766
1000,506,478,499,233,530,763
1000,505,518,512,263,496,759
1000,501,496,484,239,505,744
1000,500,490,483,262,474,736
1000,503,521,485,260,485,745
1000,486,497,499,239,493,732
1000,510,493,515,243,519,762
1000,508,504,498,261,485,746
1000,497,491,487,247,485,732
1000,507,491,493,248,508,756
1000,504,496,489,247,514,761
1000,514,517,479,249,504,753
1000,477,516,488,249,479,728
1000,525,486,503,258,517,775
1000,479,465,481,205,532,737
1000,501,500,498,247,497,744
1000,480,484,493,230,515,745
1000,498,474,539,225,543,768
1000,503,492,486,248,480,728
1000,486,491,510,235,514,749
1000,503,478,489,248,502,750
1000,486,491,508,241,504,745
1000,521,538,503,286,461,747
1000,500,507,513,255,494,749
1000,495,533,514,290,483,773
1000,483,487,504,240,487,727
1000,484,483,520,240,500,740
1000,499,491,506,246,503,749
1000,524,488,520,258,530,788
1000,484,514,514,230,525,755
1000,526,503,501,273,486,759
1000,517,474,502,243,535,778
1000,492,472,513,240,506,746
1000,496,499,516,248,505,753
1000,496,489,492,252,497,749
1000,487,513,507,237,489,726
1000,514,529,485,254,501,755
1000,509,493,497,253,492,745
1000,484,518,515,250,503,753
1000,493,513,517,236,522,758
1000,478,518,485,248,475,723
1000,519,497,505,258,512,770
1000,520,514,512,285,481,766
1000,502,488,518,240,517,757
1000,483,493,496,243,502,745
1000,506,540,484,271,474,745
1000,522,487,493,264,496,760
1000,511,495,500,266,495,761
1000,508,485,482,249,497,746
1000,473,500,493,224,507,731
1000,496,518,506,261,504,765
1000,493,488,511,250,486,736
1000,501,518,505,243,510,753
1000,490,499,493,245,500,745
1000,503,488,525,246,519,765
1000,487,503,488,249,485,734
1000,512,483,487,256,489,745
1000,516,501,509,260,510,770
1000,491,506,513,250,505,755
1000,481,518,522,240,513,753
1000,492,488,492,229,509,738
1000,500,495,501,254,489,743
1000,495,488,465,245,482,727
1000,524,501,482,260,508,768
1000,505,511,520,263,502,765
1000,510,489,515,242,505,747
1000,487,509,517,256,509,765
1000,515,512,484,270,466,736
1000,480,504,528,231,518,749
1000,523,489,509,261,506,767
1000,493,497,506,255,490,745
1000,511,492,510,255,511,766
1000,491,505,518,259,483,742
1000,491,517,535,256,508,764
1000,487,488,481,240,491,731
1000,483,485,516,230,512,742
1000,506,524,501,269,492,761
1000,497,521,497,254,502,756
1000,498,519,481,273,464,737
1000,502,508,526,267,503,770
1000,509,513,484,249,504,753
1000,507,505,481,270,473,743
1000,495,493,502,238,506,744
1000,517,483,508,261,503,764
1000,485,499,479,244,484,728
1000,492,498,497,255,493,748
1000,499,496,502,251,485,736
1000,494,514,503,261,489,750
1000,515,509,495,255,502,757
1000,496,483,507,240,514,754
1000,486,481,501,218,535,753
1000,507,498,504,253,507,760
1000,477,520,510,261,488,749
1000,487,514,501,254,489,743
1000,476,486,509,235,517,752
1000,484,508,490,240,499,739
1000,513,528,498,269,481,750
1000,495,512,487,258,494,752
1000,513,495,504,251,504,755
1000,483,504,523,246,508,754
1000,514,507,511,263,506,769
1000,510,484,496,261,498,759
1000,491,495,495,234,522,756
1000,466,502,529,224,534,758
1000,526,499,502,269,495,764
1000,521,488,523,270,503,773
1000,470,507,498,247,493,740
1000,488,511,485,248,489,737
1000,482,524,491,252,483,735
1000,513,483,492,253,505,758
1000,523,491,471,271,476,747
1000,500,476,487,240,486,726
1000,523,504,507,266,507,773
1000,519,485,483,251,503,754
1000,489,482,525,235,521,756
1000,483,497,498,226,518,744
1000,512,510,512,256,517,773
1000,479,486,510,230,515,745
1000,471,532,484,269,457,726
1000,493,486,538,216,552,768
1000,490,519,500,235,514,749
1000,521,480,505,238,528,766
1000,496,484,488,234,509,743
1000,513,502,502,262,496,758
1000,504,525,476,280,471,751
1000,522,510,515,251,515,766
1000,521,477,513,243,530,773
1000,512,497,516,271,507,778
1000,475,503,481,230,485,715
1000,500,502,493,254,496,750
1000,511,501,524,254,509,763
1000,495,507,490,261,480,741
1000,539,510,502,286,492,778
1000,507,488,500,248,511,759
1000,481,484,484,241,491,732
1000,475,520,513,240,497,737
1000,500,471,502,235,526,761
1000,526,526,471,281,455,736
1000,495,497,502,247,508,755
1000,500,480,502,235,515,750
1000,489,501,498,240,500,740
1000,493,501,458,259,464,723
1000,533,493,507,274,492,766
1000,471,490,505,232,488,720
1000,489,517,490,250,486,736
1000,483,503,491,243,487,730
1000,459,512,503,235,496,731
1000,508,498,505,252,520,772
1000,494,496,503,248,503,751
1000,498,514,503,250,488,738
1000,488,491,488,242,489,731
1000,492,514,504,253,497,750
1000,515,491,508,263,500,763
1000,502,526,511,267,493,760
1000,522,519,498,267,502,769
1000,487,525,481,248,477,725
1000,502,493,501,239,505,744
1000,498,498,477,250,491,741
1000,498,493,498,243,491,734
1000,505,498,490,244,507,751
1000,512,484,485,250,502,752
1000,499,498,509,242,502,744
1000,513,517,472,262,483,745
1000,516,502,517,265,506,771
1000,503,510,520,240,529,769
1000,502,515,476,252,484,736
1000,513,517,530,259,513,772
1000,478,480,492,238,496,734
1000,504,498,489,253,500,753
1000,514,510,500,251,513,764
1000,517,515,470,247,494,741
1000,502,533,499,255,494,749
1000,461,510,539,250,487,737
1000,494,506,511,239,510,749
1000,495,504,470,240,486,726
1000,493,495,495,251,493,744
1000,503,518,472,270,469,739
1000,486,492,487,250,494,744
1000,473,486,490,231,492,723
1000,510,497,491,260,496,756
1000,503,505,504,261,490,751
1000,466,503,461,239,453,692
1000,508,481,484,233,498,731
1000,510,503,479,261,480,741
1000,465,500,497,224,506,730
1000,492,494,511,257,474,731
1000,491,518,497,251,487,738
1000,495,480,485,239,500,739
1000,498,521,501,259,504,763
1000,517,499,474,254,500,754
1000,503,502,508,248,516,764
1000,473,520,507,239,503,742
1000,500,505,492,240,500,740
1000,491,504,492,242,496,738
1000,492,494,486,224,516,740
1000,516,526,509,277,494,771
1000,507,481,513,243,510,753
1000,502,502,485,257,477,734
1000,476,493,499,236,517,753
1000,496,486,512,246,520,766
1000,494,531,483,274,457,731
1000,493,482,511,234,509,743
1000,487,539,503,258,499,757
1000,534,508,478,286,471,757
1000,505,517,508,264,495,759
1000,512,494,523,239,536,775
1000,470,500,508,227,504,731
1000,505,511,512,254,503,757
1000,498,503,498,253,487,740
1000,525,512,505,275,493,768
1000,515,490,487,253,503,756
1000,502,475,487,228,524,752
1000,467,517,494,247,483,730
1000,510,498,519,255,501,756
1000,512,505,494,269,481,750
1000,505,512,511,257,490,747
1000,521,495,512,260,517,777
1000,508,500,478,262,484,746
1000,540,500,495,277,489,766
1000,499,503,479,253,482,735
1000,506,527,511,269,501,770
1000,496,498,513,240,520,760
1000,508,504,474,269,487,756
1000,504,484,516,249,513,762
1000,521,472,492,240,517,757
1000,524,516,477,267,485,752
1000,501,491,505,237,512,749
1000,501,490,497,244,516,760
1000,529,497,538,261,529,790
1000,516,505,492,257,496,753
1000,481,497,471,252,468,720
1000,496,505,508,256,482,738
1000,520,486,522,250,518,768
1000,508,500,514,245,510,755
1000,502,477,484,234,517,751
1000,514,514,499,265,495,760
1000,486,488,506,226,510,736
1000,512,516,485,266,472,738
1000,510,521,488,252,496,748
1000,480,503,509,250,509,759
1000,494,489,495,263,476,739
1000,504,466,506,242,530,772
1000,495,504,517,253,508,761
1000,483,515,498,244,490,734
1000,505,504,502,250,505,755
1000,496,467,514,242,521,763
1000,486,493,501,254,485,739
1000,518,487,521,265,521,786
1000,482,489,487,235,500,735
1000,501,502,497,258,499,757
1000,493,474,475,239,497,736
1000,497,491,518,257,503,760
1000,481,494,501,246,501,747
1000,495,492,538,250,509,759
1000,473,486,497,225,504,729
1000,510,504,491,260,486,746
1000,487,512,490,244,489,733
1000,506,494,484,256,490,746
1000,521,494,514,240,521,761
1000,500,534,503,256,482,738
1000,522,487,522,246,526,772
1000,507,513,501,262,489,751
1000,484,497,490,242,487,729
1000,498,509,504,244,509,753
1000,520,509,501,264,503,767
1000,500,503,477,255,489,744
1000,470,503,485,228,506,734
1000,518,497,506,243,516,759
1000,508,497,517,254,502,756
1000,504,500,494,255,492,747
1000,482,513,475,238,488,726
1000,518,510,483,269,477,746
1000,508,486,507,246,501,747
1000,504,489,493,243,492,735
1000,485,487,533,235,512,747
1000,485,511,501,247,495,742
1000,501,501,505,262,502,764
1000,475,490,513,236,521,757
1000,502,495,496,251,505,756
1000,490,499,492,249,495,744
1000,487,506,494,251,483,734
1000,521,516,525,277,486,763
1000,478,484,486,230,503,733
1000,523,526,507,287,467,754
1000,509,489,515,254,516,770
1000,499,526,521,260,497,757
1000,506,506,495,259,490,749
1000,516,503,492,265,502,767
1000,493,532,491,259,475,734
1000,515,499,486,254,498,752
1000,499,456,495,239,512,751
1000,488,509,511,253,504,757
1000,520,537,498,266,501,767
1000,495,510,495,251,490,741
1000,472,509,492,226,498,724
1000,524,515,492,276,471,747
1000,490,454,515,222,534,756
1000,491,489,481,227,495,722
1000,535,492,502,256,502,758
1000,481,494,483,233,495,728
1000,495,523,512,256,485,741
1000,489,517,483,256,473,729
1000,504,471,516,245,522,767
1000,499,486,522,249,511,760
1000,512,486,502,257,508,765
1000,508,503,505,250,518,768
1000,529,513,487,254,498,752
1000,525,493,508,249,516,765
1000,486,526,491,264,468,732
1000,517,476,503,237,519,756
1000,493,506,487,260,470,730
1000,451,512,507,226,502,728
1000,483,514,504,251,493,744
1000,475,506,482,251,472,723
1000,507,507,492,254,500,754
1000,497,512,483,243,504,747
1000,516,493,511,266,502,768
1000,502,508,489,254,483,737
1000,491,517,494,260,475,735
1000,476,513,492,249,505,754
1000,479,501,476,228,517,745
1000,517,495,479,256,493,749
1000,473,500,482,245,479,724
1000,489,530,500,265,472,737
1000,479,466,495,230,504,734
1000,487,504,489,257,474,731
1000,518,478,503,235,531,766
1000,503,537,520,267,504,771
1000,509,484,501,246,513,759
1000,514,493,495,250,510,760
1000,507,479,511,242,520,762
1000,496,496,499,248,508,756
1000,505,505,486,268,463,731
1000,524,529,502,279,473,752
1000,506,478,491,243,504,747
1000,511,493,479,247,493,740
1000,478,504,456,229,489,718
1000,503,532,488,268,483,751
1000,500,525,500,267,475,742
1000,495,494,470,237,500,737
1000,509,523,531,262,525,787
1000,472,499,528,255,501,756
1000,511,527,521,273,483,756
1000,487,495,517,230,531,761
1000,500,484,493,242,498,740
1000,504,514,477,242,491,733
1000,487,486,513,234,510,744
1000,489,532,512,267,486,753
1000,505,497,505,239,533,772
1000,490,493,503,228,510,738
1000,493,504,508,237,517,754
1000,485,467,478,227,497,724
1000,466,484,480,219,496,715
1000,498,516,500,264,490,754
1000,505,495,511,260,491,751
1000,531,472,492,245,529,774
1000,500,495,501,249,493,742
1000,486,527,504,261,478,739
1000,493,455,486,215,528,743
1000,487,495,502,249,502,751
1000,486,504,480,258,471,729
1000,496,473,477,246,473,719
1000,494,487,524,239,512,751
1000,502,492,529,253,516,769
1000,504,526,493,257,491,748
1000,461,486,509,234,478,712
1000,484,487,470,234,497,731
1000,511,494,493,257,501,758
1000,489,500,506,229,510,739
1000,461,509,525,222,517,739
1000,466,512,492,246,473,719
1000,499,491,498,253,494,747
1000,498,477,497,234,522,756
1000,497,480,515,240,520,760
1000,491,513,517,248,515,763
1000,512,480,494,246,514,760
1000,518,494,538,255,533,788
1000,514,492,508,247,518,765
1000,509,511,485,250,501,751
1000,482,502,490,246,474,720
1000,496,486,505,248,502,750
1000,455,503,492,222,504,726
1000,498,467,479,230,508,738
1000,484,529,504,253,493,746
1000,483,522,498,266,453,719
1000,487,477,511,250,511,761
1000,513,518,508,269,496,765
1000,473,503,494,228,510,738
1000,511,491,499,248,509,757
1000,513,514,491,252,500,752
1000,515,485,482,254,500,754
1000,480,512,490,229,516,745
1000,488,458,495,233,514,747
1000,511,488,476,244,503,747
1000,529,496,499,270,491,761
1000,467,501,497,243,482,725
1000,528,502,515,268,502,770
1000,500,526,491,265,478,743
1000,488,474,514,228,523,751
1000,534,495,516,266,522,788
1000,494,475,517,217,552,769
1000,509,499,485,272,469,741
1000,494,525,504,262,505,767
1000,509,505,502,254,485,739
1000,507,500,510,258,492,750
1000,499,463,502,217,522,739
1000,519,517,505,259,512,771
1000,498,506,521,253,497,750
1000,507,508,495,249,507,756
1000,493,509,500,253,483,736
1000,516,488,502,262,495,757
1000,494,500,517,247,498,745
1000,526,499,491,270,497,767
1000,496,491,538,238,531,769
1000,498,480,472,244,499,743
1000,474,463,547,226,535,761
1000,493,512,486,244,486,730
1000,510,502,506,263,493,756
1000,496,507,490,254,483,737
1000,502,489,511,237,532,769
1000,513,481,482,253,498,751
1000,474,496,506,239,503,742
1000,486,485,518,241,517,758
1000,477,527,489,239,507,746
1000,517,509,488,262,478,740
1000,512,520,502,256,511,767
1000,490,484,472,230,498,728
1000,491,513,535,242,523,765
1000,508,475,519,250,520,770
1000,485,493,496,247,493,740
1000,454,479,499,214,514,728
1000,478,519,507,255,486,741
1000,513,508,500,258,494,752
1000,510,522,483,265,488,753
1000,509,518,488,255,500,755
1000,499,501,487,250,497,747
1000,516,519,497,276,476,752
1000,476,517,498,237,521,758
1000,511,516,522,250,512,762
1000,497,510,473,260,472,732
1000,514,499,478,265,465,730
1000,482,495,499,236,502,738
1000,486,492,510,243,506,749
1000,496,490,515,242,517,759
1000,493,511,496,240,505,745
1000,486,525,491,253,485,738
1000,525,541,515,294,483,777
1000,486,478,519,228,515,743
1000,507,501,491,263,488,751
1000,471,481,504,207,534,741
1000,502,502,508,244,514,758
1000,486,536,503,258,486,744
1000,527,504,493,264,504,768
1000,475,503,474,243,479,722
1000,474,472,503,216,517,733
1000,498,512,480,251,488,739
1000,504,489,514,229,525,754
1000,507,496,513,254,500,754
1000,503,500,474,254,492,746
1000,519,504,517,265,504,769
1000,478,507,512,240,506,746
1000,520,500,498,259,509,768
1000,509,481,479,247,491,738
1000,505,519,488,263,490,753
1000,493,492,504,238,516,754
1000,493,518,493,244,489,733
1000,507,531,525,286,477,763
1000,517,498,492,264,484,748
1000,522,476,507,240,530,770
1000,497,511,511,258,510,768
1000,475,514,496,250,490,740
1000,502,503,505,238,516,754
1000,476,475,489,217,503,720
1000,503,492,508,238,529,767
1000,503,487,490,245,504,749
1000,490,506,491,245,480,725
1000,523,488,490,265,497,762
1000,517,509,498,250,499,749
1000,484,494,487,226,509,735
1000,496,504,507,256,492,748
1000,476,525,501,250,492,742
1000,514,476,469,261,470,731
1000,539,499,548,269,524,793
1000,476,504,509,249,484,733
1000,506,507,499,264,482,746
1000,517,483,497,253,507,760
1000,488,514,496,262,469,731
1000,519,497,520,259,505,764
1000,512,489,495,255,502,757
1000,499,516,478,247,477,724
1000,509,490,496,258,493,751
1000,489,511,498,254,503,757
1000,482,515,484,254,468,722
1000,516,493,513,260,509,769
1000,491,503,505,240,509,749
1000,466,477,513,201,545,746
1000,499,510,490,272,486,758
1000,501,487,484,233,509,742
1000,486,499,489,238,489,727
1000,497,498,526,249,517,766
1000,526,510,468,271,491,762
1000,491,493,513,243,516,759
1000,526,501,502,264,511,775
1000,488,523,481,261,469,730
1000,483,469,497,232,502,734
1000,505,494,510,247,514,761
1000,503,500,518,253,519,772
1000,518,470,493,247,512,759
1000,516,480,478,250,485,735
1000,490,479,501,238,502,740
1000,507,518,505,266,479,745
1000,478,487,526,236,501,737
1000,492,516,513,257,500,757
1000,513,524,515,270,500,770
1000,520,512,506,246,502,748
1000,489,476,479,220,522,742
1000,482,492,500,243,496,739
1000,490,504,497,249,498,747
1000,483,503,489,254,484,738
1000,498,488,499,242,510,752
1000,512,511,511,272,502,774
1000,507,483,521,247,527,774
1000,485,493,497,241,499,740
1000,514,474,500,244,509,753
1000,488,499,513,236,510,746
1000,490,474,519,226,537,763
1000,474,517,502,246,491,737
1000,494,519,496,262,478,740
1000,499,509,490,261,483,744
1000,477,506,478,239,491,730
1000,505,496,512,253,508,761
1000,478,521,484,244,497,741
1000,500,522,485,268,480,748
1000,468,499,498,248,492,740
1000,501,512,500,258,496,754
1000,513,494,507,270,498,768
1000,493,480,504,232,513,745
1000,495,496,482,257,483,740
1000,479,497,510,230,517,747
1000,485,485,492,231,496,727
1000,469,497,523,234,508,742
1000,499,508,507,258,502,760
1000,463,504,504,234,485,719
1000,517,493,521,246,524,770
1000,493,504,523,253,505,758
1000,476,514,503,247,500,747
1000,485,494,498,238,493,731
1000,491,490,495,250,473,723
1000,496,466,507,234,534,768
1000,502,499,516,249,523,772
1000,510,504,496,278,473,751
1000,508,478,520,241,523,764
1000,516,481,485,251,494,745
1000,484,522,519,257,480,737
1000,517,518,512,275,503,778
1000,532,485,494,257,505,762
1000,496,488,466,244,489,733
1000,516,489,491,256,486,742
1000,489,510,519,247,486,733
1000,506,484,520,241,533,774
1000,486,504,502,242,503,745
1000,497,515,512,251,514,765
1000,508,492,503,238,528,766
1000,512,502,451,254,476,730
1000,479,471,487,230,505,735
1000,490,505,477,262,463,725
1000,484,495,487,248,496,744
1000,499,475,517,238,516,754
1000,495,493,501,230,530,760
1000,496,528,543,262,509,771
1000,484,474,546,223,548,771
1000,487,479,500,223,515,738
1000,501,493,522,255,506,761
1000,516,487,463,259,486,745
1000,513,507,518,269,485,754
1000,506,487,479,255,506,761
1000,495,516,477,261,465,726
1000,496,510,489,266,478,744
1000,485,502,491,251,481,732
1000,481,517,490,257,491,748
1000,488,498,496,248,507,755
1000,468,521,488,243,486,729
1000,521,499,509,269,502,771
1000,506,530,481,269,469,738
1000,475,520,495,237,489,726
1000,494,514,496,250,498,748
1000,509,503,509,258,514,772
1000,496,488,477,235,502,737
1000,488,485,495,237,496,733
1000,502,473,540,232,536,768
1000,501,501,498,250,498,748
1000,511,509,508,247,506,753
1000,525,489,502,249,514,763
1000,522,500,491,269,487,756
1000,506,482,510,255,501,756
1000,515,491,502,253,509,762
1000,497,531,520,264,497,761
1000,485,516,506,246,499,745
1000,507,514,484,263,485,748
1000,502,510,505,264,492,756
1000,494,484,495,240,510,750
1000,486,522,508,263,496,759
1000,528,480,485,252,499,751
1000,506,495,500,258,507,765
1000,490,492,539,245,531,776
1000,489,501,495,253,501,754
1000,495,477,502,226,526,752
1000,509,508,518,250,518,768
1000,510,487,478,267,474,741
1000,488,455,493,228,517,745
1000,503,499,482,247,501,748
1000,486,508,488,232,499,731
1000,526,487,490,254,504,758
1000,507,524,488,275,486,761
1000,493,520,516,258,491,749
1000,482,480,503,228,513,741
1000,491,514,502,261,481,742
1000,466,480,511,233,497,730
1000,504,492,505,251,498,749
1000,486,457,519,215,533,748
1000,510,522,485,276,466,742
1000,479,484,514,248,502,750
1000,483,519,506,253,486,739
1000,506,511,517,259,498,757
1000,492,495,506,259,477,736
1000,508,503,496,275,487,762
1000,506,522,494,273,482,755
1000,514,519,490,262,484,746
1000,500,514,513,261,505,766
1000,494,490,493,251,496,747
1000,493,513,495,251,489,740
1000,502,513,499,278,476,754
1000,494,521,508,250,513,763
1000,504,477,520,237,512,749
1000,497,530,468,269,459,728
1000,503,513,491,265,485,750
1000,526,511,497,267,495,762
1000,477,509,504,236,508,744
1000,478,517,490,246,482,728
1000,491,495,495,248,503,751
1000,491,483,529,241,515,756
1000,517,503,499,263,494,757
1000,536,550,497,292,463,755
1000,479,502,491,249,480,729
1000,509,488,504,255,497,752
1000,490,524,485,263,475,738
1000,512,487,508,240,512,752
1000,497,497,518,233,517,750
1000,493,489,458,244,471,715
1000,493,466,485,220,528,748
1000,519,501,516,260,509,769
1000,504,518,533,262,509,771
1000,481,478,511,231,514,745
1000,489,513,503,239,500,739
1000,490,504,498,251,496,747
1000,532,511,517,270,500,770
1000,489,474,508,234,510,744
1000,519,492,522,256,516,772
1000,518,479,476,255,501,756
1000,523,514,518,275,498,773
1000,489,499,491,243,493,736
1000,497,510,516,249,513,762
1000,502,474,503,230,518,748
1000,501,522,524,246,517,763
1000,501,540,519,271,486,757
1000,524,502,490,258,496,754
1000,500,495,472,246,493,739
1000,476,509,475,241,485,726
1000,504,495,499,257,506,763
1000,512,518,516,256,510,766
1000,447,471,515,214,524,738
1000,474,519,513,239,514,753
1000,518,498,488,252,486,738
1000,492,472,463,231,494,725
1000,501,497,529,247,511,758
1000,519,502,518,268,507,775
1000,484,467,506,214,524,738
1000,498,496,474,247,480,727
1000,513,482,515,241,521,762
1000,491,502,501,251,508,759
1000,490,520,503,267,472,739
1000,496,475,523,222,532,754
1000,488,524,514,246,522,768
1000,522,495,484,269,486,755
1000,493,484,535,228,533,761
1000,492,511,483,259,485,744
1000,511,495,509,259,501,760
1000,493,496,445,242,465,707
1000,484,497,508,237,510,747
1000,511,496,525,259,513,772
1000,492,492,496,256,498,754
1000,506,501,522,251,523,774
1000,481,512,489,248,482,730
1000,491,481,510,246,512,758
1000,496,503,470,255,474,729
1000,478,503,500,240,499,739
1000,480,504,490,236,495,731
1000,517,486,493,260,505,765
1000,470,493,515,239,513,752
1000,510,492,491,264,472,736
1000,503,489,553,247,538,785
1000,488,496,492,238,505,743
1000,498,511,537,247,511,758
1000,484,519,502,237,510,747
1000,488,513,499,250,491,741
1000,465,534,506,244,489,733
1000,521,516,508,284,480,764
1000,533,488,499,264,507,771
1000,484,517,484,256,484,740
1000,478,505,530,238,516,754
1000,512,490,504,247,505,752
1000,467,485,489,226,497,723
1000,485,511,494,248,481,729
1000,501,488,521,239,523,762
1000,450,494,483,222,485,707
1000,517,510,481,266,492,758
1000,490,515,498,252,495,747
1000,508,509,523,253,508,761
1000,530,495,534,266,533,799
1000,488,507,523,233,518,751
1000,546,461,478,254,496,750
1000,513,522,508,275,484,759
1000,507,473,491,247,492,739
1000,502,504,513,240,526,766
1000,511,518,510,258,508,766
1000,503,516,507,258,487,745
1000,484,498,493,256,488,744
1000,509,484,507,255,507,762
1000,516,484,506,260,503,763
1000,512,501,533,250,526,776
1000,480,483,515,226,519,745
1000,509,493,480,244,506,750
1000,504,497,532,252,514,766
1000,504,508,532,259,504,763
1000,485,505,515,250,491,741
1000,493,510,527,244,515,759
1000,505,505,493,255,496,751
1000,484,508,500,247,494,741
1000,496,493,498,256,505,761
1000,511,510,493,258,498,756
1000,531,510,493,275,488,763
1000,479,518,503,258,490,748
1000,522,496,519,274,486,760
1000,490,514,504,258,476,734
1000,485,513,530,240,507,747
1000,490,488,495,251,491,742
1000,512,491,515,260,485,745
1000,489,497,502,248,488,736
1000,482,491,495,230,511,741
1000,503,488,502,244,514,758
1000,508,480,513,253,519,772
1000,494,488,504,244,504,748
1000,473,492,513,235,501,736
1000,479,499,501,236,500,736
1000,507,477,514,264,498,762
1000,509,502,484,264,473,737
1000,528,508,486,265,489,754
1000,514,501,507,261,503,764
1000,500,511,507,251,508,759
1000,506,493,510,253,521,774
1000,512,503,499,263,490,753
1000,492,493,528,245,506,751
1000,502,492,491,262,488,750
1000,477,494,469,233,483,716
1000,503,452,494,241,509,750
1000,496,499,504,260,488,748
1000,475,516,504,252,487,739
1000,483,477,505,236,515,751
1000,491,488,513,234,515,749
1000,503,496,504,243,511,754
1000,508,502,478,250,489,739
1000,470,479,490,229,500,729
1000,508,518,478,262,492,754
1000,471,515,490,255,457,712
1000,509,498,506,251,512,763
1000,513,512,502,268,492,760
1000,484,499,503,246,495,741
1000,484,499,485,250,483,733
1000,503,487,509,242,511,753
1000,507,499,509,250,510,760
1000,475,512,484,251,467,718
1000,507,515,506,249,522,771
1000,497,518,505,257,491,748
1000,508,458,506,234,517,751
1000,495,481,530,232,520,752
1000,467,492,492,242,494,736
1000,495,492,517,241,511,752
1000,488,486,504,243,501,744
1000,486,486,497,251,490,741
1000,514,490,488,245,509,754
1000,468,487,510,238,511,749
1000,501,542,514,275,485,760
1000,501,478,494,236,505,741
1000,477,511,492,252,489,741
1000,483,495,491,237,505,742
1000,488,507,508,228,521,749
1000,496,490,511,247,507,754
1000,517,506,538,265,516,781
1000,513,482,508,247,503,750
1000,479,497,496,251,487,738
1000,482,505,478,244,469,713
1000,499,499,505,245,509,754
1000,504,484,476,241,496,737
1000,512,506,477,270,481,751
1000,499,500,520,231,542,773
1000,509,476,523,242,515,757
1000,525,495,508,271,486,757
1000,509,482,498,255,517,772
1000,517,520,488,257,506,763
1000,517,483,524,243,546,789
1000,480,470,504,222,527,749
1000,513,493,477,258,488,746
1000,511,497,502,262,487,749
1000,476,496,544,245,523,768
1000,511,513,500,276,481,757
1000,513,500,505,255,513,768
1000,484,487,485,227,503,730
1000,498,514,491,253,471,724
1000,509,448,492,244,510,754
1000,490,512,509,259,491,750
1000,495,503,505,250,513,763
1000,529,497,513,266,503,769
1000,506,508,532,271,508,779
1000,537,504,485,278,475,753
1000,509,503,484,258,487,745
1000,523,514,504,267,503,770
1000,484,491,495,234,502,736
1000,502,503,498,252,501,753
1000,494,504,510,246,501,747
1000,505,506,483,261,484,745
1000,503,499,513,253,502,755
1000,515,503,499,261,497,758
1000,519,489,473,264,485,749
1000,513,527,522,269,503,772
1000,516,513,505,280,480,760
1000,488,497,470,239,481,720
1000,493,516,493,257,488,745
1000,480,492,509,236,505,741
1000,497,487,502,225,519,744
1000,480,494,517,240,500,740
1000,510,500,480,256,486,742
1000,516,494,489,251,491,742
1000,499,485,518,244,511,755
1000,480,508,494,236,510,746
1000,498,521,482,266,472,738
1000,499,527,534,253,506,759
1000,518,488,498,234,522,756
1000,519,506,488,259,490,749
1000,486,503,499,228,516,744
1000,492,507,510,256,493,749
1000,495,485,477,239,489,728
1000,485,515,501,248,497,745
1000,522,511,496,256,486,742
1000,498,498,495,232,516,748
1000,512,497,507,248,510,758
1000,488,506,487,254,479,733
1000,487,496,497,245,503,748
1000,506,478,505,235,512,747
1000,510,497,504,245,513,758
1000,491,492,498,232,512,744
1000,500,487,485,252,493,745
1000,480,485,509,224,517,741
1000,491,502,512,247,493,740
1000,477,507,487,248,467,715
1000,477,483,493,218,522,740
1000,501,493,497,234,518,752
1000,505,476,484,237,506,743
1000,504,503,497,257,493,750
1000,499,509,499,254,503,757
1000,511,506,512,264,498,762
1000,500,497,492,259,486,745
1000,492,472,493,229,502,731
1000,485,516,503,246,505,751
1000,489,473,499,231,515,746
1000,496,477,535,256,512,768
1000,487,487,523,240,522,762
1000,487,512,509,257,483,740
1000,515,503,469,259,493,752
1000,473,510,511,250,486,736
1000,494,523,489,248,489,737
1000,499,482,499,237,513,750
1000,507,500,510,247,520,767
1000,495,528,527,272,491,763
1000,505,514,506,253,496,749
1000,494,468,508,221,532,753
1000,498,496,513,248,513,761
1000,478,511,482,245,486,731
1000,508,508,485,265,478,743
1000,499,526,503,257,491,748
1000,499,546,540,264,505,769
1000,511,502,512,246,523,769
1000,512,521,484,264,483,747
1000,519,472,491,243,521,764
1000,481,503,492,239,492,731
1000,479,478,486,222,517,739
1000,509,493,496,259,495,754
1000,482,515,501,254,496,750
1000,496,495,508,248,504,752
1000,496,497,482,253,479,732
1000,484,500,481,239,506,745
1000,503,474,507,239,515,754
1000,500,497,523,257,496,753
1000,511,474,499,228,530,758
1000,479,501,493,234,510,744
1000,498,538,479,275,470,745
1000,523,516,489,270,490,760
1000,497,480,510,236,508,744
1000,475,472,478,224,502,726
1000,486,485,483,247,496,743
1000,480,525,507,251,491,742
1000,476,502,480,237,488,725
1000,502,483,509,255,510,765
1000,523,477,503,254,520,774
1000,504,511,501,270,478,748
1000,502,500,506,249,510,759
1000,504,499,507,257,489,746
1000,521,515,522,267,498,765
1000,491,501,516,241,526,767
1000,473,525,506,258,476,734
1000,473,496,505,242,494,736
1000,480,508,513,233,524,757
1000,509,453,518,231,524,755
1000,495,497,520,237,533,770
1000,519,496,491,257,497,754
1000,501,487,503,243,499,742
1000,502,478,479,243,508,751
1000,493,491,506,240,510,750
1000,535,536,510,288,488,776
1000,507,534,514,259,500,759
1000,489,505,482,240,481,721
1000,516,485,522,263,510,773
1000,506,508,507,253,499,752
1000,492,522,499,253,487,740
1000,493,521,506,263,491,754
1000,517,461,504,231,547,778
1000,495,481,486,227,506,733
1000,514,504,499,250,510,760
1000,511,520,516,265,492,757
1000,490,495,502,246,501,747
1000,516,489,496,251,496,747
1000,506,502,505,245,512,757
1000,516,474,508,242,517,759
1000,513,502,504,262,507,769
1000,500,490,523,247,515,762
1000,478,497,519,240,513,753
1000,509,503,500,241,485,726
1000,486,520,513,264,485,749
1000,494,489,519,247,514,761
1000,493,524,484,255,482,737
1000,482,496,483,244,486,730
1000,510,519,500,260,502,762
1000,510,513,492,273,474,747
1000,494,497,503,245,513,758
1000,502,504,501,249,509,758
1000,511,505,483,248,507,755
1000,504,506,493,246,500,746
1000,495,489,525,242,518,760
1000,515,514,498,266,478,744
1000,464,481,496,230,493,723
1000,496,486,513,239,526,765
1000,519,511,490,267,498,765
1000,490,474,477,228,502,730
1000,510,532,508,262,508,770
1000,489,479,468,229,494,723
1000,499,497,505,237,518,755
1000,485,488,500,237,502,739
1000,493,488,486,239,496,735
1000,481,487,493,247,470,717
1000,496,481,506,252,495,747
1000,509,508,543,256,521,777
1000,509,487,507,237,518,755
1000,501,506,493,263,480,743
1000,495,513,508,256,500,756
1000,485,517,500,244,497,741
1000,483,486,496,246,501,747
1000,503,507,498,258,494,752
1000,510,517,501,260,492,752
1000,506,492,491,244,497,741
1000,496,491,518,251,510,761
1000,481,498,507,251,501,752
1000,498,522,469,255,482,737
1000,518,488,499,242,516,758
1000,501,481,495,231,518,749
1000,493,495,507,235,508,743
1000,518,484,491,239,516,755
1000,535,516,486,284,470,754
1000,478,486,503,233,502,735
1000,496,456,484,225,515,740
1000,483,487,512,247,500,747
1000,518,507,504,256,508,764
1000,495,491,514,236,525,761
1000,493,499,502,250,492,742
1000,480,519,512,232,516,748
1000,529,493,505,257,515,772
1000,503,494,515,245,511,756
1000,507,518,479,252,488,740
1000,488,503,522,247,505,752
1000,486,497,516,243,488,731
1000,495,476,509,224,520,744
1000,483,513,489,250,474,724
1000,503,460,509,236,531,767
1000,525,491,500,267,494,761
1000,504,505,492,257,490,747
1000,510,496,495,252,483,735
1000,483,490,488,240,487,727
1000,503,488,490,237,511,748
1000,494,496,534,238,518,756
1000,527,488,481,251,512,763
1000,526,491,472,262,473,735
1000,496,493,509,257,482,739
1000,536,519,491,273,494,767
1000,511,522,509,260,502,762
1000,530,474,498,256,491,747
1000,487,487,485,229,497,726
1000,524,507,515,262,508,770
1000,498,484,486,224,511,735
1000,493,504,498,245,496,741
1000,479,518,495,248,498,746
1000,489,497,523,247,512,759
1000,519,539,516,288,471,759
1000,509,481,479,245,493,738
1000,493,500,503,241,504,745
1000,491,506,510,242,506,748
1000,501,510,516,259,493,752
1000,472,523,525,241,496,737
1000,540,482,478,262,495,757
1000,535,465,518,241,533,774
1000,480,494,491,224,519,743
1000,453,490,510,229,493,722
1000,503,483,517,229,538,767
1000,499,520,491,277,470,747
1000,493,517,502,256,497,753
1000,494,523,513,256,495,751
1000,471,488,509,235,503,738
1000,458,521,514,244,489,733
1000,488,498,479,222,521,743
1000,495,499,506,245,499,744
1000,502,489,489,244,503,747
1000,522,502,505,263,518,781
1000,469,480,519,224,517,741
1000,499,492,506,244,504,748
1000,488,488,486,227,525,752
1000,500,523,493,277,454,731
1000,514,494,521,258,512,770
1000,486,509,495,249,490,739
1000,490,525,500,258,484,742
1000,504,476,531,252,516,768
1000,504,496,488,252,498,750
1000,478,488,518,232,519,751
1000,482,468,506,226,516,742
1000,483,507,489,244,490,734
1000,507,502,506,248,509,757
1000,477,506,489,229,504,733
1000,491,514,504,249,501,750
1000,514,507,484,257,494,751
1000,495,486,518,246,504,750
1000,522,519,489,272,484,756
1000,495,499,500,239,513,752
1000,486,488,512,231,508,739
1000,522,501,491,255,510,765
1000,513,496,487,263,482,745
1000,489,501,514,240,506,746
1000,478,506,508,246,502,748
1000,494,518,483,253,482,735
1000,485,511,507,239,520,759
1000,487,473,492,218,521,739
1000,507,478,486,226,505,731
1000,497,508,493,235,513,748
1000,500,491,497,249,513,762
1000,504,503,497,259,502,761
1000,482,497,469,250,470,720
1000,469,532,531,235,520,755
1000,537,484,524,249,536,785
1000,516,511,486,277,484,761
1000,475,494,525,237,522,759
1000,548,493,526,266,520,786
1000,491,513,506,243,499,742
1000,519,523,490,270,484,754
1000,505,526,507,258,505,763
1000,512,455,489,226,527,753
1000,500,512,494,268,483,751
1000,501,514,491,258,476,734
1000,508,497,496,262,490,752
1000,504,503,501,257,486,743
1000,488,477,485,225,511,736
1000,488,487,501,245,503,748
1000,539,503,510,275,489,764
1000,491,483,471,225,510,735
1000,518,544,501,262,485,747
1000,509,516,495,259,484,743
1000,487,510,491,262,465,727
1000,532,498,512,265,507,772
1000,455,485,520,224,525,749
1000,500,489,481,230,529,759
1000,496,508,509,261,488,749
1000,491,534,496,267,472,739
1000,502,512,512,267,503,770
1000,505,527,517,276,480,756
1000,512,497,526,240,528,768
1000,481,482,519,228,522,750
1000,522,501,509,263,493,756
1000,493,481,506,241,500,741
1000,484,508,492,250,484,734
1000,483,517,526,232,516,748
1000,523,487,511,252,521,773
1000,482,514,524,249,503,752
1000,506,490,512,242,506,748
1000,470,507,510,240,502,742
1000,506,522,499,262,502,764
1000,516,486,498,237,517,754
1000,508,497,496,260,500,760
1000,498,489,482,249,494,743
1000,491,447,492,212,518,730
1000,485,496,501,247,502,749
1000,501,507,470,260,465,725
1000,527,521,509,282,482,764
1000,502,516,501,255,487,742
1000,486,484,508,239,496,735
1000,516,490,518,259,513,772
1000,499,513,508,254,507,761
1000,471,521,501,244,491,735
1000,511,536,507,260,497,757
1000,474,477,498,222,519,741
1000,499,484,508,245,511,756
1000,515,509,522,251,526,777
1000,500,509,510,243,500,743
1000,488,494,498,241,499,740
1000,488,520,502,264,492,756
1000,499,461,502,224,532,756
1000,493,501,505,249,504,753
1000,516,511,492,259,498,757
1000,512,488,510,238,509,747
1000,498,514,485,247,490,737
1000,508,476,479,227,505,732
1000,496,497,517,267,475,742
1000,504,491,510,243,513,756
1000,486,491,490,230,498,728
1000,506,518,506,260,503,763
1000,479,481,471,246,485,731
1000,481,505,529,247,510,757
1000,487,492,486,240,499,739
1000,515,483,496,253,507,760
1000,514,496,492,250,493,743
1000,520,499,505,252,507,759
1000,468,507,503,236,494,730
1000,509,471,501,241,508,749
1000,505,499,500,259,497,756
1000,491,516,491,253,483,736
1000,515,510,480,265,471,736
1000,492,510,493,237,507,744
1000,507,520,480,277,480,757
1000,504,531,488,271,467,738
1000,500,524,499,267,479,746
1000,503,485,498,236,522,758
1000,502,488,492,249,492,741
1000,494,466,509,235,520,755
1000,505,497,472,256,486,742
1000,480,504,509,234,512,746
1000,503,496,514,257,497,754
1000,499,474,487,232,504,736
1000,499,472,486,224,521,745
1000,520,479,503,246,523,769
1000,512,481,533,251,518,769
1000,492,482,526,261,480,741
1000,489,512,514,261,498,759
1000,483,497,486,238,492,730
1000,479,484,496,238,498,736
1000,504,504,511,246,504,750
1000,494,479,500,231,506,737
1000,495,492,497,246,490,736
1000,518,507,501,269,493,762
1000,496,507,501,256,496,752
1000,496,506,502,251,508,759
1000,506,515,497,252,504,756
1000,516,497,501,252,505,757
1000,524,499,472,251,492,743
1000,478,489,495,241,509,750
1000,502,502,462,263,483,746
1000,510,492,498,255,482,737
1000,499,511,506,241,505,746
1000,510,495,511,250,511,761
1000,493,548,519,265,485,750
1000,519,508,470,263,472,735
1000,500,512,483,262,480,742
1000,517,482,496,249,513,762
1000,481,520,515,250,511,761
1000,492,505,498,241,496,737
1000,498,505,497,242,500,742
1000,512,497,521,270,483,753
1000,504,501,481,255,481,736
1000,506,490,491,244,495,739
1000,459,506,496,236,486,722
1000,497,498,537,239,523,762
1000,486,484,541,233,531,764
1000,506,514,500,259,492,751
1000,529,515,494,267,492,759
1000,506,507,511,269,483,752
1000,478,501,507,233,515,748
1000,489,494,510,245,505,750
1000,505,499,513,262,494,756
1000,500,495,488,233,516,749
1000,502,480,470,252,499,751
1000,486,505,501,242,507,749
1000,488,536,511,258,487,745
1000,501,487,506,248,498,746
1000,476,487,494,223,519,742
1000,505,510,496,251,500,751
1000,499,515,474,253,492,745
1000,510,501,489,258,499,757
1000,507,508,495,248,500,748
1000,499,513,515,267,483,750
1000,492,462,479,213,518,731
1000,493,501,493,240,511,751
1000,477,498,482,232,508,740
1000,468,509,500,244,494,738
1000,504,501,497,245,489,734
1000,519,509,483,271,491,762
1000,501,529,476,272,457,729
1000,490,498,488,239,501,740
1000,503,482,498,226,511,737
1000,500,516,486,253,496,749
1000,518,497,487,261,500,761
1000,497,485,505,237,520,757
1000,492,480,489,239,506,745
1000,512,512,482,275,482,757
1000,498,501,491,255,499,754
1000,510,488,486,246,503,749
1000,510,509,506,249,512,761
1000,497,494,511,248,505,753
1000,495,504,493,246,507,753
1000,503,508,492,263,481,744
1000,541,500,514,276,498,774
1000,515,512,515,267,495,762
1000,484,490,474,233,504,737
1000,499,487,476,244,487,731
1000,517,500,495,246,506,752
1000,506,509,498,269,491,760
1000,533,506,492,269,497,766
1000,486,514,495,258,475,733
1000,478,498,509,225,523,748
1000,504,480,500,253,498,751
1000,534,506,503,280,483,763
1000,499,483,522,235,522,757
1000,488,508,477,245,481,726
1000,500,522,516,250,495,745
1000,484,491,510,250,497,747
1000,491,510,497,255,492,747
1000,488,479,508,248,493,741
1000,514,525,495,283,475,758
1000,455,495,499,217,508,725
1000,500,505,477,243,492,735
1000,515,519,503,280,489,769
1000,507,475,491,233,514,747
1000,517,504,504,275,483,758
1000,504,498,460,261,469,730
1000,494,511,497,261,469,730
1000,491,492,502,242,518,760
1000,486,494,491,245,505,750
1000,483,514,484,251,486,737
1000,500,522,504,269,488,757
1000,465,512,503,243,476,719
1000,493,472,487,217,512,729
1000,509,526,495,251,505,756
1000,472,514,517,235,500,735
1000,506,528,488,274,463,737
1000,511,490,519,256,513,769
1000,518,505,482,264,478,742
1000,479,519,500,236,522,758
1000,492,475,513,233,512,745
1000,491,526,524,270,492,762
1000,524,527,482,271,484,755
1000,492,508,494,245,504,749
1000,511,522,491,268,469,737
1000,515,482,508,239,525,764
1000,501,488,525,250,517,767
1000,528,519,483,280,485,765
1000,518,481,488,254,504,758
1000,515,487,504,246,505,751
1000,487,513,499,261,467,728
1000,500,502,522,242,528,770
1000,479,493,483,238,489,727
1000,512,502,510,243,521,764
1000,495,495,484,247,493,740
1000,502,518,498,283,465,748
1000,493,491,504,249,494,743
1000,479,496,460,237,469,706
1000,504,506,496,254,507,761
1000,526,524,519,277,493,770
1000,478,501,507,239,485,724
1000,505,498,538,240,529,769
1000,489,503,485,266,474,740
1000,500,493,525,257,491,748
1000,505,519,475,250,497,747
1000,516,493,471,246,507,753
1000,505,493,488,248,487,735
1000,515,498,502,233,529,762
1000,485,497,497,241,503,744
1000,504,501,478,260,460,720
1000,498,494,492,243,514,757
1000,494,516,504,247,504,751
1000,509,497,500,260,486,746
1000,476,493,489,231,509,740
1000,497,483,508,234,515,749
1000,513,500,484,254,490,744
1000,530,494,500,268,483,751
1000,489,489,504,245,511,756
1000,503,507,516,247,502,749
1000,501,523,492,251,499,750
1000,505,530,474,262,476,738
1000,521,503,509,248,518,766
1000,528,457,508,243,529,772
1000,476,453,504,224,514,738
1000,484,492,474,239,488,727
1000,492,474,453,225,502,727
1000,515,488,526,240,540,780
1000,486,516,482,255,483,738
1000,501,505,470,256,472,728
1000,487,501,507,239,501,740
1000,489,498,481,238,506,744
1000,499,516,505,266,494,760
1000,508,489,534,248,524,772
1000,470,516,508,241,503,744
1000,473,506,500,231,509,740
1000,511,514,523,254,513,767
1000,495,513,495,243,502,745
1000,481,524,488,259,480,739
1000,501,517,500,240,502,742
1000,506,502,500,240,524,764
1000,514,476,490,236,512,748
1000,525,512,516,271,498,769
1000,521,484,504,255,505,760
1000,486,473,487,233,515,748
1000,499,521,487,260,469,729
1000,522,500,523,261,503,764
1000,508,503,497,249,498,747
1000,494,501,489,250,495,745
1000,485,532,499,249,495,744
1000,492,503,484,252,480,732
1000,505,484,497,239,507,746
1000,509,505,483,254,490,744
1000,520,479,497,251,504,755
1000,477,488,511,224,506,730
1000,475,520,526,245,508,753
1000,498,499,511,262,493,755
1000,499,486,526,239,520,759
1000,491,503,486,245,493,738
1000,458,487,482,220,502,722
1000,512,481,500,251,520,771
1000,517,496,503,258,510,768
1000,525,507,484,253,497,750
1000,457,515,482,244,480,724
1000,508,511,488,265,481,746
1000,498,538,504,267,471,738
1000,483,513,478,257,461,718
1000,521,495,494,262,492,754
1000,451,498,486,230,477,707
1000,507,514,536,253,509,762
1000,521,508,501,253,519,772
1000,520,500,510,257,512,769
1000,510,491,489,250,496,746
1000,485,487,484,235,511,746
1000,485,500,526,242,521,763
1000,499,493,469,250,470,720
1000,469,521,519,242,513,755
1000,474,518,492,251,485,736
1000,491,531,504,267,479,746
1000,488,499,486,245,490,735
1000,469,497,532,241,507,748
1000,499,496,493,259,487,746
1000,523,512,491,272,493,765
1000,510,486,510,238,510,748
1000,510,525,524,287,483,770
1000,533,484,461,254,486,740
1000,547,501,523,288,489,777
1000,487,481,508,246,501,747
1000,529,522,497,288,470,758
1000,516,483,473,263,491,754
1000,510,466,482,244,515,759
1000,492,510,510,245,488,733
1000,519,481,479,261,481,742
1000,501,465,495,242,502,744
1000,496,511,503,259,494,753
1000,487,532,519,270,475,745
1000,508,498,479,233,519,752
1000,543,490,485,250,519,769
1000,494,517,513,261,494,755
1000,521,527,499,273,490,763
1000,507,469,477,250,486,736
1000,496,480,507,240,493,733
1000,488,479,494,245,497,742
1000,506,492,502,250,498,748
1000,499,498,471,257,481,738
1000,512,477,500,244,516,760
1000,484,520,533,244,510,754
1000,499,503,501,265,484,749
1000,505,524,501,256,482,738
1000,508,522,510,253,493,746
1000,488,501,496,239,506,745
1000,492,496,491,238,509,747
1000,511,484,509,250,513,763
1000,484,507,502,247,508,755
1000,492,502,490,243,499,742
1000,510,487,492,240,521,761
1000,499,503,499,254,507,761
1000,499,489,493,250,501,751
1000,528,490,499,269,503,772
1000,506,484,491,250,505,755
1000,515,509,518,270,520,790
1000,499,504,466,253,488,741
1000,511,488,494,261,505,766
1000,512,515,548,255,527,782
1000,483,484,517,224,522,746
1000,481,490,500,237,504,741
1000,499,472,499,254,493,747
1000,501,495,490,247,483,730
1000,474,482,513,217,514,731
1000,480,502,493,238,491,729
1000,509,522,497,265,494,759
1000,508,520,488,260,499,759
1000,500,497,487,235,509,744
1000,493,523,514,272,484,756
1000,516,497,502,255,511,766
1000,483,523,512,259,476,735
1000,495,541,483,264,486,750
1000,501,518,522,262,502,764
1000,514,500,503,246,509,755
1000,492,506,479,243,498,741
1000,519,486,492,262,498,760
1000,516,509,495,269,472,741
1000,504,535,521,265,500,765
1000,500,524,496,253,497,750
1000,499,520,497,266,478,744
1000,496,529,498,269,476,745
1000,494,470,501,235,513,748
1000,512,527,511,281,474,755
1000,519,497,517,249,519,768
1000,513,501,488,254,496,750
1000,539,485,503,276,488,764
1000,540,498,483,262,508,770
1000,499,497,527,251,511,762
1000,529,509,504,284,483,767
1000,536,506,503,285,486,771
1000,488,459,476,223,512,735
1000,488,490,491,243,516,759
1000,494,505,486,266,488,754
1000,506,487,499,247,511,758
1000,542,526,457,279,468,747
1000,502,485,499,228,510,738
1000,450,492,532,208,534,742
1000,506,498,532,247,528,775
1000,493,517,499,250,493,743
1000,502,498,502,241,507,748
1000,515,504,504,269,496,765
1000,494,520,511,263,512,775
1000,490,491,483,241,497,738
1000,488,499,503,230,523,753
1000,505,467,490,230,510,740
1000,531,473,499,260,509,769
1000,486,525,513,268,490,758
1000,527,484,501,256,505,761
1000,472,488,493,240,504,744
1000,491,527,508,258,486,744
1000,449,506,510,232,501,733
1000,487,500,478,250,480,730
1000,492,496,521,248,514,762
1000,509,489,496,256,500,756
1000,516,513,509,271,488,759
1000,518,503,535,255,512,767
1000,505,502,498,259,498,757
1000,494,498,494,246,495,741
1000,487,480,524,234,515,749
1000,528,500,485,258,504,762
1000,460,494,560,217,561,778
1000,521,507,486,255,505,760
1000,496,542,546,272,500,772
1000,498,488,519,226,544,770
1000,509,529,501,272,479,751
1000,483,491,513,239,516,755
1000,494,482,489,222,522,744
1000,469,479,472,220,505,725
1000,516,532,500,266,482,748
1000,499,480,500,249,512,761
1000,524,523,506,288,479,767
1000,510,488,483,249,508,757
1000,492,494,484,233,518,751
1000,495,539,499,262,486,748
1000,504,498,510,256,510,766
1000,494,501,509,258,488,746
1000,527,530,526,271,515,786
1000,489,473,507,237,506,743
1000,477,484,486,223,499,722
1000,503,495,478,260,474,734
1000,474,491,495,223,515,738
1000,472,499,473,237,474,711
1000,500,513,486,248,489,737
1000,513,512,527,266,505,771
1000,501,484,520,241,513,754
1000,475,484,508,227,510,737
1000,485,520,485,256,492,748
1000,486,502,508,236,510,746
1000,485,500,518,223,530,753
1000,507,482,479,235,509,744
1000,495,494,490,241,502,743
1000,499,497,481,244,492,736
1000,533,500,477,259,493,752
1000,517,476,494,242,506,748
1000,491,503,516,238,508,746
1000,525,495,497,271,495,766
1000,498,507,505,246,500,746
1000,486,495,491,246,491,737
1000,518,514,492,258,502,760
1000,514,511,510,270,485,755
1000,507,507,483,255,496,751
1000,522,508,512,278,488,766
1000,476,490,489,223,505,728
1000,497,518,490,269,479,748
1000,520,510,495,262,504,766
1000,491,492,508,246,506,752
1000,518,478,502,250,510,760
1000,522,518,487,265,493,758
1000,500,511,529,250,544,794
1000,490,511,503,256,485,741
1000,521,491,492,258,495,753
1000,462,503,478,231,481,712
1000,513,485,495,247,496,743
1000,515,517,487,288,475,763
1000,536,484,497,263,515,778
1000,501,485,495,242,501,743
1000,495,472,504,245,513,758
1000,472,497,480,235,488,723
1000,512,505,488,245,487,732
1000,494,493,477,252,467,719
1000,498,506,483,246,497,743
1000,512,473,492,239,506,745
1000,511,504,490,264,483,747
1000,504,521,512,256,505,761
1000,513,481,507,256,496,752
1000,500,498,500,242,519,761
1000,499,478,511,230,525,755
1000,468,514,491,234,488,722
1000,498,496,490,251,490,741
1000,501,491,484,255,487,742
1000,492,499,509,255,492,747
1000,537,490,501,267,503,770
1000,487,514,495,255,481,736
1000,505,510,489,260,493,753
1000,507,536,487,271,480,751
1000,494,492,486,253,483,736
1000,501,467,512,227,536,763
1000,518,504,467,265,474,739
1000,490,502,492,235,522,757
1000,522,473,477,251,508,759
1000,497,486,492,233,507,740
1000,489,513,511,262,477,739
1000,519,493,488,244,516,760
1000,468,498,516,244,491,735
1000,497,481,506,237,512,749
1000,505,496,487,251,483,734
1000,467,485,492,227,497,724
1000,501,468,498,224,541,765
1000,502,516,493,262,492,754
1000,502,499,526,248,517,765
1000,514,496,499,258,503,761
1000,467,510,507,237,497,734
1000,482,479,476,256,476,732
1000,497,499,495,242,520,762
1000,493,508,515,252,489,741
1000,505,513,485,263,487,750
1000,499,504,483,269,477,746
1000,480,485,486,231,503,734
1000,496,498,501,254,487,741
1000,492,515,507,256,477,733
1000,515,543,493,285,471,756
1000,510,493,515,240,517,757
1000,494,507,477,252,483,735
1000,513,491,518,269,497,766
1000,497,483,494,239,512,751
1000,541,496,511,262,507,769
1000,498,505,530,239,525,764
1000,483,487,491,246,498,744
1000,506,491,514,245,510,755
1000,501,496,483,249,501,750
1000,524,517,522,261,518,779
1000,515,491,521,254,514,768
1000,489,516,488,243,489,732
1000,485,510,507,247,496,743
1000,500,524,504,258,507,765
1000,498,496,498,260,492,752
1000,504,527,494,259,486,745
1000,495,508,513,256,491,747
1000,504,509,538,247,527,774
1000,508,474,506,238,521,759
1000,498,462,505,221,522,743
1000,527,491,513,244,530,774
1000,517,508,493,266,489,755
1000,507,519,523,261,514,775
1000,482,499,506,242,498,740
1000,485,501,492,236,506,742
1000,509,487,494,258,509,767
1000,491,511,505,247,500,747
1000,514,525,494,264,492,756
1000,478,485,488,229,510,739
1000,516,472,525,245,517,762
1000,497,501,505,259,502,761
1000,510,487,493,232,520,752
1000,541,490,497,272,497,769
1000,496,502,484,248,509,757
1000,510,507,527,271,486,757
1000,522,517,475,262,475,737
1000,502,502,523,245,519,764
1000,506,515,486,257,498,755
1000,509,505,467,248,480,728
1000,507,477,510,238,522,760
1000,516,498,518,253,518,771
1000,500,495,491,257,483,740
1000,530,511,488,272,471,743
1000,531,520,481,274,482,756
1000,511,487,461,253,476,729
1000,482,488,504,236,505,741
1000,497,497,501,256,493,749
1000,492,503,511,250,499,749
1000,504,511,492,249,503,752
1000,509,507,482,258,480,738
1000,495,493,500,239,489,728
1000,492,520,480,255,487,742
1000,525,474,502,250,510,760
1000,459,499,481,235,480,715
1000,510,508,489,256,478,734
1000,484,494,531,236,516,752
1000,497,523,491,269,471,740
1000,514,516,497,260,502,762
1000,514,502,496,255,494,749
1000,497,531,518,267,485,752
1000,505,512,497,264,486,750
1000,505,509,478,263,474,737
1000,498,512,508,250,511,761
1000,490,500,485,238,499,737
1000,500,500,483,233,500,733
1000,494,493,491,227,497,724
1000,508,496,497,240,513,753
1000,514,492,493,230,525,755
1000,498,502,471,247,470,717
1000,488,499,537,242,526,768
1000,510,461,509,234,520,754
1000,514,492,516,258,501,759
1000,511,469,512,255,500,755
1000,512,492,512,243,527,770
1000,487,496,514,232,530,762
1000,507,474,496,244,512,756
1000,486,488,476,235,489,724
1000,485,462,495,232,508,740
1000,505,493,502,252,503,755
1000,502,501,494,235,520,755
1000,480,471,515,218,525,743
1000,504,522,508,257,493,750
1000,528,491,498,261,502,763
1000,504,513,485,256,488,744
1000,544,524,513,293,490,783
1000,470,506,491,243,486,729
1000,497,481,511,241,512,753
1000,482,530,513,248,501,749
1000,529,480,501,263,499,762
1000,521,478,481,239,509,748
1000,509,483,487,230,529,759
1000,506,491,498,252,489,741
1000,492,490,470,249,480,729
1000,491,492,519,247,510,757
1000,481,499,493,248,487,735
1000,511,507,494,250,511,761
1000,485,483,495,229,519,748
1000,516,503,481,258,498,756
1000,525,486,482,260,487,747
1000,491,505,486,251,485,736
1000,500,493,487,252,489,741
1000,490,499,499,236,510,746
1000,497,515,511,248,503,751
1000,505,504,494,269,492,761
1000,487,492,481,243,487,730
1000,518,482,479,244,508,752
1000,489,501,533,255,504,759
1000,490,479,503,242,503,745
1000,495,533,491,274,473,747
1000,491,504,507,251,491,742
1000,505,478,512,248,509,757
1000,517,534,496,289,472,761
1000,484,499,489,261,483,744
1000,509,481,497,251,496,747
1000,506,520,493,269,465,734
1000,502,500,501,254,492,746
1000,511,500,503,261,490,751
1000,504,494,488,242,486,728
1000,498,548,525,282,466,748
1000,501,502,472,260,489,749
1000,502,507,505,251,522,773
1000,497,484,510,248,510,758
1000,504,502,512,248,497,745
1000,524,466,493,250,501,751
1000,515,480,527,239,518,757
1000,499,487,500,230,528,758
1000,497,484,496,249,494,743
1000,497,480,526,235,516,751
1000,494,488,484,246,493,739
1000,485,504,496,238,497,735
1000,503,459,501,222,530,752
1000,510,499,488,244,477,721
1000,483,507,501,239,498,737
1000,520,483,517,247,523,770
1000,498,509,503,244,499,743
1000,518,524,482,277,471,748
1000,516,500,521,242,521,763
1000,510,477,498,249,510,759
1000,482,499,507,238,505,743
1000,485,519,540,257,503,760
1000,481,501,507,243,502,745
1000,515,478,515,242,518,760
1000,515,524,521,262,511,773
1000,481,497,499,237,500,737
1000,474,498,491,231,497,728
1000,491,516,516,253,499,752
1000,480,513,478,242,499,741
1000,511,525,512,282,490,772
1000,507,512,494,266,478,744
1000,510,509,485,260,496,756
1000,490,501,498,241,507,748
1000,501,492,466,250,475,725
1000,515,486,517,248,522,770
1000,511,507,476,258,509,767
1000,485,513,525,255,483,738
1000,517,491,505,263,503,766
1000,511,467,492,239,505,744
1000,493,525,473,260,498,758
1000,509,499,459,255,466,721
1000,494,485,514,250,486,736
1000,539,516,491,276,490,766
1000,508,490,520,251,518,769
1000,500,512,511,254,510,764
1000,520,483,484,257,513,770
1000,510,502,535,246,539,785
1000,487,512,480,257,489,746
1000,486,490,481,247,492,739
1000,497,531,529,264,487,751
1000,484,510,491,232,500,732
1000,523,492,516,278,488,766
1000,513,507,506,263,509,772
1000,516,503,516,262,511,773
1000,475,501,521,237,510,747
1000,506,489,488,246,490,736
1000,508,510,491,258,499,757
1000,478,506,517,240,507,747
1000,494,474,504,211,532,743
1000,491,509,484,249,497,746
1000,512,485,492,255,486,741
1000,526,524,526,279,499,778
1000,512,495,519,250,504,754
1000,485,515,498,251,507,758
1000,504,522,511,268,482,750
1000,507,516,532,276,489,765
1000,483,515,483,246,482,728
1000,537,496,509,270,514,784
1000,511,481,487,251,506,757
1000,471,472,517,230,511,741
1000,492,512,534,254,509,763
1000,500,503,483,253,491,744
1000,508,489,506,256,500,756
1000,509,519,505,258,486,744
1000,515,484,491,243,506,749
1000,488,498,504,258,483,741
1000,466,473,489,218,502,720
1000,493,489,497,247,495,742
1000,514,521,495,269,484,753
1000,515,512,508,260,504,764
1000,506,501,493,243,508,751
1000,488,471,512,220,526,746
1000,519,503,498,260,496,756
1000,451,502,482,225,479,704
1000,499,515,505,247,506,753
1000,479,505,514,237,507,744
1000,505,482,478,241,511,752
1000,480,476,518,232,512,744
1000,501,494,518,236,525,761
1000,515,507,504,264,494,758
1000,519,494,501,258,506,764
1000,476,504,514,232,510,742
1000,487,515,495,239,497,736
1000,465,489,481,224,510,734
1000,495,521,479,256,482,738
1000,504,526,539,279,494,773
1000,516,489,502,252,508,760
1000,515,486,511,249,509,758
1000,497,514,515,264,494,758
1000,498,466,507,235,513,748
1000,516,485,516,228,536,764
1000,515,507,519,261,499,760
1000,497,493,477,246,478,724
1000,501,513,506,258,493,751
1000,495,483,502,246,510,756
1000,487,528,502,251,486,737
1000,495,506,490,251,489,740
1000,529,507,512,260,527,787
1000,500,504,510,257,502,759
1000,494,496,510,238,517,755
1000,508,507,515,255,513,768
1000,508,497,507,231,527,758
1000,484,520,501,253,500,753
1000,491,502,519,232,527,759
1000,490,516,523,265,509,774
1000,505,534,493,263,482,745
1000,504,497,498,247,497,744
1000,517,485,514,249,535,784
1000,514,509,501,268,492,760
1000,477,500,478,234,494,728
1000,509,502,499,259,496,755
1000,504,481,509,236,521,757
1000,502,480,450,235,491,726
1000,504,510,501,257,491,748
1000,494,515,501,251,494,745
1000,502,495,496,238,514,752
1000,539,497,497,261,503,764
1000,499,492,500,246,502,748
1000,499,490,487,238,480,718
1000,517,507,515,258,500,758
1000,501,499,496,257,489,746
1000,487,501,519,236,515,751
1000,515,501,485,257,490,747
1000,488,517,495,263,480,743
1000,471,503,483,238,475,713
1000,522,500,492,261,503,764
1000,484,499,507,237,505,742
1000,497,500,494,261,488,749
1000,498,487,479,239,499,738
1000,504,452,487,216,527,743
1000,512,490,503,256,492,748
1000,498,522,535,274,486,760
1000,485,514,503,248,490,738
1000,486,506,492,248,487,735
1000,520,483,487,250,485,735
1000,508,505,505,256,499,755
1000,468,498,508,221,513,734
1000,470,507,495,232,491,723
1000,519,482,507,253,516,769
1000,508,529,510,271,491,762
1000,514,500,520,263,510,773
1000,508,525,507,270,477,747
1000,491,504,538,243,521,764
1000,499,509,510,242,501,743
1000,500,498,508,251,496,747
1000,499,503,481,259,475,734
1000,498,510,491,246,494,740
1000,516,492,532,247,516,763
1000,503,496,483,252,498,750
1000,520,495,493,253,520,773
1000,505,503,525,256,502,758
1000,509,499,493,263,467,730
1000,530,496,498,252,516,768
1000,500,512,501,246,500,746
1000,507,500,481,243,495,738
1000,487,494,508,242,502,744
1000,482,498,506,241,511,752
1000,497,509,484,253,490,743
1000,489,509,519,245,501,746
1000,525,481,509,251,512,763
1000,479,491,511,229,512,741
1000,458,512,482,236,487,723
1000,503,476,527,239,514,753
1000,502,494,482,245,513,758
1000,472,527,498,252,480,732
1000,519,486,529,254,524,778
1000,510,511,511,266,489,755
1000,497,515,492,261,471,732
1000,518,452,492,221,538,759
1000,511,514,502,268,489,757
1000,503,499,478,253,483,736
1000,510,512,473,268,457,725
1000,488,505,510,256,492,748
1000,523,495,497,245,512,757
1000,479,495,500,233,508,741
1000,491,502,500,251,509,760
1000,499,496,475,257,478,735
1000,511,508,507,254,509,763
1000,473,474,469,210,514,724
1000,484,521,503,258,492,750
1000,486,505,503,234,504,738
1000,514,518,528,276,498,774
1000,492,526,480,243,488,731
1000,491,488,480,216,525,741
1000,519,496,487,264,484,748
1000,498,483,501,241,507,748
1000,491,505,473,242,489,731
1000,502,485,505,233,523,756
1000,497,480,492,231,537,768
1000,503,496,497,250,496,746
1000,478,525,481,253,476,729
1000,506,482,495,250,491,741
1000,509,502,490,249,491,740
1000,520,522,519,272,493,765
1000,487,498,507,250,486,736
1000,521,508,493,268,478,746
1000,514,502,487,260,498,758
1000,503,520,484,263,490,753
1000,504,498,489,250,503,753
1000,508,500,514,269,484,753
1000,488,497,509,240,509,749
1000,498,499,478,232,510,742
1000,522,514,484,275,477,752
1000,503,510,497,242,510,752
1000,490,491,504,237,500,737
1000,482,469,523,216,539,755
1000,512,489,499,247,514,761
1000,507,509,494,257,490,747
1000,511,495,463,257,471,728
1000,519,516,512,285,474,759
1000,522,522,487,276,476,752
1000,486,475,512,231,516,747
1000,512,495,510,260,502,762
1000,512,515,489,269,478,747
1000,499,499,505,247,497,744
1000,524,495,487,263,497,760
1000,481,488,488,247,482,729
1000,511,515,520,255,512,767
1000,489,545,516,255,502,757
1000,510,501,479,267,483,750
1000,469,471,527,211,530,741
1000,511,486,522,239,539,778
1000,481,501,511,245,504,749
1000,486,500,481,255,486,741
1000,497,504,505,245,514,759
1000,495,496,498,259,491,750
1000,491,512,459,260,461,721
1000,500,498,499,249,513,762
1000,467,513,502,246,479,725
1000,506,498,494,260,499,759
1000,502,476,505,245,510,755
1000,492,489,516,240,501,741
1000,500,465,503,228,533,761
1000,522,513,520,273,495,768
1000,513,515,536,270,512,782
1000,477,536,510,260,490,750
1000,506,516,482,248,495,743
1000,474,517,515,233,514,747
1000,523,525,478,276,456,732
1000,507,511,480,250,496,746
1000,469,494,502,230,502,732
1000,507,488,510,256,501,757
1000,498,480,529,233,532,765
1000,480,495,505,233,510,743
1000,513,492,506,241,503,744
1000,504,519,507,261,492,753
1000,516,497,473,254,485,739
1000,495,508,479,257,480,737
1000,509,526,492,268,485,753
1000,497,539,504,272,478,750
1000,499,503,485,258,495,753
1000,488,494,501,240,505,745
1000,499,510,517,257,508,765
1000,467,493,485,222,504,726
1000,500,508,498,241,506,747
1000,497,495,485,239,493,732
1000,469,474,488,225,512,737
1000,510,486,489,251,498,749
1000,500,505,475,237,492,729
1000,509,490,485,253,494,747
1000,489,490,513,244,500,744
1000,484,509,497,258,481,739
1000,499,522,501,266,487,753
1000,507,493,503,241,508,749
1000,492,509,475,250,487,737
1000,527,501,513,257,510,767
1000,493,486,513,252,517,769
1000,497,442,502,222,522,744
1000,490,490,512,238,507,745
1000,512,480,475,238,500,738
1000,532,503,483,266,492,758
1000,527,490,490,256,500,756
1000,511,511,507,262,499,761
1000,509,520,530,281,489,770
1000,524,521,504,264,508,772
1000,487,495,496,252,490,742
1000,509,491,529,244,535,779
1000,525,518,499,266,492,758
1000,505,499,532,254,504,758
1000,495,498,501,233,523,756
1000,499,494,507,245,510,755
1000,488,511,516,247,501,748
1000,520,513,507,265,494,759
1000,485,501,477,253,468,721
1000,483,488,483,247,485,732
1000,509,497,497,256,490,746
1000,494,495,516,254,494,748
1000,501,500,483,254,486,740
1000,487,518,500,249,498,747
1000,486,486,475,241,487,728
1000,496,506,515,254,500,754
1000,475,484,490,234,486,720
1000,483,464,500,232,507,739
1000,513,491,513,242,507,749
1000,505,521,508,266,478,744
1000,471,507,492,245,494,739
1000,511,522,492,276,486,762
1000,488,501,521,253,491,744
1000,524,503,499,283,485,768
1000,493,513,528,248,498,746
1000,498,516,513,253,505,758
1000,501,490,485,248,503,751
1000,513,488,513,260,505,765
1000,485,466,495,220,530,750
1000,483,504,483,221,516,737
1000,491,487,466,243,485,728
1000,489,493,535,230,528,758
1000,536,512,493,278,487,765
1000,521,497,484,244,501,745
1000,495,496,485,238,508,746
1000,521,526,504,291,484,775
1000,509,485,498,258,497,755
1000,496,502,530,245,504,749
1000,512,492,484,256,504,760
1000,514,523,506,273,496,769
1000,533,515,500,274,472,746
1000,500,523,485,271,473,744
1000,504,509,506,247,490,737
1000,513,502,485,256,490,746
1000,476,482,518,224,530,754
1000,486,511,510,245,507,752
1000,511,492,479,261,473,734
1000,515,494,507,255,490,745
1000,508,503,472,266,470,736
1000,470,478,519,240,513,753
1000,526,501,495,255,514,769
1000,492,512,525,241,522,763
1000,487,517,513,263,503,766
1000,507,517,506,255,498,753
1000,530,556,497,289,478,767
1000,511,534,492,259,486,745
1000,523,485,482,265,494,759
1000,535,495,502,269,507,776
1000,501,488,514,248,515,763
1000,479,498,521,230,529,759
1000,477,485,492,233,496,729
1000,487,493,483,230,507,737
1000,498,539,499,266,480,746
1000,505,490,487,254,493,747
1000,513,489,539,273,505,778
1000,498,552,511,271,488,759
1000,502,516,484,262,472,734
1000,504,516,517,258,488,746
1000,483,480,502,225,527,752
1000,487,515,492,249,486,735
1000,478,513,502,249,494,743
1000,512,498,498,256,502,758
1000,500,501,511,252,498,750
1000,498,501,485,245,497,742
1000,505,486,506,253,494,747
1000,498,490,512,244,508,752
1000,475,518,491,247,496,743
1000,484,505,493,251,491,742
1000,511,494,493,250,495,745
1000,462,528,483,246,476,722
1000,512,485,498,241,517,758
1000,501,498,494,251,495,746
1000,491,519,506,256,484,740
1000,491,481,473,244,488,732
1000,503,497,533,254,515,769
1000,497,519,498,264,477,741
1000,521,506,509,255,512,767
1000,518,473,502,252,506,758
1000,523,524,517,271,484,755
1000,503,505,491,258,493,751
1000,474,506,476,236,490,726
1000,501,483,513,239,507,746
1000,525,490,535,242,530,772
1000,487,491,483,241,501,742
1000,514,477,499,244,514,758
1000,525,488,489,261,500,761
1000,488,481,499,237,503,740
1000,511,503,499,263,486,749
1000,469,498,482,242,477,719
1000,527,498,493,261,502,763
1000,529,475,487,271,481,752
1000,515,486,491,247,496,743
1000,500,516,499,249,500,749
1000,486,505,526,235,528,763
1000,503,491,484,228,519,747
1000,506,515,485,269,472,741
1000,505,488,529,242,540,782
1000,502,487,508,231,515,746
1000,465,488,486,205,517,722
1000,473,480,512,232,495,727
1000,511,495,480,240,507,747
1000,509,496,514,249,504,753
1000,495,517,526,253,510,763
1000,517,498,516,260,504,764
1000,499,507,514,250,506,756
1000,504,510,503,257,498,755
1000,492,495,483,236,499,735
1000,499,499,500,236,512,748
1000,473,547,472,257,464,721
1000,473,478,489,210,526,736
1000,511,505,528,264,492,756
1000,484,525,473,245,482,727
1000,468,495,483,229,482,711
1000,483,506,513,239,502,741
1000,490,515,492,253,491,744
1000,493,498,493,257,480,737
1000,472,486,490,224,507,731
1000,493,505,522,241,545,786
1000,503,497,489,253,488,741
1000,488,502,493,253,478,731
1000,518,517,522,277,499,776
1000,449,485,517,217,516,733
1000,497,496,508,244,502,746
1000,477,504,504,235,506,741
1000,512,490,478,250,500,750
1000,501,497,513,263,492,755
1000,477,534,504,256,481,737
1000,517,482,496,244,516,760
1000,490,489,498,249,491,740
1000,516,480,487,236,518,754
1000,483,477,478,222,500,722
1000,524,504,494,263,486,749
1000,508,476,516,248,520,768
1000,492,506,504,249,486,735
1000,505,490,510,249,510,759
1000,521,498,499,272,487,759
1000,488,523,494,254,502,756
1000,503,488,510,266,487,753
1000,502,515,503,254,498,752
1000,527,534,500,276,487,763
1000,510,504,510,255,503,758
1000,487,497,491,244,487,731
1000,507,517,474,268,484,752
1000,497,518,509,240,517,757
1000,514,514,494,260,504,764
1000,497,488,521,232,532,764
1000,506,507,501,259,503,762
1000,509,494,492,256,491,747
1000,506,501,488,256,503,759
1000,497,511,519,253,507,760
1000,492,522,529,264,495,759
1000,519,504,483,273,464,737
1000,480,511,479,244,488,732
1000,501,498,496,252,495,747
1000,518,506,501,272,481,753
1000,478,538,511,269,455,724
1000,498,485,506,236,518,754
1000,499,488,502,243,519,762
1000,516,496,471,256,493,749
1000,515,518,515,270,489,759
1000,487,511,505,260,501,761
1000,519,468,513,239,537,776
1000,481,492,477,238,483,721
1000,468,487,485,216,509,725
1000,495,491,521,241,505,746
1000,502,522,496,265,499,764
1000,500,496,490,252,495,747
1000,469,469,467,219,508,727
1000,515,512,488,270,474,744
1000,516,501,494,261,496,757
1000,512,478,478,237,509,746
1000,476,496,516,231,506,737
1000,487,509,487,255,494,749
1000,507,502,493,238,504,742
1000,489,518,491,258,483,741
1000,486,526,478,256,485,741
1000,464,502,509,238,495,733
1000,482,507,480,251,468,719
1000,515,498,500,264,485,749
1000,480,493,554,246,522,768
1000,499,510,483,251,495,746
1000,473,500,504,238,491,729
1000,484,482,485,227,516,743
1000,496,475,511,234,518,752
1000,507,506,515,254,522,776
1000,486,508,496,264,471,735
1000,501,506,492,261,487,748
1000,493,512,480,248,468,716
1000,497,486,481,246,496,742
1000,501,472,503,245,507,752
1000,517,503,464,241,516,757
1000,487,482,477,228,508,736
1000,482,535,515,250,495,745
1000,497,513,493,255,480,735
1000,529,517,482,277,486,763
1000,500,492,513,242,525,767
1000,507,494,493,251,503,754
1000,490,503,494,257,470,727
1000,515,516,517,281,498,779
1000,508,481,520,245,514,759
1000,500,490,492,244,500,744
1000,507,500,496,248,482,730
1000,492,508,477,243,489,732
1000,504,502,527,243,517,760
1000,502,491,523,254,503,757
1000,477,494,490,229,492,721
1000,490,496,520,239,510,749
1000,513,503,492,258,481,739
1000,498,475,520,236,527,763
1000,515,504,510,262,492,754
1000,508,528,481,266,482,748
1000,493,516,483,248,496,744
1000,496,476,501,230,522,752
1000,522,503,508,260,508,768
1000,509,483,499,242,506,748
1000,521,509,489,258,497,755
1000,514,525,509,274,477,751
1000,467,488,516,219,512,731
1000,490,506,512,253,496,749
1000,490,495,492,256,491,747
1000,491,529,484,265,480,745
1000,494,479,488,247,497,744
1000,511,491,506,237,522,759
1000,507,457,494,230,524,754
1000,501,516,494,272,489,761
1000,511,484,523,243,527,770
1000,504,532,481,263,487,750
1000,526,498,516,252,528,780
1000,507,522,510,270,482,752
1000,480,505,480,245,479,724
1000,475,503,495,245,500,745
1000,500,495,512,236,519,755
1000,487,512,517,243,499,742
1000,482,495,484,235,501,736
1000,505,496,533,239,516,755
1000,494,491,517,247,506,753
1000,489,491,497,249,490,739
1000,491,524,471,242,485,727
1000,498,499,483,236,508,744
1000,516,538,500,277,482,759
1000,498,509,521,254,521,775
1000,478,490,479,243,489,732
1000,490,490,499,241,507,748
1000,487,506,507,242,511,753
1000,511,501,491,270,482,752
1000,465,491,476,234,488,722
1000,502,508,510,252,513,765
1000,507,497,518,232,540,772
1000,508,512,537,258,521,779
1000,500,489,485,249,488,737
1000,517,501,470,259,475,734
1000,484,510,509,242,498,740
1000,496,489,502,249,511,760
1000,491,528,493,253,483,736
1000,486,508,511,238,503,741
1000,477,489,480,231,497,728
1000,499,496,487,254,480,734
1000,489,497,479,247,490,737
1000,487,520,496,258,476,734
1000,507,545,497,273,486,759
1000,496,499,485,238,492,730
1000,492,510,505,241,505,746
1000,516,494,517,253,509,762
1000,522,511,499,267,476,743
1000,466,480,518,219,524,743
1000,486,494,507,236,512,748
1000,506,508,518,246,511,757
1000,550,529,498,300,475,775
1000,510,505,513,254,505,759
1000,484,493,493,231,503,734
1000,520,539,479,293,450,743
1000,495,516,514,258,489,747
1000,499,481,518,245,507,752
1000,477,486,515,235,512,747
1000,501,520,490,262,485,747
1000,490,531,489,262,471,733
1000,523,516,466,276,446,722
1000,491,473,500,243,516,759
1000,480,533,500,253,490,743
1000,493,524,482,260,483,743
1000,506,495,503,252,505,757
1000,496,526,502,257,484,741
1000,489,507,481,253,468,721
1000,529,528,509,270,500,770
1000,479,511,508,240,493,733
1000,481,484,504,236,509,745
1000,510,503,473,251,490,741
1000,497,494,500,242,502,744
1000,495,494,495,243,518,761
1000,513,486,512,259,510,769
1000,468,510,514,235,520,755
1000,501,482,505,231,528,759
1000,495,509,493,255,497,752
1000,517,478,496,255,510,765
1000,515,504,514,256,504,760
1000,497,494,514,252,502,754
1000,483,492,507,235,517,752
1000,502,518,483,252,497,749
1000,512,518,519,259,495,754
1000,498,483,494,221,520,741
1000,479,477,487,236,500,736
1000,507,477,489,243,508,751
1000,493,512,494,247,499,746
1000,522,504,475,267,490,757
1000,511,506,514,252,523,775
1000,505,487,498,251,501,752
1000,501,519,512,261,506,767
1000,499,486,484,256,493,749
1000,522,508,500,262,502,764
1000,490,507,506,253,505,758
1000,512,519,509,254,504,758
1000,519,510,509,255,501,756
1000,504,536,498,267,479,746
1000,513,493,496,247,512,759
1000,497,488,495,246,495,741
1000,537,501,528,256,525,781
1000,477,509,512,244,494,738
1000,507,482,490,233,528,761
1000,482,503,504,244,510,754
1000,497,528,492,261,489,750
1000,513,511,524,272,509,781
1000,494,515,509,252,498,750
1000,480,524,505,255,487,742
1000,527,494,520,274,496,770
1000,503,516,508,260,503,763
1000,513,500,493,256,480,736
1000,536,516,477,282,473,755
1000,511,524,506,285,474,759
1000,510,492,503,250,513,763
1000,510,517,506,273,482,755
1000,516,484,489,258,481,739
1000,509,507,485,247,495,742
1000,480,494,486,224,502,726
1000,514,535,510,272,504,776
1000,524,488,537,257,521,778
1000,506,514,512,251,506,757
1000,491,500,505,233,514,747
1000,517,505,496,254,503,757
1000,502,482,498,249,497,746
1000,505,528,490,272,470,742
1000,524,485,536,255,530,785
1000,541,482,471,273,485,758
1000,516,490,496,254,499,753
1000,512,491,479,280,466,746
1000,503,499,491,254,502,756
1000,484,503,521,242,508,750
1000,463,488,492,215,514,729
1000,512,491,490,251,504,755
1000,506,494,480,257,494,751
1000,486,510,484,253,496,749
1000,530,488,464,263,498,761
1000,499,526,497,248,500,748
1000,488,502,518,246,509,755
1000,504,480,506,236,519,755
1000,493,486,517,242,513,755
1000,502,486,503,256,492,748
1000,510,493,498,248,514,762
1000,517,472,487,250,497,747
1000,486,517,508,252,497,749
1000,462,475,508,232,503,735
1000,512,510,491,255,485,740
1000,514,506,478,251,490,741
1000,527,503,506,261,492,753
1000,474,509,491,236,491,727
1000,496,483,520,253,500,753
1000,527,492,544,268,523,791
1000,496,522,506,260,495,755
1000,501,490,516,246,513,759
1000,483,503,492,241,511,752
1000,502,467,488,239,504,743
1000,497,505,467,246,488,734
1000,485,477,524,225,543,768
1000,497,497,501,238,517,755
1000,494,528,486,262,483,745
1000,521,510,505,270,483,753
1000,486,494,481,240,487,727
1000,490,480,502,235,502,737
1000,496,495,501,239,505,744
1000,511,506,493,250,497,747
1000,530,496,513,265,511,776
1000,499,496,471,242,490,732
1000,493,505,492,250,486,736
1000,504,504,494,263,494,757
1000,534,509,494,278,484,762
1000,499,526,505,255,494,749
1000,503,512,497,248,515,763
1000,513,452,506,236,531,767
1000,512,528,552,267,525,792
1000,503,517,531,265,512,777
1000,476,521,495,250,487,737
1000,474,489,482,242,486,728
1000,495,499,511,241,516,757
1000,498,497,538,244,534,778
1000,498,529,476,264,483,747
1000,483,520,505,253,508,761
1000,482,505,503,246,498,744
1000,504,498,508,248,518,766
1000,512,504,482,263,482,745
1000,501,501,486,244,496,740
1000,483,489,489,237,503,740
1000,482,495,515,236,519,755
1000,504,485,512,255,503,758
1000,502,510,517,246,523,769
1000,526,541,483,289,474,763
1000,463,498,482,235,482,717
1000,511,471,512,223,537,760
1000,504,507,512,274,491,765
1000,485,518,512,240,503,743
1000,507,486,511,251,517,768
1000,494,483,495,241,500,741
1000,505,506,520,241,518,759
1000,498,515,521,253,502,755
1000,516,531,489,275,479,754
1000,515,493,528,258,505,763
1000,507,501,500,250,510,760
1000,460,501,533,234,514,748
1000,485,518,507,261,480,741
1000,516,504,496,274,481,755
1000,494,491,503,243,501,744
1000,499,513,525,248,512,760
1000,530,477,512,236,528,764
1000,535,499,504,260,504,764
1000,494,483,512,230,522,752
1000,493,461,494,229,514,743
1000,490,506,501,251,500,751
1000,478,517,491,242,494,736
1000,496,507,509,250,499,749
1000,477,515,484,258,470,728
1000,493,507,499,252,496,748
1000,504,490,481,248,498,746
1000,488,467,511,225,522,747
1000,509,503,468,259,472,731
1000,473,519,484,248,481,729
1000,496,494,500,247,516,763
1000,488,503,507,249,503,752
1000,505,502,497,253,498,751
1000,500,513,524,247,516,763
1000,515,487,519,250,516,766
1000,484,484,463,232,485,717
1000,480,505,498,239,500,739
1000,495,490,527,237,525,762
1000,481,486,479,228,504,732
1000,467,501,474,226,495,721
1000,507,490,489,239,513,752
1000,510,516,487,260,492,752
1000,503,502,494,245,502,747
1000,503,490,482,236,518,754
1000,519,484,514,248,523,771
1000,492,495,518,249,493,742
1000,496,500,530,253,506,759
1000,530,487,516,253,524,777
1000,505,485,487,246,508,754
1000,529,525,484,277,493,770
1000,495,509,503,253,498,751
1000,512,498,501,255,490,745
1000,499,490,501,247,505,752
1000,511,495,495,256,487,743
1000,497,524,530,264,506,770
1000,487,500,485,241,478,719
1000,509,494,475,245,502,747
1000,484,490,534,234,528,762
1000,478,495,500,233,524,757
1000,533,498,501,257,495,752
1000,533,506,490,263,500,763
1000,520,479,492,251,493,744
1000,500,500,499,252,493,745
1000,510,503,496,260,480,740
1000,489,489,512,222,520,742
1000,518,505,491,269,481,750
1000,484,518,495,253,486,739
1000,503,505,489,250,499,749
1000,520,504,492,261,503,764
1000,514,488,519,255,504,759
1000,512,499,527,259,520,779
1000,520,497,491,237,518,755
1000,513,490,523,245,533,778
1000,491,487,511,242,518,760
1000,485,493,497,238,490,728
1000,440,518,513,213,506,719
1000,491,507,507,256,478,734
1000,498,503,504,246,507,753
1000,513,482,495,241,525,766
1000,524,471,491,239,499,738
1000,508,499,485,251,500,751
1000,484,498,496,239,500,739
1000,506,509,499,249,506,755
1000,500,489,498,235,518,753
1000,505,480,485,240,507,747
1000,496,512,477,244,494,738
1000,516,490,492,260,494,754
1000,518,508,500,261,512,773
1000,504,529,489,256,496,752
1000,497,475,475,249,483,732
1000,475,481,494,240,490,730
1000,501,500,501,248,502,750
1000,503,504,499,250,491,741
1000,493,478,502,233,493,726
1000,521,513,491,278,478,756
1000,476,516,517,242,496,738
1000,524,516,479,281,463,744
1000,490,525,478,256,465,721
1000,523,500,507,262,511,773
1000,494,503,470,247,488,735
1000,518,472,468,250,498,748
1000,478,536,480,251,479,730
1000,492,474,505,232,524,756
1000,482,513,470,251,478,729
1000,509,490,492,270,485,755
1000,470,491,474,233,469,702
1000,471,503,518,241,509,750
1000,507,507,506,258,490,748
1000,496,522,477,258,482,740
1000,505,475,496,245,503,748
1000,512,506,509,241,515,756
1000,523,473,491,247,510,757
1000,505,524,520,264,508,772
1000,511,513,497,265,495,760
1000,464,494,503,242,486,728
1000,505,500,505,246,509,755
1000,486,503,484,249,484,733
1000,516,504,475,249,502,751
1000,484,502,495,239,492,731
1000,515,485,504,249,527,776
1000,498,497,494,248,496,744
1000,496,502,499,250,501,751
1000,479,496,499,238,506,744
1000,480,520,501,239,520,759
1000,505,473,490,229,513,742
1000,464,513,522,245,501,746
1000,480,487,499,230,496,726
1000,480,531,488,266,471,737
1000,517,492,489,263,498,761
1000,508,488,484,253,488,741
1000,530,494,493,260,501,761
1000,491,505,519,242,495,737
1000,493,516,496,257,484,741
1000,480,515,466,260,460,720
1000,512,510,501,269,485,754
1000,511,493,496,264,489,753
1000,497,463,515,231,531,762
1000,511,490,489,261,494,755
1000,504,493,494,253,485,738
1000,526,512,511,268,488,756
1000,519,496,494,259,499,758
1000,469,504,514,237,492,729
1000,503,515,510,256,494,750
1000,489,508,509,249,489,738
1000,483,492,474,242,506,748
1000,488,495,486,235,503,738
1000,510,481,494,243,506,749
1000,502,504,518,243,530,773
1000,496,478,487,242,515,757
1000,496,483,507,232,531,763
1000,515,488,494,243,505,748
1000,501,505,514,251,490,741
1000,521,514,518,277,483,760
1000,494,491,509,244,507,751
1000,479,507,484,232,494,726
1000,504,498,491,257,490,747
1000,527,491,502,253,509,762
1000,507,491,514,244,513,757
1000,488,510,500,258,483,741
1000,542,493,528,286,502,788
1000,517,525,501,273,487,760
1000,498,489,508,245,512,757
1000,498,476,474,232,506,738
1000,473,517,501,262,474,736
1000,505,513,506,256,498,754
1000,488,463,500,230,505,735
1000,478,498,493,243,497,740
1000,506,499,499,253,508,761
1000,495,498,500,240,495,735
1000,481,486,504,226,523,749
1000,487,478,485,229,495,724
1000,496,519,508,268,498,766
1000,505,505,479,256,486,742
1000,483,514,501,239,508,747
1000,506,523,484,273,479,752
1000,511,519,496,269,487,756
1000,479,497,509,230,515,745
1000,487,511,513,246,488,734
1000,499,517,496,259,485,744
1000,499,508,496,259,484,743
1000,498,493,505,238,510,748
1000,499,507,507,252,497,749
1000,503,506,486,263,482,745
1000,517,516,502,255,504,759
1000,497,523,519,258,497,755
1000,474,511,481,229,507,736
1000,509,529,490,275,480,755
1000,488,521,498,257,481,738
1000,520,499,498,259,499,758
1000,496,498,457,233,495,728
1000,478,513,525,245,519,764
1000,522,502,510,261,487,748
1000,502,493,501,257,491,748
1000,475,520,488,228,502,730
1000,500,505,504,248,507,755
1000,519,482,514,244,512,756
1000,520,486,508,260,512,772
1000,505,492,518,248,505,753
1000,495,508,495,249,504,753
1000,487,507,484,246,470,716
1000,524,490,531,252,525,777
1000,526,523,526,266,502,768
1000,500,502,469,259,472,731
1000,526,495,510,271,506,777
1000,489,505,488,243,510,753
1000,509,482,496,246,508,754
1000,498,515,522,253,497,750
1000,512,527,518,283,476,759
1000,489,483,508,236,507,743
1000,483,496,510,242,495,737
1000,500,507,470,261,481,742
1000,483,515,517,234,523,757
1000,504,476,512,235,526,761
1000,469,504,496,243,501,744
1000,509,497,509,262,495,757
1000,509,502,506,257,501,758
1000,487,506,527,233,526,759
1000,520,500,528,252,533,785
1000,499,494,497,251,494,745
1000,484,513,494,239,509,748
1000,509,521,514,278,490,768
1000,503,496,510,243,515,758
1000,511,522,493,274,471,745
1000,513,501,496,254,518,772
1000,522,523,512,279,476,755
1000,509,458,493,248,498,746
1000,514,495,532,262,517,779
1000,509,518,513,266,497,763
1000,515,487,498,264,499,763
1000,506,498,507,268,492,760
1000,541,509,517,258,515,773
1000,470,492,480,235,481,716
1000,514,504,502,252,506,758
1000,519,506,514,265,491,756
1000,501,476,531,244,525,769
1000,497,494,542,239,521,760
1000,512,485,501,248,506,754
1000,494,485,481,245,497,742
1000,468,500,482,237,500,737
1000,504,494,480,254,500,754
1000,464,506,493,237,490,727
1000,507,497,494,252,513,765
1000,521,526,484,273,479,752
1000,487,506,484,240,505,745
1000,514,486,480,248,496,744
1000,514,513,498,267,501,768
1000,500,496,459,256,460,716
1000,491,511,487,244,492,736
1000,490,494,519,253,488,741
1000,496,500,514,251,511,762
1000,505,486,506,253,509,762
1000,491,517,490,247,498,745
1000,495,491,508,239,521,760
1000,495,494,491,251,497,748
1000,516,474,491,242,528,770
1000,507,503,528,243,529,772
1000,498,483,497,243,512,755
1000,492,482,496,230,503,733
1000,519,512,510,264,508,772
1000,484,504,506,223,520,743
1000,487,526,489,269,467,736
1000,485,505,484,244,503,747
1000,485,530,452,254,462,716
1000,508,497,512,268,497,765
1000,514,457,478,251,493,744
1000,520,497,512,255,510,765
1000,513,491,514,261,500,761
1000,497,522,476,264,480,744
1000,487,514,534,248,510,758
1000,482,496,503,245,505,750
1000,497,499,507,246,492,738
1000,504,495,516,234,524,758
1000,519,493,506,252,508,760
1000,495,481,477,234,496,730
1000,518,527,513,279,477,756
1000,472,533,520,246,506,752
1000,493,472,515,245,525,770
1000,502,488,511,243,516,759
1000,497,489,493,239,506,745
1000,497,480,507,244,516,760
1000,518,495,523,265,513,778
1000,517,518,509,263,493,756
1000,502,513,531,245,513,758
1000,464,509,506,233,509,742
1000,510,509,503,257,503,760
1000,518,507,512,263,502,765
1000,508,503,490,257,490,747
1000,506,501,489,257,488,745
1000,485,498,489,243,497,740
1000,487,481,472,234,493,727
1000,510,502,518,255,502,757
1000,501,484,485,240,509,749
1000,527,467,489,247,521,768
1000,480,495,495,236,503,739
1000,494,494,512,228,534,762
1000,491,500,503,240,514,754
1000,495,492,500,241,497,738
1000,506,504,480,252,491,743
1000,537,490,471,266,483,749
1000,502,505,524,256,513,769
1000,498,500,493,235,513,748
1000,516,527,509,281,500,781
1000,497,492,481,239,499,738
1000,492,497,522,240,520,760
1000,485,510,495,249,489,738
1000,527,507,500,257,518,775
1000,480,510,508,247,500,747
1000,496,502,502,228,521,749
1000,530,517,503,268,509,777
1000,512,507,499,249,503,752
1000,506,476,492,237,508,745
1000,509,494,493,236,522,758
1000,495,506,513,248,495,743
1000,502,524,494,252,481,733
1000,515,505,495,271,471,742
1000,505,473,512,237,530,767
1000,499,486,496,244,501,745
1000,494,492,505,250,522,772
1000,514,511,516,276,502,778
1000,505,512,521,256,519,775
1000,480,497,479,233,488,721
1000,501,529,511,262,497,759
1000,477,517,469,257,464,721
1000,501,520,486,259,488,747
1000,508,523,470,260,479,739
1000,500,509,473,239,500,739
1000,496,517,512,244,497,741
1000,477,517,537,248,501,749
1000,513,499,527,267,496,763
1000,479,501,485,240,494,734
1000,492,496,509,242,503,745
1000,466,511,515,237,503,740
1000,537,501,523,265,511,776
1000,501,502,498,276,495,771
1000,514,509,516,260,510,770
1000,525,493,515,267,507,774
1000,519,507,493,265,496,761
1000,483,484,495,226,505,731
1000,490,482,530,231,521,752
1000,493,491,493,247,493,740
1000,504,520,497,263,479,742
1000,506,496,500,240,511,751
1000,466,518,494,245,480,725
1000,495,489,490,242,506,748
1000,510,484,484,245,489,734
1000,513,523,485,267,479,746
1000,485,494,517,231,521,752
1000,529,489,481,259,500,759
1000,516,507,481,266,487,753
1000,495,500,471,256,495,751
1000,515,473,482,259,493,752
1000,490,496,492,252,477,729
1000,485,509,495,255,500,755
1000,498,532,513,251,506,757
1000,509,471,508,235,501,736
1000,503,510,499,258,494,752
1000,486,481,482,226,513,739
1000,493,518,528,255,489,744
1000,475,494,508,243,498,741
1000,515,468,516,235,531,766
1000,502,510,498,259,504,763
1000,505,487,513,250,516,766
1000,513,484,512,250,524,774
1000,493,504,486,254,500,754
1000,513,506,512,249,530,779
1000,513,507,479,256,503,759
1000,503,504,486,257,490,747
1000,488,471,512,235,515,750
1000,504,509,472,249,497,746
1000,486,507,478,248,472,720
1000,495,490,503,243,496,739
1000,483,481,487,242,484,726
1000,502,497,504,243,519,762
1000,493,505,491,244,505,749
1000,506,484,507,242,503,745
1000,493,525,513,249,496,745
1000,506,511,517,257,503,760
1000,481,514,523,245,501,746
1000,496,500,503,253,507,760
1000,512,494,505,257,492,749
1000,500,501,517,249,510,759
1000,480,496,532,242,511,753
1000,492,489,489,241,505,746
1000,503,496,483,237,502,739
1000,500,479,515,236,518,754
1000,505,492,508,246,501,747
1000,507,510,496,260,497,757
1000,521,516,509,272,511,783
1000,488,489,483,219,515,734
1000,499,513,506,260,501,761
1000,517,518,492,255,497,752
1000,495,491,503,243,496,739
1000,497,501,496,243,499,742
1000,504,505,513,261,493,754
1000,524,523,498,285,471,756
1000,497,513,494,248,496,744
1000,507,498,514,255,507,762
1000,468,492,505,237,505,742
1000,472,496,506,244,507,751
1000,515,489,498,254,513,767
1000,482,473,516,233,516,749
1000,508,475,513,242,506,748
1000,497,486,503,248,493,741
1000,493,536,510,256,497,753
1000,494,489,484,231,509,740
1000,493,483,497,230,520,750
1000,521,503,503,254,514,768
1000,477,516,506,240,497,737
1000,446,530,508,237,496,733
1000,509,516,496,259,496,755
1000,498,532,523,274,467,741
1000,484,491,513,245,509,754
1000,496,504,486,246,511,757
1000,474,488,537,245,504,749
1000,503,504,497,257,503,760
1000,506,491,483,238,512,750
1000,467,488,486,223,524,747
1000,476,513,508,248,499,747
1000,501,491,511,238,522,760
1000,495,514,506,248,508,756
1000,497,477,517,240,535,775
1000,493,510,491,264,483,747
1000,519,489,506,258,499,757
1000,528,496,478,247,508,755
1000,519,522,516,266,502,768
1000,504,505,509,240,521,761
1000,496,485,522,231,527,758
